nucleotide	aminoAcid	estimatedNumberGenomes
CCTCCCAGACATCTGTGTACTTGTGTGCCAGCACTATAACAGCGAACTATGGCTACACCTTCGGTTCG	CASTITANYGYTF	6
CCTCCCAGACATCTGTGTACTTGTGTGCCAGCAGTTACGCTGTACAGGGGTCTGGCATTCAGTACTTCGGCGCC	CASSYAVQGSGIQYF	7
GGACTCGGCCCTTTATCTTTGCGCCAGCAGCGATGTCGGGGGGGCAGAGACCCAGTACTTCGGGCCA	CASSDVGGAETQYF	2
CCTCCCAGACATCTGTGTACTTGTGTGCCAGCAGTTACCGTCTCCCCGAGACTTGCAACTAATGAAAAACTGTTTTTTGGCAGT		4
GACTCGGCCGTGTATGTCTGTGCCAGCAGCTTGGATTCGGGGGAAGTTTACAATGAGCAGTTCTTCGGGCCA	CASSLDSGEVYNEQFF	2
CAAAAGAACCCGACAGCTTTCTATCTCTGTGCCAGTACCACGTTGGTCCTCCAGGCCGGAAACACCATATATTTTGGAGAG	CASTTLVLQAGNTIYF	2
CAGAACTGGAGGATTCTGGAGTTTATTTCTGTGCCAGCAGCCAAGATGGGCCCGGCTGAGACACTGAAGCTTTCTTTGGACAA	CASSQDGPG*DTEAFF	3
CAGAACTGGAGGATTCTGGAGTTTATTTCTGTGCCAGCAGCCAATTGACCAGCTGGAACACTGAAGCTTTCTTTGGACAA	CASSQLTSWNTEAFF	7
AACCCAGGGACTCAGCTGTGTATTTTTGTGCTAGTGCCCCGACAGGGTCTTATGGCTACACCTTCGGTTCG	CASAPTGSYGYTF	1
CAAAAGAACCCGACAGCTTTCTATCTCTGTGCCAGTAGTTTCGGCGGAGGGGCCATTAATTCACCCCTCCACTTTGGGAAC	CASSFGGGAINSPLHF	6
AACCCAGGGACTCRGCYGTGTATKTYTGTGCCAGCAGCTTGATGGGGAGGGAACAAGAGACCCAGTACTTCGGGCCA	CASSLMGREQETQYF	7
CCTCACATACCTCTCAGTACCTCTGTGCCAGCATGAGGGGACTAGCGGGATTAGGGTAGCAGTACTTCGGGCCG	CASMRGLAGLG*QYF	4
GACTCGGCCGTGTATGTCTGTGCCAGCAGCTCAGTACGGGACATAACACAAGAGACCCAGTACTTCGGGCCA	CASSSVRDITQETQYF	4
ATCCTGAAGACAGCAGCTTCTACATCTGCAGTGCTCCGCTCCGACAGGGCAACTGGGACGAGCAGTACTTCGGGCCG	CSAPLRQGNWDEQYF	1
TGGGGGACTCAGCTTTGTATTTCTGTGCCAGCAGTGAAAGGGGAAGCACAGATACGCAGTATTTTGGCCCA	CASSERGSTDTQYF	11
AGCTTGGTGACTCTGCTGTGTATTTCTGTGCCAGCAGCCCCTCAAACGGGGTGCGGGAGCAGTTCTTCGGGCCA	CASSPSNGVREQFF	17
TSRGGGACTCAGCTKTGTAYTTCTGTGCCAGCAGTGTTGACAGGCCGGCGTTGGGGACCCAGTACTTCGGGCCA	CASSVDRPALGTQYF	2
GACTCGGCCGTGTATGTCTGTGCCAGCAACACAGGGTTGGGGAATCAGCCCCAGCATTTTGGTGAT	CASNTGLGNQPQHF	1
CCTCCCAGACATCTGTGTACTTGTGTGCCAGCAGAACAACAGGGCGCAATCAGCCCCAGCATTTTGGTGAT	CASRTTGRNQPQHF	5
AAGAAGACTCAGCTGCGTATCTCTGCGCCAGCAGCCAAGATCCGGGGGACGCCTACAATGAGCAGTTCTTCGGGCCA	CASSQDPGDAYNEQFF	1
CAAAAGAACCCGACAGCTTTCTATCTCTGTGCCAGTAGTATGCCCCTAAAGAGCACAGATACGCAGTATTTTGGCCCA	CASSMPLKSTDTQYF	4
ATCCTGAAGACAGCAGCTTCTACATCTGCAGTGCTAGAACCTCCACAGGGGGCGAAGCTGGCTACACCTTCGGTTCG	CSARTSTGGEAGYTF	1
AAGRAGACWCRGCWSYGTATCTCTGCGCCAGCAGCCAAGAGCGGGCAGCCCTYTACGAGCAGTACTTCGGGCCG	CASSQERAALYEQYF	2
GAGACACGGCACTGTATCTCTGCGCCAGCAAGTCCGGGAAGTAAACAAACGAGCAGTACTTCGGGCCG	CASKSGK*TNEQYF	2
GACTCGGCCGTGTATGTCTGTGCCAGCAGCTTAAGGGCAGCTTCAAACTATGGCTACACCTTCGGTTCG	CASSLRAASNYGYTF	30
TGGGGGACTCAGCTTTGTATTTCTGTGCCAGCAGCGTAGCAGGACAGCACAATGAGCAGTTCTTCGGGCCA	CASSVAGQHNEQFF	6
AGCTTGGTGACTCTGCTGTGTATTTCTGTGCCAGCAGCCCGAGACAGGGAGAAGTTGGCTACACCTTCGGTTCG	CASSPRQGEVGYTF	7
CCCAACCAGACAGCTCTTTACTTCTGTGCCAGCAGCGGGACACCTAAACAATCAGCCCCAGCATTTTGGTGAT		3
ATCCTGAAGACAGCAGCTTCTACATCTGCAGTGCTAGAGCCCAAACTAGCGGGGACACAGATACGCAGTATTTTGGCCCA	CSARAQTSGDTDTQYF	20
CGAGGAGATTCGGCAGCTTATTTCTGTGCCAGCTCACCACGTCTATGGGGGTAAATGAGCAGTTCTTCGGGCCA		1
TYRGGRGACWCAGCWYKGTATTTCTGTGCCAGCAGCTCCGGACTAGCGGGAGTTAGGACCGGGGAGCTGTTTTTTGGAGAA	CASSSGLAGVRTGELFF	10
GACTCGGCCGTGTATCTCTGTGCCAGCAGCCCGGCGGGGGGCTATGGCTACACCTTCGGTTCG	CASSPAGGYGYTF	1
CAAAAGAACCCGACAGCTTTCTATCTCTGTGCCAGTAGTGCGGCAGGGACTAGCGGGGTAGATACGCAGTATTTTGGCCCA	CASSAAGTSGVDTQYF	2
GGACTCGGCCCTTTATCTTTGCGCCAGCAGCCCGGGGGGGCGCGAAGGCTATGGCTACACCTTCGGTTCG	CASSPGGREGYGYTF	2
CCCAACCAGACAGCTCTTTACTTCTGTGCCACCAGTGGGGGGCTGCAGCCAAGAGACCCAGTACTTCGGGCCA		3
CAAAAGAACCCGACAGCTTTCTATCTCTGTGCCAGTAGTAGTGAGTCCTACAATGAGCAGTTCTTCGGGCCA	CASSSESYNEQFF	4
ATCCTGAAGACAGCAGCTTCTACATCTGCAGTGCTCTGACTAGCGGGAGCTTCACAGATACGCAGTATTTTGGCCCA	CSALTSGSFTDTQYF	4
GACGCAGCCATGTACCTGTGTGCCACAACAAAGGGGCGGAGGGGAGCTAACTATGGCTACACCTTCGGTTCG	CATTKGRRGANYGYTF	5
GACTCGGCCGTGTATGTCTGTGCCAGCAGCTTGGATGGAAGGGGGACTGAAGCTTTCTTTGGACAA	CASSLDGRGTEAFF	1
TTCTCAGTGACTCTGGCTTCTATCTCTGTGCCTGGAGTGTTACCCTGAACACTGAAGCTTTCTTTGGACAA	CAWSVTLNTEAFF	4
AGCTTGGTGACTCTGCTGTGTATTTCTGTGCCAGCAGCCAAAACAGGGGAGTGTGGAATGAAGCTTTCTTTGGACAA	CASSQNRGVWNEAFF	18
CACCAACCAGACATCTATGTACCTCTGTGCCAGCAGTTTAGGAGGGCCTGGGGCCAACGTCCTGACTTTCGGGGCC	CASSLGGPGANVLTF	21
CCTCCCAGACATCTGTGTACTTGTGTGCCAGCAGTTTGCGGACTGATCTCAATGAGCAGTTCTTCGGGCCA	CASSLRTDLNEQFF	17
AGCTTGGTGACTCTGCTGTGTATTTCTGTGCCAGCAGCTCAGAGATGACAGGGCCCCTTCAGAAATCAGCCCCAGCATTTTGGTGAT		13
CAGAACTGGAGGATTCTGGAGTTTATTTCTGTGCCAGCAGCCAAGATAGCAATCAGCCCCAGCATTTTGGTGAT	CASSQDSNQPQHF	3
TSRGGGACTCAGCTKTGTAYTTCTGTGCCAGCAGCCCTCTGCCCGGGCAGGTGGTAGGGGAGCTGTTTTTTGGAGAA	CASSPLPGQVVGELFF	1
MAGAAGACTCAGCYSYGTATCTCTGCGCCAGCAGTCTAAAGCGGGTGGATCAGCCCCAGCATTTTGGTGAT	CASSLKRVDQPQHF	3
GACTCGGCCGTGTATGTCTGTGCCAGCAGCTTTTCTTTCGGGACTAGCGGAGGGGAGCAGTTCTTCGGGCCA	CASSFSFGTSGGEQFF	3
CCTCACATACCTCTCAGTACCTCTGTGCCAAAACTCAATACCGGACACCTCCCCCTCACGAACACCGGGGAGCTGTTTTTTGGAGAA		1
AGCTTGGTGACTCTGCTGTGTATTTCTGTGCCAGCAGCCGCCTAGACGGCCAGGAGTAGTTCTTCGGGCCA	CASSRLDGQE*FF	4
CAGAACTGGAGGATTCTGGAGTTTATTTCTGTGCCAGCAGCCAAGATGTGGGGGGAACACTGAAGCTTTCTTTGGACAA		22
GACGCAGCCATGTACCTGTGTGCCACCAGCAACTCGTGACATTTTTAGCACAGATACGCAGTATTTTGGCCCA		30
CCCTGAAGACAGCAGCATATATCTCTGCAGCGTCGGCCCGGGACAGAGCACAGATACGCAGTATTTTGGCCCA	CSVGPGQSTDTQYF	9
CCTCCCAGACATCTGTGTACTTGTGTGCCATCAGTGACAGCACCACTGAAGCTTTCTTTGGACAA	CAISDSTTEAFF	10
CCTCCCAGACATCTGTGTACTTGTGTGCCAGCAGTGAACGGGGAGGGGATCTCCGCGAAGCTTTCTTTGGACAA	CASSERGGDLREAFF	6
TTCTCAGTGACTCTGGCTTCTATCTCTGTGCCTGGAGCGTAGGACAGGGGGCTCGAGAGACCCAGTACTTCGGGCCA	CAWSVGQGARETQYF	4
GGACTCGGCCCTTTATCTTTGCGCCAGCAGCTTGACAGAGGGCTGGAACACTGAAGCTTTCTTTGGACAA	CASSLTEGWNTEAFF	2
CCTCCCAGACATCTGTGTACTTGTGTGCCAGCAGTTATAAGCCCGCCTGGGTGAGCACCGGGGAGCTGTTTTTTGGAGAA	CASSYKPAWVSTGELFF	1
CAGAACTGGAGGATTCTGGAGTTTATTTCTGTGCCAGCAGCCAAGATTCCAGCGCGCACGGGGAGCTGTTTTTTGGAGAA	CASSQDSSAHGELFF	19
GACTCGGCCGTGTATGTCTGTGCCAGCAGCCCAGTTCGCGACACCGGGGAGCTGTTTTTTGGAGAA	CASSPVRDTGELFF	1
GGACTCGGCCCTTTATCTTTGCGCCAGCAGCTGGAGCACCGGGCCAGATACGCAGTATTTTGGCCCA	CASSWSTGPDTQYF	6
ATCCTGAAGACAGCAGCTTCTACATCTGCAGTGCTAGAGGTCTTCTCGCGGGTGACTCCTACGAGCAGTACTTCGGGCCG	CSARGLLAGDSYEQYF	8
GCTCCCAGACATCTGTGTATTTCTGCGCCAGCAGTGAGACAGGGTGGGGTGAAGCTTTCTTTGGACAA	CASSETGWGEAFF	5
CACCAACCAGACATCTATGTACCTCTGTGCCAGCATTCGGTCCAGGGGTGGGTACGAGCAGTACTTCGGGCCG	CASIRSRGGYEQYF	4
AACCCAGGGACTCAGCTGTGTAYTTYTGTGCCAGCAGTTTAGCCTTTTTTTCGTCACAGGGGACCTACGAGCAGTACTTCGGGCCG	CASSLAFFSSQGTYEQYF	6
AGCTTGGTGACTCTGCTGTGTATTTCTGTGCCAGCAGCCTCTCTAGCGGGGCCGATGAGCAGTTCTTCGGGCCA	CASSLSSGADEQFF	7
CCTGAAGACAGCAGCTTCTACATCTGCAGTGCGAAGGGATCACGCGAGCGTCTGCCCTATTTCAGTGAGACCCAGTACTTCGGGCCA	CSAKGSRERLPYFSETQYF	7
GCTCCCAGACATCTGTGTATTTCTGCGCCAGCAGTGACGGCGGGGGGGCTGAAGCTTTCTTTGGACAA	CASSDGGGAEAFF	2
CCTCCCAGACATCTGTGTACTTGTGTGCCAGCAGCCAATTGGGCAATCAGCCCCAGCATTTTGGTGAT	CASSQLGNQPQHF	2
CCTCCCAGACATCTGTGTACTTGTGTGCCAGCAGTTACGATCTGGGACGTACCGGCTACACCTTCGGTTCG	CASSYDLGRTGYTF	4
GGACTCGGCCRTGTATSTCTGTGCCAGCAGCCCGGCGGCGGGAGGGGGCACAGATACGCAGTATTTTGGCCCA	CASSPAAGGGTDTQYF	5
GACTCGGCCGTGTATGTCTGTGCCAGCAGCTTAGGGGTCGGGGACAGAAGCCTCACCCCTCCACTTTGGGAAC		3
GACTCGGCCGTGTATGTCTGTGCCAGCAGCTTTACCCGGGACTAGCCCTGATGGGGACCGGGGAGCTGTTTTTTGGAGAA		1
CCCAACCAGACAGCTCTTTACTTCTGTGCCACCCCCCGAAAGGGAGGGTACCTAGACAATGAGCAGTTCTTCGGGCCA	CATPRKGGYLDNEQFF	1
CCCAACCAGACAGCTCTTTACTTCTGTGCCAGCAGTCCGTCGAGGGGGGACCCAACAAGAGAGACCCAGTACTTCGGGCCA	CASSPSRGDPTRETQYF	4
TGGGGGACTCAGCTTTGTATTTCTGTGCCAGCAGCCCTGGGACCAACTATGGCTACACCTTCGGTTCG	CASSPGTNYGYTF	1
ATCCTGAAGACAGCAGCTTCTACATCTGCAGTGCTAGAGCAACCCCCCGGGACGCGACCTCCTACGAGCAGTACTTCGGGCCG	CSARATPRDATSYEQYF	1
GACTCGGCCGTGTATGTCTGTGCCAGAAGGCGACAGGGGGCCGGGGCAAGAGACCCAGTACTTCGGGCCA		1
CAAAAGAACCCGACAGCTTTCTATCTCTGTGCCAGTAGCGTTGCGGRGGCCCCCGTCATCACTGAAGCTTTCTTTGGACAA	CASSVAXAPVITEAFF	8
ATCCTGAAGACAGCAGCTTCTACATCTGCAGTGCTAGAACAGGGCAGAACACTGAAGCTTTCTTTGGACAA	CSARTGQNTEAFF	1
TGGGGGACTCAGCTTTGTATTTCTGTGCCAGCAGCCGGGGGGTAGGGACCTCAGATACGCAGTATTTTGGCCCA	CASSRGVGTSDTQYF	2
GACTCGGCCGTGTATGTCTGTGCCAGCAGCCTAAGGCCCGGGGTAGGGGAGCTGTTTTTTGGAGAA	CASSLRPGVGELFF	22
CAAAAGAACCCGACAGCTTTCTATCTCTGTGCCAGTAGTCCCCAGGGGCTCCTCTACGAGCAGTACTTCGGGCCG	CASSPQGLLYEQYF	5
CTCCCTCTCAGACTTCTGTTTACTTCTGTGCCAGCAGTCATCTAGATGAGCAGTTCTTCGGGCCA	CASSHLDEQFF	6
GACTCGGCCGTGTATGTCTGTGCCAGCAGCTTGGGGCAGGAAGGCTACTACGAGCAGTACTTCGGGCCG	CASSLGQEGYYEQYF	1
TSRGGGACTCAGCTKTGTAYTTCTGTGCCAGCAGCCCCTCGCTGTTGGGCAGACAAGAGACCCAGTACTTCGGGCCA	CASSPSLLGRQETQYF	2
GGGGGACTYRGCTGTGTATCTCTGTGCCAGCAGCCTCAAATCGAACACTGAAGCTTTCTTTGGACAA	CASSLKSNTEAFF	1
GACTCGGCCGTGTATGTCTGTGCCAGCAGCTTAGGCGACAGTTACAGCAATCAGCCCCAGCATTTTGGTGAT	CASSLGDSYSNQPQHF	4
TTCTCAGTGACTCTGGCTTCTATCTCTGTGCCTGGACGACGGGCAATTCGGGCGGGGAGCTGTTTTTTGGAGAA	CAWTTGNSGGELFF	5
CCACGTTTGGTGCCAGCCAGACCTCTGTACCTCTGTGCCAGCAGTTTATCCGCCGGGGGACTCTCCTACGAGCAGTACTTCGGGCCG	CASSLSAGGLSYEQYF	18
CACCAACCAGACATCTATGTACCTCTGTGCCAGCACCCCGGAGGGGGGATCCTACGAGCAGTACTTCGGGCCG	CASTPEGGSYEQYF	1
GGACTCGGCCSTSTATSTCTGTGCCAGCAGCCAAGAAGTTCGGGGGCCGGATCCTACAATGAGCAGTTCTTCGGGCCA		3
GACTCGGCCGTGTATGTCTGTGCCAGCAGCTTAGATGGCCACTCTCCCCTTTATGGCTACACCTTCGGTTCG	CASSLDGHSPLYGYTF	3
ATCCTGAAGACAGCAGCTTCTACATCTGCAGTGCAGCCGGGACAGGGGATCCGGCTACACCTTCGGTTCG		1
TGGGGGACTCAGCTTTGTATTTCTGTGCCAGCAACAATCTCCCGAACACCGGGGAGCTGTTTTTTGGAGAA	CASNNLPNTGELFF	6
GACTCGGCCGTGTATGTCTGTGCCAGCAGCTTGGATGTATGGGGCAGCGGGAACACTGAAGCTTTCTTTGGACAA	CASSLDVWGSGNTEAFF	2
AACCCAGGGACTCAGCTGTGTATTTTTGTGCCAGCAGTTTCGAGGTTGACAGGGCTTTCTTTGGACAA	CASSFEVDRAFF	10
GACTCGGCCATGTATCGCTGTGCCAGCAGTTGGGGCTGGGCGGCGAACACTGAAGCTTTCTTTGGACAA	CASSWGWAANTEAFF	14
AGCTTGGTGACTCTGCTGTGTATTTCTGTGCCAGCAGCCAAGATCTTTCGGGGGGGAGCACAGATACGCAGTATTTTGGCCCA	CASSQDLSGGSTDTQYF	1
CAAAAGAACCCGACAGCTTTCTATCTCTGTGCCAGTAGTATAGAGGACTAGCTGGTGAGCAGTTCTTCGGGCCA		26
GGACTCGGCCRTGTATSTCTGTGCCAGCAGCTTAGGCCCTGGGACAGGACCCGGGGAGCTGTTTTTTGGAGAA	CASSLGPGTGPGELFF	1
TGGGGGACTCAGCTTTGTATTTCTGTGCCAGCGCGCCAGTACGGAATGAGCAGTTCTTCGGGCCA	CASAPVRNEQFF	12
TGGGGGACTCAGCTTTGTATTTCTGTGCCAGCAGTGCTGAGGTCGGAAAACTGTTTTTTGGCAGT	CASSAEVGKLFF	4
TCAGGAGACACAGCACGGTATTTCTGTGCCAGCAGTTTCGGCAGGGGGGGAGATACGCAGTATTTTGGCCCA	CASSFGRGGDTQYF	1
GCTCCCAGACATCTGTGTATTTCTGCGCCAGCAGTGAGTCGACAGGGGCAATGGGGAGGTCCTACGAGCAGTACTTCGGGCCG	CASSESTGAMGRSYEQYF	5
AACCCAGGGACTCAGCTGTGTATTTTTGTGCTAGTGGTTTGGTCGGGACAGGGTGGGTCAGCCCCAGCATTTTGGTGAT		4
AAGAAGACTCAGCTGCGTATCTCTGCGCCAGCAGCCAAGGTCTTCGGACTAGCGGGGGGGCCATAGATACGCAGTATTTTGGCCCA	CASSQGLRTSGGAIDTQYF	7
ATCCTGAAGACAGCAGCTTCTACATCTGCAGTGCTTGGACTAGCGGGATCACCTACGAGCAGTACTTCGGGCCG	CSAWTSGITYEQYF	1
ATCCTGAAGACAGCAGCTTCTACATCTGCAGTGCTACACAGGGGGATCGTGAAAAACTGTTTTTTGGCAGT	CSATQGDREKLFF	1
ARRRRGACTCAGCYGYGTATCTCTRCGCCAGCAGCCAGGAAAGGGGGGAAAAACTGTTTTTTGGCAGT	XASSQERGEKLFF	11
GACTCGGCCGTGTATGTCTGTGCCAGCAGCTTAGGGGGGGCGATAATGTATGAAAAACTGTTTTTTGGCAGT	CASSLGGAIMYEKLFF	1
ATCCTGAAGACAGCAGCTTCTACATCTGCAGTGCTAGGTGGTTGGGACAGGCCTACAATGAGCAGTTCTTCGGGCCA	CSARWLGQAYNEQFF	18
GACTCGGCCRTGTATSKCTGTGCCAGAAGCTCTTCCGGACTAGCGGGAGGGCCTCTTGCTGGGAGCTGTTTTTTGGAGAA		12
CAAAAGAACCCGACAGCTTTCTATCTCTGTGCCAGTAGTATGGAGAAGGGGGCAGAAGCTTTCTTTGGACAA	CASSMEKGAEAFF	1
CCTCCCAGACATCTGTGTACTTGTGTGCCATCAGTGAGTCGGGGGGGGGCTCAGATACGCAGTATTTTGGCCCA	CAISESGGGSDTQYF	2
ATCCTGAAGACAGCAGCTTCTACATCTGCAGTGCCCCAGACTACTATGGCTACACCTTCGGTTCG	CSAPDYYGYTF	12
GATTCTGGAGTTTATTTCTGTGCCAGCAGCCAGGGGGTGGTAGCGGGAGGCAGCTCCTACAATGAGCAGTTCTTCGGGCCA	CASSQGVVAGGSSYNEQFF	7
ATCCTGAAGACAGCAGCTTCTACATCTGCAGTGCTAGAGCGTCGGCAGGGGGATCCAATGAGCAGTTCTTCGGGCCA	CSARASAGGSNEQFF	3
GGACTCGGCCCTTTATCTTTGCGCCAGCAGCTTATTGGAGGGGTTCCTACGAGCAGTACTTCGGGCCG		14
GACTCGGCCGTGTATGTCTGTGCCAGCAGCCCCAGCCTACTAGCGGGAGATCTCACCCAGACCCAGTACTTCGGGCCA	CASSPSLLAGDLTQTQYF	3
GACTCGGCCGTGTATGTCTGTGCCAGCAGCTTGGGGGCATCAACTAATGAAAAACTGTTTTTTGGCAGT	CASSLGASTNEKLFF	34
CAAAAGAACCCGACAGCTTTCTATCTCTGTGCCAGTAGAGAGGGGGCGCGGACGGGTCAGCCCCAGCATTTTGGTGAT	CASREGARTGQPQHF	4
GACTCGGCCGTGTATGTCTGTGCCAGCAGCTTAGATCGATTAGCGGGGGGGCGAATTAGCACAGATACGCAGTATTTTGGCCCA	CASSLDRLAGGRISTDTQYF	7
AAYCMRGRGACWCAGCWSKGTATTTYTGTGCCAGCAGGCAAGAGGGGTACGAGCAGTACTTCGGGCCG	CASRQEGYEQYF	2
GACTCGGCCGTGTATGTCTGTGCCAGCAGCTCCCTACGACAGCCGGGGCCCCAGCATTTTGGTGAT	CASSSLRQPGPQHF	17
GCTCCCAGACATCTGTGTATTTCTGCGCCAGCAGCCGGACTGGTAACACCGGGGAGCTGTTTTTTGGAGAA	CASSRTGNTGELFF	4
CTCCCTCTCAGACTTCTGTTTACTTCTGTGCCAGCACCTTAGGGGGGGAGCAGTACTTCGGGCCG	CASTLGGEQYF	15
GACTCGGCCGTGTATCTCTGTGCCAGCAGCTTACATAGCAATCAGCCCCAGCATTTTGGTGAT	CASSLHSNQPQHF	7
GAGACACGGCACTGTATCTCTGCGCCAGCAGTCAATCGTGGACAGTCGAGGGCTACGAGCAGTACTTCGGGCCG	CASSQSWTVEGYEQYF	8
GACTCGGCCGTGTATGTCTGTGCCAGCAGCAGCGCGACAGGGAAGGACTAGACTATGGCTACACCTTCGGTTCG		7
CAAAAGAACCCGACAGCTTTCTATCTCTGTGCCAGTATCGGACAGGACTATGGCTACACCTTCGGTTCG	CASIGQDYGYTF	1
ATCCTGAAGACAGCAGCTTCTACATCTGCAGTGCAACACTAGCGGGGGGGCCGGGTGAGCAGTTCTTCGGGCCA	CSATLAGGPGEQFF	29
YRGRRGACTCAGCYYTGTATYTCTGYGCCAGCAGCCCGGACGGAGCAAATGAGCAGTTCTTCGGGCCA	CASSPDGANEQFF	3
CAGGGACTYGGSCSTRTATKTCTGTGCCAGCAACGGACTAGCGGGGGGCCGGTGGGAGCAGTACTTCGGGCCG	CASNGLAGGRWEQYF	1
GACTCGGCCGTGTATGTCTGTGCCAGAATCGACGTGATCAAAGGCGGTTAGCCAAAAACATTCAGTACTTCGGCGCC		1
TTCTCAGTGACTCTGGCTTCTATCTCTGTGCCTGGAGTACCAGACAGGGCCCAAGAGACCCAGTACTTCGGGCCA		1
CAGCCAGACCTATCTGTACCACTGTGCCAGCAGGGGGGTTTCGGGACGGGGATCCTACGAGCAGTACTTCGGGCCG	CASRGVSGRGSYEQYF	1
TGGGGGACTCAGCTTTGTATTTCTGTGCCAGCAGCGTAGGACTAGCGGGGTTCACAGATACGCAGTATTTTGGCCCA	CASSVGLAGFTDTQYF	4
CCTCCCAGACATCTGTGTACTTGTGTGCCAGCAGTGAAGGGGTTGAAACGGGCTATGGCTACACCTTCGGTTCG	CASSEGVETGYGYTF	9
CCTCCCAGACATCTGTGTACTTGTGTGCCAGCAGTGGGGGGGACAATAAAGCTCTGGGGCCAACGTCCTGACTTTCGGGGCC		2
TGGGGGACTCAGCTTTGTATTTCTGTGCCAGCAGCTTAGGACTAGCGGCCTACGAGCAGTACTTCGGGCCG	CASSLGLAAYEQYF	1
GACTCGGCCGTGTATGTCTGTGCCAGCAGCTCCGGGGGGCCACAAGAGACCCAGTACTTCGGGCCA	CASSSGGPQETQYF	3
CCTCCCAGACATCTGTGTACTTGTGTGCCAGCAGTAACGGGTCAGGGGTCACAGATACGCAGTATTTTGGCCCA	CASSNGSGVTDTQYF	8
GACTCGGCCGTGTATGTCTGTGCCAGCAGCCGTGCGACAGGGGTGGGCGAGCAGTACTTCGGGCCG	CASSRATGVGEQYF	5
CCTCCCAGACATCTGTGTACTTGTGTGCCAGCAGTTGGGACAGAATGAACACTGAAGCTTTCTTTGGACAA	CASSWDRMNTEAFF	2
ATCCTGAAGACAGCAGCTTCTACATCTGCAGTGCTAGAGTTCCAGCGGGAGACTTAGCCAAAAACATTCAGTACTTCGGCGCC	CSARVPAGDLAKNIQYF	1
GGACTCGGCCCTTTATCTTTGCGCCAGCAGCTTGACTAGCGGGGGGGGTAATGAGCAGTTCTTCGGGCCA	CASSLTSGGGNEQFF	6
CCTCCCAGACATCTGTGTACTTGTGTGCCAGTAGTTACAGGGTGATGACAGATACGCAGTATTTTGGCCCA	CASSYRVMTDTQYF	1
CCTCCCAGACATCTGTGTACTTGTGTGCCAGCAGTTACTCGCGACAGGCCTCCGAATACGAGCAGTACTTCGGGCCG	CASSYSRQASEYEQYF	2
CCTCCCAGACATCTGTGTACTTGTGTGCCAGCAGTATCGGGGGAATCCAAGAGACCCAGTACTTCGGGCCA	CASSIGGIQETQYF	9
CCTCCCAGACATCTGTGTACTTGTGTGCCAGCAGTGGGGACAGGGGGCATGGCTACACCTTCGGTTCG	CASSGDRGHGYTF	1
GACTCGGCCGTGTATGTCTGTGCCAGCAGCTTGGGGAGTGTCGGAGTTGGATATAGCAATCAGCCCCAGCATTTTGGTGAT	CASSLGSVGVGYSNQPQHF	13
GACTCGGCCGTGTATGTCTGTGCCAGCAGCTGGAAGACAGGGATTACACCGGGGAGCTGTTTTTTGGAGAA		4
CGAGGAGATTCGGCAGCTTATTTCTGTGCCAGCTCACCACGAGCTGAATTTAATTCACCCCTCCACTTTGGGAAC	CASSPRAEFNSPLHF	2
CRRRRGACTCAGCCSTGTATCTCTRCGCCAGCAGCCAAGCGGCTGGGTTTACGGCCGGGGAGCTGTTTTTTGGAGAA	XASSQAAGFTAGELFF	12
GACTCGGCCGTGTATGTCTGTGCCAGCAGCCCCAGAATCTTCGGACAGGGGTACACTGAAGCTTTCTTTGGACAA	CASSPRIFGQGYTEAFF	2
CAGAAGACTCAGCCCTGTATCTCTGCGCCAGCAGCCAAGGACTGGGGGAGACCCAGTACTTCGGGCCA	CASSQGLGETQYF	11
TCCTCAGTGACTCTGGCTTCTATCTCTGTGCCTGGAGTATTAAAAAGGGGGCGGCTCAGCCCCAGCATTTTGGTGAT	CAWSIKKGAAQPQHF	2
CCCAACCAGACAGCTCTTTACTTCTGTGCCACCACCCCGGGACACTTAATGAAAAACTGTTTTTTGGCAGT		2
GACTCGGCCGTGTATGTCTGTGCCAGCAGCATAGGCCCGGGGCGGGGAGATACGCAGTATTTTGGCCCA	CASSIGPGRGDTQYF	4
GACTCGGCCGTGTATGTCTGTGCCAGCAGCCAAGATGAGCGGGTGTACAATGAGCAGTTCTTCGGGCCA	CASSQDERVYNEQFF	6
GACTCGGCCGTGTATGTCTGTGCCAGCAGCTTAACAGGGGTCGGTAACTATGGCTACACCTTCGGTTCG	CASSLTGVGNYGYTF	2
ATCCTGAAGACAGCAGCTTCTACATCTGCAGTGCTAGACCCCCAGCGGGGGCCTCCTACGAGCAGTACTTCGGGCCG	CSARPPAGASYEQYF	2
TSRGGGACTCAGCTKTGTAYTTCTGTGCCAGCAGAAGCGGGGGGGTAGGAAATGAGCAGTTCTTCGGGCCA	CASRSGGVGNEQFF	4
CCCAACCAGACAGCTCTTTACTTCTGTGCCAGCAGTTACTCAACTAGCGGACTATACGAGCAGTACTTCGGGCCG	CASSYSTSGLYEQYF	1
TGYWCCCTCTCAGACWTCTGTKTACTTCTGTGCCAGCAGAAGAGGGACTGAGGCTTTCTTTGGACAA	CASRRGTEAFF	2
AGCTTGGTGACTCTGCTGTGTATTTCTGTGCCAGCAGCCACCATGACAGGAACACCGGGGAGCTGTTTTTTGGAGAA	CASSHHDRNTGELFF	1
GACTCGGCCGTGTATGTCTGTGCCAGCAGCTCCCCCGTGTGGGGGCCCATTCAATTATAACTACGAGCAGTACTTCGGGCCG		6
AGCTTGGTGACTCTGCTGTGTATTTCTGTGCCAGCAGCCAAGCCGGGAACGAAGAGACCCAGTACTTCGGGCCA	CASSQAGNEETQYF	17
CCTCACATACCTCTCAGTACCTCTGTGCCAGCAGTGAGTCCTACAGGGGCCTATGGCTACACCTTCGGTTCG		3
GAGACACGGCACTGTATCTCTGCGCCAGCAGCCGTAGGTATGGGGACAGCTCCTACGAGCAGTACTTCGGGCCG	CASSRRYGDSSYEQYF	2
CAAAAGAACCCGACAGCTTTCTATCTCTGTGCCAGTAGTCCCCGACAGGGGGGCGGTTACGAGCAGTACTTCGGGCCG	CASSPRQGGGYEQYF	2
CCTCCCAGACATCTGTGTACTTGTGTGCCAGCAGTCCCTTTCGGACAGCCTATGGCTACACCTTCGGTTCG	CASSPFRTAYGYTF	8
CCCTGAAGACAGCAGCATATATCTCTGCAGCACCTCAGGGGTGGCGAACACTGAAGCTTTCTTTGGACAA	CSTSGVANTEAFF	18
CGAGGAGATTCGGCAGCTTATTTCTGTGCCAGCTCACCACCGGCCAGCCGAGCAGTACTTCGGGCCG		1
GGACTCGGCCCTTTATCTTTGCGCCAGCAGCAGAACAGGGGGGGATCAGCCCCAGCATTTTGGTGAT	CASSRTGGDQPQHF	1
AACCCAGGGACTCAGCTGTGTATTTTTGTGCTAGTGCCCCGGGGGCACTTCAGGGCTGGGGGCGAGCAGTACTTCGGGCCG		2
GACTCGGCCGTGTATGTCTGTGCCAGCAGCTTGGCCGGCGAGTCCACTGAAGCTTTCTTTGGACAA	CASSLAGESTEAFF	1
GGACTCGGCCCTTTATCTTTGCGCCAGCAGCCCAGGAACGGGGGATCACTATGGCTACACCTTCGGTTCG	CASSPGTGDHYGYTF	4
TGGGGGACTCAGCTTTGTATTTCTGTGCCAGCGACACACAGGGGGCGCGAGACGAGCAGTACTTCGGGCCG	CASDTQGARDEQYF	15
CCCTGAAGACAGCAGCATATATCTCTGCAGCGTGGCAGCGGGAGGCCGGTTTGGAATGAGCAGTTCTTCGGGCCA		4
GACTCGGCCGTGTATGTCTGTGCCAGCAGCTTGGACTAGCGGGACACGAGCAGTACTTCGGGCCG		3
CCCAACCAGACAGCTCTTTACTTCTGTGCCAGCAGACCGATCCAAGTAGCTGGGGCTTTCTTTGGACAA	CASRPIQVAGAFF	1
CCCAACCAGACAGCTCTTTACTTCTGTGCCAGCAGTGGGACAGGGACTGGGGCCAACGTCCTGACTTTCGGGGCC	CASSGTGTGANVLTF	1
CAAAAGAACCCGACAGCTTTCTATCTCTGTGCCAGTAGTATAAGCGGCGTAGGTTCTGGACAGCCCCAGCATTTTGGTGAT	CASSISGVGSGQPQHF	7
ATCCTGAAGACAGCAGCTTCTACATCTGCAGTGCCCGGGCAACATTAGCGGGAGGACCCAATGAGCAGTTCTTCGGGCCA	CSARATLAGGPNEQFF	1
ARRRRGACTCAGCYGYGTATCTCTRCGCCAGCAGCCAAGAAGGTAGCGGGACCCTCCGGGGCTCCTACGAGCAGTACTTCGGGCCG	XASSQEGSGTLRGSYEQYF	1
GACTCGGCCGTGTATGTCTGTGCCAGCAGCCTTGGGGGCCAAACGCACACTGAAGCTTTCTTTGGACAA	CASSLGGQTHTEAFF	2
GGGGGACTTGGCTGTGTATCTCTGTGCCAGCAGCCCAGGGACAGGGAGCGAGCAGTACTTCGGGCCG	CASSPGTGSEQYF	5
CAAAAGAACCCGACAGCTTTCTATCTCTGTGCCAGTAGTATGCTTGGGGGCACTGAAGCTTTCTTTGGACAA	CASSMLGGTEAFF	6
ATCCTGAAGACAGCAGCTTCTACATCTGCAGTGCCATCGGGACAGATCGGGAGACCCAGTACTTCGGGCCA	CSAIGTDRETQYF	33
TGGGGGACTCAGCTTTGTATTTCTGTGCCAGCAGCTTGACGGACCGGGACACCGGGGAGCTGTTTTTTGGAGAA	CASSLTDRDTGELFF	3
CCCTGAAGACAGCAGCATATATCTCTGCAGCGTTGAAGATCGGTGGCAGCATTCGTCTGGAAACACCATATATTTTGGAGAG	CSVEDRWQHSSGNTIYF	1
GACTCGGCCGTGTATGTCTGTGCCAGCAGCTTAACCCTCCCGAACACTGAAGCTTTCTTTGGACAA	CASSLTLPNTEAFF	3
CCTCCCAGACATCTGTGTACTTGTGTGCCAGCAGACCTGACAGGCCCCCCTACGAGCAGTACTTCGGGCCG	CASRPDRPPYEQYF	1
CCTCCCAGACATCTGTGTACTTGTGTGCCAGCAGTGACTCGAACTCTGGGGCCAACGTCCTGACTTTCGGGGCC	CASSDSNSGANVLTF	6
GACTCGGCCGTGTATGTCTGTGCCAGCAGCCCCTCCCGTCGGTGATGAAGTTCACCCCTCCACTTTGGGAAC	CASSPSRR**SSPLHF	2
GGACTCGGCCMTSTATCKCTGTGCCAGCAGCTTGCCGGGGTCCCTTTCCTATGGCTACACCTTCGGTTCG	CASSLPGSLSYGYTF	20
GCTCCCAGACATCTGTGTATTTCTGCGCCAGCAGTGAGGCGGGGGGCCAAGATACGCAGTATTTTGGCCCA	CASSEAGGQDTQYF	4
GACTCGGCCGTGTATGTCTGTGCCAGCAGACATACCTAAGAACCTCATGCAGGGGAAGCACCGGGGAGCTGTTTTTTGGAGAA		11
TYCTCAGTGACTCTGGCTTCTATCTCTGTGCCTGGACTCGGGACGCCGCCTACGAGCAGTACTTCGGGCCG	CAWTRDAAYEQYF	9
CCTCCCAGACATCTGTGTACTTGTGTGCCAGCAGTTAGTGGGGACTAATCTGCCCCCGGAAAATGAGCAGTTCTTCGGGCCA		6
GCTCCCAGACATCTGTGTATTTCTGCGCCAGCAGGGACAGCGACAATTCCTACAATGAGCAGTTCTTCGGGCCA	CASRDSDNSYNEQFF	4
CAAAAGAACCCGACAGCTTTCTATCTCTGTGCCAGTAGCTAAACTAGCGGCCCCCTACGAGCAGTACTTCGGGCCG		1
ATCCTGAAGACAGCAGCTTCTACATCTGCAGTGCTCGACCTATAGCGGGAGCTTCCTACGAGCAGTACTTCGGGCCG	CSARPIAGASYEQYF	40
CCTCCCAGACATCTGTGTACTTGTGTGCCAGCAGTTACTCGAGGGGGACCTATGGCTACACCTTCGGTTCG	CASSYSRGTYGYTF	6
CCTCACATACCTCTCAGTACCTCTGTGCCAGCAGTACAGGGGACCGTCAGCCCTAGCATTTTGGTGAT	CASSTGDRQP*HF	1
TTCTCAGTGACTCTGGCTTCTATCTCTGTGCCTGGAGTGTTGACTCCTGGCGCGGGGAGCTGTTTTTTGGAGAA	CAWSVDSWRGELFF	2
TYRGGRGACWCAGCWYKGTATTTCTGTGCCAGCAGTCACCGGGACGCAAAAAGAAGAGACCCAGTACTTCGGGCCA		14
CCCTGAAGACAGCAGCATATATCTCTGCAGCGTTTTCGGCGTGTACACAGATACGCAGTATTTTGGCCCA	CSVFGVYTDTQYF	12
TGGGGGACTCAGCTTTGTATTTCTGTGCCAGCAGTGGGAGGGGACACTCCTACGAGCAGTACTTCGGGCCG	CASSGRGHSYEQYF	4
CGAGGAGATTCGGCAGCTTATTTCTGTGCCAGCTCACCGGCTGGACTAGCGACCCGAGGGCAGTTCTTCGGGCCA	CASSPAGLATRGQFF	3
GACTCGGCCGTGTATGTCTGTGCCAGCAGCTTGGGGGCCTCCGCGTACGAGCAGTACTTCGGGCCG	CASSLGASAYEQYF	1
ARRRRGACTCAGCYGYGTATCTCTRCGCCAGCAGCTACGCCTCTAATCAGCCCCAGCATTTTGGTGAT	XASSYASNQPQHF	3
AACCCAGGGACTCAGCTGTGTATTTTTGTGCCAGCAGCCCCGGACTTACCTATGGCTACACCTTCGGTTCG	CASSPGLTYGYTF	7
GACTCGGCCGTGTATGTCTGTGCCAGCAGTTTGGGGTTTAGTGGCAAAAACATTCAGTACTTCGGCGCC	CASSLGFSGKNIQYF	1
GACTCGGCCGTGTATGTCTGTGCCAGCAGCAAACGACTAGCGGGGGATACGAGCAGTACTTCGGGCCG		1
GACTCGGCCGTGTATGTCTGTGCCAGCACCTGGGGGGACAGGGCCCGGGCCCAGTACTTCGGGCCA	CASTWGDRARAQYF	1
ATCCTGAAGACAGCAGCTTCTACATCTGCAGTGCTAGGCCAGGCACAGGCGGCCGGAACACTGAAGCTTTCTTTGGACAA	CSARPGTGGRNTEAFF	4
GACTCGGCCGTGTATGTCTGTGCCAGCAGAACCGGGACTAGCGGAACTTTTGGGCCTACAATGAGCAGTTCTTCGGGCCA		3
CCTCCCAGACATCTGTGTACTTGTGTGCCAGCAGCCTCATGGTCAGCCAAGAGACCCAGTACTTCGGGCCA	CASSLMVSQETQYF	3
GACTCGGCCGTGTATGTCTGTGCCAGCAGCTTACAGGGGACTTACACAGATACGCAGTATTTTGGCCCA	CASSLQGTYTDTQYF	1
GCTCCCAGACATCTGTGTATTTCTGCGCCAGCCGCCGGGCGTGGGCAGGGGTGAACACTGAAGCTTTCTTTGGACAA	CASRRAWAGVNTEAFF	9
GGACTCGGCCCTTTATCTTTGCGCCAGCAGCTTCCCCCGGGTCCCGTGCAGGGAGAGCAGTTCTTCGGGCCA		7
GACTCGGCCGTGTATGTCTGTGCCAGCAGCGCCCGCGGGGGAAGGGCCACAGATACGCAGTATTTTGGCCCA	CASSARGGRATDTQYF	4
CTCCCTCTCAGACTTCTGTTTACTTCTGTGCCAGCACCACGACTCCAAAACAGGGACTCTGGGGCCAACGTCCTGACTTTCGGGGCC		3
TGGGGGACTCAGCTTTGTATTTCTGTGCCAGCAGCCCGCGGGATGACGTCCACGAGCAGTACTTCGGGCCG	CASSPRDDVHEQYF	5
AGCTTGGTGACTCTGCTGTGTATTTCTGTGCCAGCACCCTAGGGGGCCATGGCTACACCTTCGGTTCG	CASTLGGHGYTF	14
CCTCCCAGACATCTGTGTACTTGTGTGCCAGCAGTTACGGGACCGGGCTCTACGAGCAGTACTTCGGGCCG	CASSYGTGLYEQYF	4
GACTCGGCCGTGTATGTCTGTGCCAGCCATGTGCGCGACCAGACAAAGTCGGGCCAACGTCCTGACTTTCGGGGCC		3
GACTCGGCCGTGTATGTCTGTGCCAGCAGCTTAGACAGGGGGCCGTATGGCTACACCTTCGGTTCG	CASSLDRGPYGYTF	1
AACCCAGGGACTCAGCTGTGTAYTTYTGTGCCAGCAGTTCCCCCGGGCCCTACGAGCAGTACTTCGGGCCG	CASSSPGPYEQYF	2
CAGAACTGGAGGATTCTGGAGTTTATTTCTGTGCCAGCAGCCAATCACTGGACGCGAACACTGAAGCTTTCTTTGGACAA	CASSQSLDANTEAFF	2
GACTCGGCCGTGTATGTCTGTGCCAGCAGCCGGACTAGCGGGAGCCCCCACGAGCAGTACTTCGGGCCG	CASSRTSGSPHEQYF	1
CAAAAGAACCCGACAGCTTTCTATCTCTGTGCCAGTAGGCAGGTCTCCGGGAATCAGCCCCAGCATTTTGGTGAT	CASRQVSGNQPQHF	3
CGAAGCTTGAGGATTCAGCAGTGTATTTTTGTGCCAGCAGCCAAACGGCCGCCTCCTACGAGCAGTACTTCGGGCCG	CASSQTAASYEQYF	4
GACTCGGCCGTGTATGTCTGTGCCAGCAGCTCCCTAACCAATCTCGACAAAGTCGGGCCAACGTCCTGACTTTCGGGGCC		1
AGCTTGGTGACTCTGCTGTGTATTTCTGTGCCAGCAGCCAAGTGGGGCCTGGGGGCTACACCTTCGGTTCG	CASSQVGPGGYTF	6
CAGAACTGGAGGATTCTGGAGTTTATTTCTGTGCCAGCAGCCGCCCTGAACAGGGGGTCGAGCAGTACTTCGGGCCG	CASSRPEQGVEQYF	8
GACTCGGCCGTGTATGTCTGTGCCAGCAGCCCCTAAATAACAGCTTCCTACGAGCAGTACTTCGGGCCG	CASSP*ITASYEQYF	1
CTCCCTCTCAGACTTCTGTTTACTTCTGTGCCAGCAGTTCTCCGGGACAGGATGCAATCAGCCCCAGCATTTTGGTGAT		5
GACTCGGCCGTGTATGTCTGTGCCAGCAGCTTGCAAGGGAGCTCCTACGAGCAGTACTTCGGGCCG	CASSLQGSSYEQYF	3
GACTCGGCCGTGTATGTCTGTGCCAGCAGCCCCTTCGCAGCCGCAAATGAGCAGTTCTTCGGGCCA	CASSPFAAANEQFF	1
CCCTGAAGACAGCAGCATATATCTCTGCAGCGTGTTGGGACTAGCGGGAGAGAATGAGCAGTTCTTCGGGCCA	CSVLGLAGENEQFF	4
CAAAAGAACCCGACAGCTTTCTATCTCTGTGCCAGTAGTCTAAGGACAGGCGTAGCGGGAAGCACCGGGGAGCTGTTTTTTGGAGAA	CASSLRTGVAGSTGELFF	1
CCTCCCAGACATCTGTGTACTTGTGTGCCAGCACTCTAAACCCCCAGGGGGTTGGCAGATACGCAGTATTTTGGCCCA		3
AACCCAGGGACTCAGCTGTGTATTTTTGTGCCAGCAGTAAAATGGCAGGGAGAGAGACCCAGTACTTCGGGCCA	CASSKMAGRETQYF	1
CCCTGAAGACAGCAGCATATATCTCTGCAGCGTAGGGGGGTCCGGGAGCAATCAGCCCCAGCATTTTGGTGAT	CSVGGSGSNQPQHF	3
CCCAACCAGACAGCTCTTTACTTCTGTGCCACCAGTGATGGCCCACTGAGGGCCAAAGGCTCTCCCACGAGCAGTACTTCGGGCCG		4
CAAAAGAACCCGACAGCTTTCTATCTCTGTGCCAGTAGTATCCAACAGGGGAGAGCCCAGCATTTTGGTGAT	CASSIQQGRAQHF	1
AGCTTGGTGACTCTGCTGTGTATTTCTGTGCCAGCAGCCAAAGAAGGGGCCATAATTCACCCCTCCACTTTGGGAAC	CASSQRRGHNSPLHF	2
AGCTTGGTGACTCTGCTGTGTATTTCTGTGCCAGCAGCCTGGGACAGAAGAATCAGCCCCAGCATTTTGGTGAT	CASSLGQKNQPQHF	3
GACTCGGCCGTGTATGTCTGTGCCAGCAGCTTAGGATATTTTGGAAACACCATATATTTTGGAGAG	CASSLGYFGNTIYF	4
CCTCCCAGACATCTGTGTACTTGTGTGCCATCAGTGCGGACAGGGGATTTTCAGAACTGTTTTTTGGCAGT	CAISADRGFSELFF	27
ATCCTGAAGACAGCAGCTTCTACATCTGCAGTGCTAGAGGAGGCGCGGGAAGGTGGGAGACCCAGTACTTCGGGCCA	CSARGGAGRWETQYF	29
ATCCTGAAGACAGCAGCTTCTACATCTGCAGTGCTAGAGTGTTGGCGGGAGGGGACACCGGGGAGCTGTTTTTTGGAGAA	CSARVLAGGDTGELFF	4
GACTCGGCCGTGTATGTCTGTGCCAGCAGTATAAGACAGGAAGCGATCGAAGCTTTCTTTGGACAA	CASSIRQEAIEAFF	7
CCTCCCAGACATCTGTGTACTTGTGTGCCAGCAGTTTCGATAGCGGGGGGTCCTACGAGCAGTACTTCGGGCCG	CASSFDSGGSYEQYF	2
CRRRRGACTCAGCCSTGTATCTCTRCGCCAGCAGCTCCTCTGGGGCCAACGTCCTGACTTTCGGGGCC	XASSSSGANVLTF	1
MAGAAGACTCAGCYSYGTATCTCTGCGCCAGCAGCCAACCCAACATTCCCGGGACAGAGCACAGATACGCAGTATTTTGGCCCA		7
CAAAAGAACCCGACAGCTTTCTATCTCTGTGCCAGTAGTGACGCAAGGGGGGATACGCAGTATTTTGGCCCA	CASSDARGDTQYF	23
AACCCAGGGACTCAGCTGTGTATTTTTGTGCCAGCAGTACAGACGGCTCCTATAATTCACCCCTCCACTTTGGGAAC	CASSTDGSYNSPLHF	8
GACTCGGCCGTGTATGTCTGTGCCAGCAGCTTCCCTAGCGGGGGGGCGGACACCGGGGAGCTGTTTTTTGGAGAA	CASSFPSGGADTGELFF	2
CCTCCCAGACATCTGTGTACTTGTGTGCCAGCATAACATCATAGGTCCCCCCAGAACAGTAAATTACGAGCAGTACTTCGGGCCG		1
GCTCCCAGACATCTGTGTATTTCTGCGCCAGCAGTGAGTCCCATGGGTACTACAATGAGCAATTCTTCGGGCCA	CASSESHGYYNEQFF	1
MAGAAGACTCAGCYSYGTATCTCTGCGCCAGCAGCCAAGGGGAGGGTGTCTACAATGAGCAGTTCTTCGGGCCA	CASSQGEGVYNEQFF	10
GACTCGGCCGTGTATGTCTGTGCCAGCAGCCCCCGACGGGACACCTACGAGCAGTACTTCGGGCCG	CASSPRRDTYEQYF	8
CCCAACCAGACAGCTCTTTACTTCTGTGCCACCAGTGATTCCCACCAGGCCACAGATACGCAGTATTTTGGCCCA	CATSDSHQATDTQYF	1
CCTCCCAGACATCTGTGTACTTGTGTGCCAGCCGGTCGACTAGCGGGAGTCGGTACGAGCAGTACTTCGGGCCG	CASRSTSGSRYEQYF	1
TGGGGGACTCAGCTTTGTATTTCTGTGCCAGCAGCGTAGTGGGTGGACTCACAGATACGCAGTATTTTGGCCCA	CASSVVGGLTDTQYF	2
CGAGGAGATTCGGCAGCTTATTTCTGTGCCAGCTCAGAGGGACAGGGTTCCTACGAGCAGTACTTCGGGCCG	CASSEGQGSYEQYF	5
GAGACACGGCACTGTATCTCTGCGCCAGCAGTCAAAATCTCAAAGACAGGGGCCGGCCATCCTTGAAGCTTTTTTTGGACAA		17
CCTCCCAGACATCTGTGTACTTGTGTGCCAGCAGTGGGGTATCAGGGGGGGAGGCCCAGTACTTCGGGCCA	CASSGVSGGEAQYF	2
CCTCCCAGACATCTGTGTACTTGTGTGCCAGCAGTAACGTACGGTACCAAGAGACCCAGTACTTCGGGCCA	CASSNVRYQETQYF	5
AACCCAGGGACTCAGCTGTGTATTTTTGTGCCAGCAGTGGTCTTTATGTCGAGACGGTCCTTTCAGATACGCAGTATTTTGGCCCA	CASSGLYVETVLSDTQYF	4
CAGAACTGGAGGATTCTGGAGTTTATTTCTGTGCCAGCAATATCCGAAGTGAGCAGTTCTTCGGGCCA	CASNIRSEQFF	2
GCTCCCAGACATCTGTGTATTTCTGCGCCAGCAGTGAGTCGCGGCGGGAGATCCACGAGCAGTACTTCGGGCCG	CASSESRREIHEQYF	10
CCTCCCAGACATCTGTGTACTTGTGTGCCAGCAGTATCGGGACCGACCGAAGGTCCCTCCACTTTGGGAAC	CASSIGTDRRSLHF	3
CCCAACCAGACAGCTCTTTACTTCTGTGCCAGCAGTTTAGGACTGATCCTACGAGCAGTACTTCGGGCCG		2
CACCAACCAGACATCTATGTACCTCTGTGCCAGCAGTTTTCGGGGAGGTCGAGACACCATATATTTTGGAGAG	CASSFRGGRDTIYF	7
CACCAACCAGACATCTATGTACCTCTGTGCCAGCTCGTATAGCAATCAGCCCCAGCATTTTGGTGAT	CASSYSNQPQHF	4
GACTCGGCCGTGTATGTCTGTGCCAGCAGCGGCCGCCGGGACAGCTATGGCTACACCTTCGGTTCG	CASSGRRDSYGYTF	23
AGCTTGGTGACTCTGCTGTGTATTTCTGTGCCAGCAGCCTGGCGCCGGGACAGATGAACACTGAAGCTTTCTTTGGACAA	CASSLAPGQMNTEAFF	28
CCTCCCAGACATCTGTGTACTTGTGTGCCAGCAGTATTGGACTGACTAGCCGTCAAGAAGAGACCCAGTACTTCGGGCCA	CASSIGLTSRQEETQYF	2
CAAAAGAACCCGACAGCTTTCTATCTCTGTGCCAGTAGTATAGAAGCGTATAAGGGCCGGAGTGGCTACACCTTCGGTTCG	CASSIEAYKGRSGYTF	1
GACTCGGCCGTGTATGTCTGTGCCAGCAGGATTAGCGGAACAAACAATGAGCAGTTCTTCGGGCCA	CASRISGTNNEQFF	4
ATCCTGAAGACAGCAGCTTCTACATCTGCAGTGCTAGGCAGTCCTACGAGCAGTACTTCGGGCCG	CSARQSYEQYF	7
ATCCTGAAGACAGCAGCTTCTACATCTGCAGTGCTGAGGGCCAGACAGGGAACACCGGGGAGCTGTTTTTTGGAGAA	CSAEGQTGNTGELFF	1
GACGCAGCCATGTACCTGTGTGCCACCAGCAGAGGGCCCTCCCCGGGGCTGTATAGCAATCAGCCCCAGCATTTTGGTGAT	CATSRGPSPGLYSNQPQHF	3
CAAAAGAACCCGACAGCTTTCTATCTCTGTGCCAGTAGTACCCATGGGGGGGCCGGTCAGCCCCAGCATTTTGGTGAT	CASSTHGGAGQPQHF	1
CACCAACCAGACATCTATGTACCTCTGTGCCAGCCGGGGCGGGACTAGCGGGAACACCGGGGAGCTGTTTTTTGGAGAA	CASRGGTSGNTGELFF	31
CCTCCCAGACATCTGTGTACTTGTGTGCCAGCAGTGAAGCGCGGCAGGGCAATCAGCCCCAGCATTTTGGTGAT	CASSEARQGNQPQHF	3
GACTCGGCCGTGTATGTCTGTGCCAGCAGCATCTACGGCCCCAGGGGGTGGAAGAGACCCAGTACTTCGGGCCA		1
CCCTGAAGACAGCAGCATATATCTCTGCAGCGTTGAGGGACAGGGGGCTTACGAGCAGTACTTCGGGCCG	CSVEGQGAYEQYF	2
TGGGGGACTCAGCTTTGTATTTCTGTGCCAGCAGTGAGGGGGGGCGAGTGTTCGAGCAGTACTTCGGGCCG	CASSEGGRVFEQYF	2
CAAAAGAACCCGACAGCTTTCTATCTCTGTGCCAGTAGTATTAACAGGGGGGGTCAAGCTTTCTTTGGACAA	CASSINRGGQAFF	3
AACCCAGGGACTCRGCYGTGTATKTYTGTGCCAGCAGTTTAGCGGGGGCCACAGATACGCAGTATTTTGGCCCA	CASSLAGATDTQYF	1
CGAGGAGATTCGGCAGCTTATTTCTGTGCCAGCTCAGCCTACTTGAACATTTACAAAGTCGGGCCAACGTCCTGACTTTCGGGGCC		9
TGGGGGACTCAGCTTTGTATTTCTGTGCCAGCAGCGTGACAGGGCTGCCAGATACGCAGTATTTTGGCCCA	CASSVTGLPDTQYF	10
TGGGGGACTCAGCTTTGTATTTCTGTGCCAGCAGTGAAACTAGCGTCCTTGAGCAGTTCTTCGGGCCA	CASSETSVLEQFF	41
GACTCGGCCGTGTATGTCTGTGCCAGCAGCTTAGCAGGACTAGCGGGAGGAGGATGGGAGACCCAGTACTTCGGGCCA	CASSLAGLAGGGWETQYF	3
CCTCCCAGACATCTGTGTACTTGTGTGCCAGCACCATTCTCGGACAGTCCTACGAGCAGTACTTCGGGCCG	CASTILGQSYEQYF	5
CGAGGAGATTCGGCAGCTTATTTCTGTGCCAGCTCACCACCTCAAGGGCATGGCTACACCTTCGGTTCG	CASSPPQGHGYTF	1
GACTCGGCCGTGTATGTCTGTGCCAGCAGCCAAGATTGGGGCCAAGAGACCCAGTACTTCGGGCCA	CASSQDWGQETQYF	1
CAGAAGACTCAGCCCTGTATCTCTGCGCCAGCAGCCAAGAGGCCTATGGCTACACCTTCGGTTCG	CASSQEAYGYTF	1
AACCCAGGGACTCAGCTGTGTATTTTTGTGCTAGTGCTATCGGACTAGCGGGGGGAAAACGGGGAGCTGTTTTTTGGAGAA		2
GGACTCGGCCCTTTATCTTTGCGCCAGCAGCTTGTCGGCAGGGGATCGGACCCAGTACTTCGGGCCA	CASSLSAGDRTQYF	31
CGAGGAGATTCGGCAGCTTATTTCTGTGCCAGCTCACCACTGGCCCTTGAGGGGGAAAAACTGTTTTTTGGCAGT	CASSPLALEGEKLFF	6
GACTCGGCCGTGTATGTCTGTGCCAGCAGCGAGACTAGCGGGAGGGGAGATACGCAGTATTTTGGCCCA	CASSETSGRGDTQYF	3
GACTCGGCCGTGTATGTCTGTGCCAGCAGCCATAACACCGGGACTTCAGATACGCAGTATTTTGGCCCA	CASSHNTGTSDTQYF	4
GACTCGGCCGTGTATGTCTGTGCCAGCAGCTTAGGACAGGTTCGCTACGAGCAGTACTTCGGGCCG	CASSLGQVRYEQYF	1
AGCTTGGTGACTCTGCTGTGTATTTCTGTGCCAGCCAGAGATGGGACAGGGGCTTGAATGAGTAGTTCTTCGGGCCA	CASQRWDRGLNE*FF	5
CACCAACCAGACATCTATGTACCTCTGTGCCAGCAGTTTAGGACAGTTCACCTACGAGCAGTACTTCGGGCCG	CASSLGQFTYEQYF	1
CCCTGAAGACAGCAGCATATATCTCTGCAGCGTTGAAGGACAGCAGAACACTGAAGCTTTCTTTGGACAA	CSVEGQQNTEAFF	7
TCMRGRGACWCAGCWSKGTAYTTCTGTGCCAGCAGCCTCGGGGGAAATCAGCCCCAGCATTTTGGTGAT	CASSLGGNQPQHF	1
GACTCGGCCGTGTATGTCTGTGCCAGCAGCTTTCGGGGGGCTAGCACAGATACGCAGTATTTTGGCCCA	CASSFRGASTDTQYF	1
CCCAACCAGACAGCTCTTTACTTCTGTGCCACCTCTCGCCCGTACCTGGGAATCAGCCCCAGCATTTTGGTGAT		1
CAGGGACTCAGCTGTGTACTTCTGTGCCAGCAGCTTAGAGTATAGCGGGAGGTCGGTGAGCAGTTCTTCGGGCCA		22
AGCTTGGTGACTCTGCTGTGTATTTCTGTGCCAACAGCCGGACAGGAGGCGATTCACCCCTCCACTTTGGGAAC	CANSRTGGDSPLHF	4
CCCTGAAGACAGCAGCATATATCTCTGCAGCGTTGCTGGGAGCGATCAGCCCCAGCATTTTGGTGAT	CSVAGSDQPQHF	3
CAAAAGAACCCGACAGCTTTCTATCTCTGTGCCAGTAGCCCCGGGGCAGGTTGGGGAGAGACCCAGTACTTCGGGCCA	CASSPGAGWGETQYF	3
CCTCCCAGACATCTGTGTACTTGTGTGCCAGCTTGAATTCGGGACAACTCAATCAGCCCCAGCATTTTGGTGAT	CASLNSGQLNQPQHF	1
TCTGCTGTGTATTTCTGTGCCAGCAGCCAAGGTGAGGAGGACAGGGGGGCGGGAACTAATGAAAAACTGTTTTTTGGCAGT	CASSQGEEDRGAGTNEKLFF	3
GACGCAGCCATGTACCTGTGTGCCACCAGCAGATACTGAGCTCCTACAATGAGCAGTTCTTCGGGCCA		5
GCTCCCAGACATCTGTGTATTTCTGCGCCAGCAGTGCAACCTCCGGGAGCATTCCAAGAGACCCAGTACTTCGGGCCA		1
CCTCCCAGACATCTGTGTACTTGTGTGCCATCAGTGACGCGTCAGTGGCCCCTACCACAGATACGCAGTATTTTGGCCCA	CAISDASVAPTTDTQYF	25
TGGGGGACTCAGCTTTGTATTTCTGTGCCAGCAGCGTAGAGGGCAGGGCCACTGGCTATGGCTACACCTTCGGTTCG	CASSVEGRATGYGYTF	17
CCTCCCAGACATCTGTGTACTTGTGTGCCAGCAGCCTGGGACCCCGACGGACTGAAGCTTTCTTTGGACAA	CASSLGPRRTEAFF	7
TGGTGCATCCTGAAGACAGCAGTTCTACATCTGCAGTGCCAACCGACGCGGGACAGGGTTATGAACACTGAAGCTTTCTTTGGACAA		18
CAAAAGAACCCGACAGCTTTCTATCTCTGTGCCACCGAAACAGGGGGCGGCTACGAGCAGTACTTCGGGCCG	CATETGGGYEQYF	13
AGCTTGGTGACTCTGCTGTGTATTTCTGTGCCAGCAGCCCACCGTCTGCCTCGGACTACCACTTGGAGACCCAGTACTTCGGGCCA	CASSPPSASDYHLETQYF	1
GGACTCGGCCCTTTATCTTTGCGCCAGCAGCTTGGTCGGAGGGGGCAATCAGCCCCAGCATTTTGGTGAT	CASSLVGGGNQPQHF	2
CACCAACCAGACATCTATGTACCTCTGTGCCAGCAGTTTAGGGATCATCGATGAGCAGTTCTTCGGGCCA	CASSLGIIDEQFF	6
GACTCGGCCGTGTATGTCTGTGCCAGCAGCTTACAGGGGGCCCAACACGAGCAGTACTTCGGGCCG	CASSLQGAQHEQYF	4
GACTCGGCCGTGTATGTCTGTGCCAGCAGCCCGGGGGAAAACACAGATACGCAGTATTTTGGCCCA	CASSPGENTDTQYF	6
ATCCTGAAGACAGCAGCTTCTACATCTGCAGTGCTAGAGATCCCGGGGGAGGGCGTTCCAGGGAGCTGTTTTTTGGAGAA	CSARDPGGGRSRELFF	2
TYRGGRGACWCAGCWYKGTATTTCTGTGCCAGCAGCTTAGATGGACTAGCGAATGACGAGCAGTACTTCGGGCCG	CASSLDGLANDEQYF	4
ATCCTGAAGACAGCAGCTTCTACATCTGCAGTGCTAGAGACCCCCTACCCGCTAGCAATTTAGCAGATACGCAGTATTTTGGCCCA	CSARDPLPASNLADTQYF	1
TGGGGGACTCAGCTTTGTATTTCTGTGCCAGCAGCGTAGGGAGACCTAGCACAGATACGCAGTATTTTGGCCCA	CASSVGRPSTDTQYF	14
ATCCTGAAGACAGCAGCTTCTACATCTGCAGTGGTAGGGGCGTCTGACTTTCTACGAGCAGTACTTCGGGCCG		2
TTCTCAGTGACTCTGGCTTCTATCTCTGTGCCTGGAGTCCAGGGGGCGCCGTTGAGCAGTTCTTCGGGCCA	CAWSPGGAVEQFF	3
GACTCGGCCGTGTATGTCTGTGCCAGCAGCCCGGGATTACTAGCGGGGGGAGATACGCAGTATTTTGGCCCA	CASSPGLLAGGDTQYF	3
CCTCCCAGACATCTGTGTACTTGTGTGCCAGCAGACGCACGGGGGGCGGGAAAATGAACACTGAAGCTTTCTTTGGACAA	CASRRTGGGKMNTEAFF	6
CGAGGAGATTCGGCAGCTTATTTCTGTGCCAGCTCACCACCCGCGTTGGGGGAATCACCCCTCCACTTTGGGAAC	CASSPPALGESPLHF	2
ATCCTGAAGACAGCAGCTTCTACATCTGCAGTGCTAAAGCGTGTTCCGGGCTTCACCCCTCCACTTTGGGAAC		4
AACYSRGGGACTCAGCTKTGTATTTYTGTGCCACTGGGACTAGCGGGTATCAGCAGTACTTCGGGCCG	CATGTSGYQQYF	5
CAAAAGAACCCGACAGCTTTCTATCTCTGTGCCAGCTCTCCGACAGGGGGGACAGATACGCAGTATTTTGGCCCA	CASSPTGGTDTQYF	9
ATCCTGAAGACAGCAGCTTCTACATCTGCAGTGCTAGAGATCGGGGCGTTAGTACAGATACGCAGTATTTTGGCCCA	CSARDRGVSTDTQYF	2
GACTCGGCCGTGTATGTCTGTGCCAGCAGCGGAGACGGCTCTGGGGCCAACGTCCTGACTTTCGGGGCC	CASSGDGSGANVLTF	1
TCAGGAGACACAGCACGGTATTTCTGTGCCAGCAGCAACACAGGGGGCAAAGTAACTATGGCTACACCTTCGGTTCG		7
GACTCGGCCGTGTATGTCTGTGCCAGCAGCTTGGGGCGAAATACCTATGGCTACACCTTCGGTTCG	CASSLGRNTYGYTF	6
AGCTTGGTGACTCTGCTGTGTATTTCTGTGCCAGCAGCCAAGGTCAGGGGGTCTACGAGCAGTACTTCGGGCCG	CASSQGQGVYEQYF	8
TGGGGGACTCAGCTTTGTATTTCTGTGCCAGCAGCATAGACGGTTATGGCTACACCTTCGGTTCG	CASSIDGYGYTF	6
CAAAAGAACCCGACAGCTTTCTATCTCTGTGCCAGTAGTATAATAGGAGAAAGAGACGAGCAGTACTTCGGGCCG	CASSIIGERDEQYF	3
GACTCGGCCGTGTATGTCTGTGCCAGCAGCTTTGGACTAGAGAACACAGATACGCAGTATTTTGGCCCA	CASSFGLENTDTQYF	2
CCCTGAAGACAGCAGCATATATCTCTGCAGCGTTGAACATTGTGGGCGGGAGGAACACCGGGGAGCTGTTTTTTGGAGAA		1
CCTCCCAGACATCTGTGTACTTGTGTGCCAGCAGTGAAGACAGCTCTGGGGCCAACGTCCTGACTTTCGGGGCC	CASSEDSSGANVLTF	3
ATCCTGAAGACAGCAGCTTCTACATCTGCAGTGCTAATGACAGGGGGCTAGAGACCCAGTACTTCGGGCCA	CSANDRGLETQYF	39
CCTCCCAGACATCTGTGTACTTGTGTGCCAGCAGGATCACGACCGGAGACAATCAGCCCCAGCATTTTGGTGAT	CASRITTGDNQPQHF	1
TGGGGGACTCAGCTTTGTATTTCTGTGCCAGCAGCTCGGGACTACATTTTAGGGAGACCCAGTACTTCGGGCCA	CASSSGLHFRETQYF	4
CCCAACCAGACMKCTCTKTACTTCTGTGCCAGTTAAACGACAGGGGAATGGCTACACCTTCGGTTCG		47
ATCCTGAAGACAGCAGCTTCTACATCTGCAGTGCTGCCCCCAGCGCCAAAGAGACCCAGTACTTCGGGCCA	CSAAPSAKETQYF	2
AGCTTGGTGACTCTGCTGTGTATTTCTGTGCCAGCAGCCAAGGCCTTGACAATGAGCAGTTCTTCGGGCCA	CASSQGLDNEQFF	1
CCCAACCAGACAGCTCTTTACTTCTGTGCCACCAGAGACAATTAAGTTCAGCCCCAGCATTTTGGTGAT	CATRDN*VQPQHF	1
CCTCACATACCTCTCAGTACCTCTGTGCCAGCAGTGGGAGGGACAGGGTTGGCGACACCGGGGAGCTGTTTTTTGGAGAA	CASSGRDRVGDTGELFF	1
AACCCAGGGACTCAGCTGTGTATTTTTGTGCCAGCACCCTACGGGCAGGGCTGGAGACCCAGTACTTCGGGCCA	CASTLRAGLETQYF	17
AACCCAGGGACTCAGCTGTGTATTTTTGTGCTAGTGGTTTTGAGCCGGACAGTGAAGCTTTCTTTGGACAA	CASGFEPDSEAFF	5
TGGAGGACTCAGCCATGTACTTCTGTGCCAGCAGTGAGGGGTTGGGTGAAAAACTGTTTTTTGGCAGT	CASSEGLGEKLFF	3
ATCCTGAAGACAGCAGCTTCTACATCTGCAGTGCTAGGCCCCCTAGCGGGAGGGCTAAGTCCTACGAGCAGTACTTCGGGCCG	CSARPPSGRAKSYEQYF	10
AACYSRGGGACTCAGCTKTGTATTTYTGTGCCAGCAGCGTAGGGGAAGGATATGGCTACACCTTCGGTTCG	CASSVGEGYGYTF	3
GACTCGGCCGTGTATGTCTGTGCCAGCAGCCGGGATGGGGAATGGGGGACCCAGTACTTCGGGCCA	CASSRDGEWGTQYF	6
TGGGGGACTCAGCTTTGTATTTCTGTGCCAGCAGCGTAGCCCAGGGTTCGATCAATGAGCAGTTCTTCGGGCCA	CASSVAQGSINEQFF	6
TGGGGGACTCAGCTTTGTATTTCTGTGCCAGCAGCATGACAGGGGCTAACTATGGCTACACCTTCGGTTCG	CASSMTGANYGYTF	3
CAAAAGAACCCGACAGCTTTCTATCTCTGTGCCAGTAGTCAGGGTACTAACTATGGCTACACCTTCGGTTCG	CASSQGTNYGYTF	6
GAGACACGGCACTGTATCTCTGCGTCAGCAGTCAATCGGGGGGACTATCCTACGAGCAGTACTTCGGGCCG	CVSSQSGGLSYEQYF	5
ATCCTGAAGACAGCAGCTTCTACATCTGCAGTGCTAGGCGGGAACCTAATGAAAAACTGTTTTTTGGCAGT	CSARREPNEKLFF	22
CAAAAGAACCCGACAGCTTTCTATCTCTGTGCCAGTAGTAGCAGGGGTTGGGAGACCCAGTACTTCGGGCCA	CASSSRGWETQYF	12
ATCCTGAAGACAGCAGCTTCTACATCTGCAGTGCGCAAAAGGGGGCACAGTTGATGAACACTGAAGCTTTCTTTGGACAA	CSAQKGAQLMNTEAFF	1
CCTCCCAGACATCTGTGTACTTGTGTGCCAGCAGCCAGGACCTCAGCGGGAGTTTTGGGACCCAGTACTTCGGGCCA	CASSQDLSGSFGTQYF	4
CAGAAGACTCAGCCCTGTATCTCTGCGCCAGCAGCCGAGAGGGTCAATTGGAGACCCAGTACTTCGGGCCA	CASSREGQLETQYF	16
AGCTTGGTGACTCTGCTGTGTATTTCTGTGCCAGCAGCACGGGACTAGCAGGGTACGAGCAGTACTTCGGGCCG	CASSTGLAGYEQYF	5
CAAAAGAACCCGACAGCTTTCTATCTCTGTGCCAGTAGTCCGGGACTAGCGGGAGGTTTAGAGACCCAGTACTTCGGGCCA	CASSPGLAGGLETQYF	10
ATCCTGAAGACAGCAGCTTCTACATCTGCAGTGCTAGAGGAGGTGGCACTGAAGCTTTCTTTGGACAA	CSARGGGTEAFF	17
CCTCCCAGACATCTGTGTACTTGTGTGCCAGCAGTCTCGTCCAGAGTGAAGCTTTCTTTGGACAA	CASSLVQSEAFF	6
CCTCCCAGACATCTGTGTACTTGTGTGCCAGCAGTTATCTGTTTAACGCCTACGAGCAGTACTTCGGGCCG	CASSYLFNAYEQYF	1
ATCCTGAAGACAGCAGCTTCTACATCTGCAGTGCTAGAGGATAATAAGCAGGGGGCCCTACAATGAGCAGTTCTTCGGGCCA		3
GACTCGGCCGTGTATGTCTGTGCCAGCAGGATAGCCGGGGCGGGCGAGACCCAGTACTTCGGGCCA	CASRIAGAGETQYF	2
CAAAAGAACCCGACAGCTTTCTATCTCTGTGCCAGTAGTATCAGGACGGCCGTCTCACCGGGGAGCTGTTTTTTGGAGAA		1
GACTCGGCCGTGTATGTCTGTGCCAGCAGACCGGGTGTAGGCAATCAGCCCCAGCATTTTGGTGAT	CASRPGVGNQPQHF	1
CCTCCCAGACATCTGTGTACTTGTGTGCCAGCAGTGCACACAGGGGGCGCCTTGGGGCCAACGTCCTGACTTTCGGGGCC	CASSAHRGRLGANVLTF	1
CAAAAGAACCCGACAGCTTTCTATCTCTGTGCCAGTAGTTCCCTCGGACAGGGGGCGCGGGAGCAGTACTTCGGGCCG	CASSSLGQGAREQYF	7
AGCTTGGTGACTCTGCTGTGTATTTCTGTGCCAGCAGATCACCTCTCCAGGGGAACACTGAAGCTTTCTTTGGACAA	CASRSPLQGNTEAFF	1
CAAAAGAACCCGACAGCTTTCTATCTCTGTGCCAGTAGTACACGGACAGGGCGAGATGGCTACACCTTCGGTTCG	CASSTRTGRDGYTF	3
GACTCGGCCGTGTATGTCTGTGCCAGCAGCTCCGGGACACATTATGTCCCTACGAGCAGTACTTCGGGCCG		1
CGAGGAGATTCGGCAGCTTATTTCTGTGCCAGCTCAGCGGGACGGTGGGACACCATATATTTTGGAGAG	CASSAGRWDTIYF	2
CCTCACATACCTCTCAGTACCTCTGTGCCAGCAGTGATTCCGCGGTCTTAAAGGGTGAAGCTTTCTTTGGACAA	CASSDSAVLKGEAFF	2
CAAAAGAACCCGACAGCTTTCTATCTCTGTGCCAGTACCCCTACGACAGGTCCCTCCTACGAGCAGTACTTCGGGCCG	CASTPTTGPSYEQYF	1
CCCAACCAGACAGCTCTTTACTTCTGTGCCAGCAGTTCACTAGCGGGAGCTACGAGCAGTACTTCGGGCCG		1
CGACTCGGCYGTGTATSTCTGTGCCAGCCAGCCAACCATAGTCGAAAGACCTATGGCTACACCTTCGGTTCG		6
GACTCGGCCGTGTATGTCTGTGCCAGCAGCTTAGTTCAGGGGGCAAGCTACGAGCAGTACTTCGGGCCG	CASSLVQGASYEQYF	8
CAGGGACTCAGCTGTGTACTTCTGTGCCAGCAGCCGAGGACAGGGTAACTGAAGCTTTCTTTGGACAA		10
CCTCCCAGACATCTGTGTACTTGTGTGCCATCAGTGAAAGGGGGCCCGCAGATTCACCCCTCCACTTTGGGAAC	CAISERGPADSPLHF	5
GACTCGGCCGTGTATGTCTGTGCCAGCAGCTCCCAAGGAGGGGGTATGGAGACCCAGTACTTCGGGCCA	CASSSQGGGMETQYF	7
GACTCGGCCGTGTATGTCTGTGCCAGCAGCCGCGAGCCCTTCGGGGGGAGCCCGTCCACAGATACGCAGTATTTTGGCCCA	CASSREPFGGSPSTDTQYF	1
GACTCGGCCGTGTATGTCTGTGCCAGAAGCCTAACCACCGGGCCCCTGACGGACTGAAGCTTTCTTTGGACAA		3
CGAGGAGATTCGGCAGCTTATTTCTGTGCCAGCTCACAGGGGACTTTCCAACCCGGGGAGCTGTTTTTTGGAGAA	CASSQGTFQPGELFF	2
CCTCCCAGACATCTGTGTACTTGTGTGCCACAGGGACAGGCAACTATGGCTACACCTTCGGTTCG	CATGTGNYGYTF	2
CCTCCCAGACATCTGTGTACTTGTGTGCCAGCAGTTACTCCCCTAGCGGGGGGCTCTACAATGAGCAGTTCTTCGGGCCA	CASSYSPSGGLYNEQFF	2
GCCACGTTTGGTGCATCCTGAAGACAGCAGTTCTACATCTGCAGTACTAGTCCCCCGGGCGGGGGAAACGAGCAGTACTTCGGGCCG		2
CCTCCCAGACATCTGTGTACTTGTGTGCCAGCAGTAAACTAGCAGGGACCTCCTACGAGCAGTACTTCGGGCCG	CASSKLAGTSYEQYF	16
GACTCGGCCGTGTATGTCTGTGCCAGCAGGCCACGACTAGCGGGAGATACGCAGTATTTTGGCCCA	CASRPRLAGDTQYF	3
CGACTCGGCTGTGTATCTCTGTGCCAGCAGCTTCTAGGACAGGGGGGAAAGAGACCCAGTACTTCGGGCCA		3
TYCTCAGTGACTCTGGCTTCTATCTCTGTGCCTCTTAACGAGGTTCTTCACGCTTCAGCCCCAGCATTTTGGTGAT		1
GACTCGGCCGTGTATGTCTGTGCCAGCAGCCAGACAGGGGTACATTCACCCCTCCACTTTGGGAAC	CASSQTGVHSPLHF	26
CCTCCCAGACATCTGTGTACTTGTGTGCCAGCAACGGGGCGGCAAAGGGCACTGAAGCTTTCTTTGGACAA	CASNGAAKGTEAFF	2
GACTCGGCCGTGTATGTCTGTGCCAGCAGCTTAGTAGCGGGAACTGTCTACGAGCAGTACTTCGGGCCG	CASSLVAGTVYEQYF	3
GACTCGGCCGTGTATGTCTGTGCCAGCAGCATCGACCTACCGGGAACAGTGAACACTGAAGCTTTCTTTGGACAA	CASSIDLPGTVNTEAFF	1
TGGGGGACTCAGCTTTGTATTTCTGTGCCAGCAGCGTAGGCAATAGCGGGGAGACCCAGTACTTCGGGCCA	CASSVGNSGETQYF	3
ATCCTGAAGACAGCAGCTTCTACATCTGCAGTGCTCGGGGCTACACGGACCACTACGAGCAGTACTTCGGGCCG	CSARGYTDHYEQYF	12
GACTCGGCCGTGTATGTCTGTGCCAGCAGCCGCACCAGCGGCTCAAATCAGCCCCAGCATTTTGGTGAT	CASSRTSGSNQPQHF	3
ATCCTGAAGACAGCAGCTTCTACATCTGCAGTGCTAGAGATGCTGGCGGGGCGAACACCGGGGAGCTGTTTTTTGGAGAA	CSARDAGGANTGELFF	3
CCCAACCAGACAGCTCTTTACTTCTGTGCCACCAGTGATTCGTCCCTTGGGGAAGCCAGAGATACGCAGTATTTTGGCCCA	CATSDSSLGEARDTQYF	1
GACTCGGCCGTGTATGTCTGTGCCAGCAGCTATAACTAAAACAGGGGGCAGACCCCTTCGGGGCTTTCTTTGGACAA		3
GACTCGGCCGTGTATGTCTGTGCCAGCAGCTTAGCCCACTAGCGGGAGTCCTACGAGCAGTACTTCGGGCCG	CASSLAH*RESYEQYF	5
CCTCCCAGACATCTGTGTACTTGTGTGCCAGCAGTTACGAGGGCCTCGACGTCTATGGCTACACCTTCGGTTCG	CASSYEGLDVYGYTF	4
GACTCGGCCGTGTATGTCTGTGCCAGCAGCCAGACAGGGGAACTATAATTCACCCCTCCACTTTGGGAAC		4
CCTCCCAGACATCTGTGTACTTGTGTGCCAGCCCTAGTAGTCACACACGCCACCATATATTTTGGAGAG		6
GACTCGGCCGTGTATGTCTGTGCCAGCAGCTTACAGTATATATCTTCTGGGGCCAACGTCCTGACTTTCGGGGCC	CASSLQYISSGANVLTF	2
AGCTTGGTGACTCTGCTGTGTATTTCTGTGCCAGCAGCCAAGACCCCTTAACAGGTCCTCGGGGGGCTACACCTTCGGTTCG		4
CRRRRGACTCAGCCSTGTATCTCTRCGCCAGCAGCGCGGGCTTAGATAGCAATCAGCCCCAGCATTTTGGTGAT	XASSAGLDSNQPQHF	13
CTCCCTCYCAGACWTCTGTKTACTTSTGTGCCAGCAGTTACCGAATAGGGCCCGGGGAGCTGTTTTTTGGAGAA	CASSYRIGPGELFF	4
CCTCCCAGACATCTGTGTACTTGTGTGCCAGCAGTGGTTAGGACAGGGGATCACAGATACGCAGTATTTTGGCCCA		11
GARGACTCRGCCMTGTATCKCTGTGCCAGAAGCTTTAGCTGTGTCGGGAACACTGAAGCTTTCTTTGGACAA	CARSFSCVGNTEAFF	1
TGTATCTCTGCGCCAGCAGCCAAGATCTACCCTGCCCCCCGGGACTAGCGGGATCTACAATGAGCAGTTCTTCGGGCCA		1
CAAAAGAACCCGACAGCTTTCTATCTCTGTGCCAGTAGTGGGACTAGCGGAAAGGTGGCCCAGTACTTCGGGCCA	CASSGTSGKVAQYF	2
TGGGGGACTCAGCTTTGTATTTCTGTGCCAGCAGCGTAGGACAGGTTAACACTGAAGCTTTCTTTGGACAA	CASSVGQVNTEAFF	4
CGAGGAGATTCGGCAGCTTATTTCTGTGCCAGCTCACCACCGGCGGGGGACGAGACCCAGTACTTCGGGCCA	CASSPPAGDETQYF	10
ATCCTGAAGACAGCAGCTTCTACATCTGCAGTGCTACGGGAGGGGATAATGAAAAACTGTTTTTTGGCAGT	CSATGGDNEKLFF	18
CGAGGAGATTCGGCAGCTTATTTCTGTGCCAGCTCACCAATAGGACGCCCTCTGGGGCCAACGTCCTGACTTTCGGGGCC		11
CAAAAGAACCCGACAGCTTTCTATCTCTGTGCCAGTAGTTCCCAGCGGGGGGGAAAAGAGACCCAGTACTTCGGGCCA	CASSSQRGGKETQYF	6
CAGAACTGGAGGATTCTGGAGTTTATTTCTGTGCCAGCAGCCTGGGACTAGCGGGAGATACGCAGTATTTTGGCCCA	CASSLGLAGDTQYF	4
ATCCTGAAGACAGCAGCTTCTACATCTGCAGTGCTAGAGGTCTCCACAGGGAGCCCTAATGAAAAACTGTTTTTTGGCAGT		4
CCTCCCAGACATCTGTGTACTTGTGTGCCAGCAGTGAACAGGGAGCAACGTACGAGCAGTACTTCGGGCCG	CASSEQGATYEQYF	1
AGCTTGGTGACTCTGCTGTGTATTTCTGTGCCAGCAGCCCAGAGGCCGCTATAGCAATCAGCCCCAGCATTTTGGTGAT		2
AGCTTGGTGACTCTGCTGTGTATTTCTGTGCCAGCAGCGGGGACAGGGTGGAGTTCTATGGCTACACCTTCGGTTCG	CASSGDRVEFYGYTF	3
CAAAAGAACCCGACAGCTTTCTATCTCTGTGCCAGTAGTATAGAGACAGGGGACCCAGGGCAGTATTTTGGCCCA	CASSIETGDPGQYF	4
CGAGGAGATTCGGCAGCTTATTTCTGTGCCAGCTCCGACACGGGAGATCCTGAAGCTTTCTTTGGACAA	CASSDTGDPEAFF	9
CGAGGAGATTCGGCAGCTTATTTCTGTGCCAGCCCGCTGGCGGCCAATTTAACCTGGGAGAGCAGTACTTCGGGCCG		2
AGCTTGGTGACTCTGCTGTGTATTTCTGTGCCAGCAGCTTAGGGTAGCGGGGCCAGAGACCCAGTACTTCGGGCCA		1
CCTCCCAGACATCTGTGTACTTGTGTGCCAGCAGTTACTCGATACCCGAGTGGGAAGCTTTCTTTGGACAA	CASSYSIPEWEAFF	13
CCTCCCAGACATCTGTGTACTTGTGTGCCAGCAGTTCGGGAGTGGGGGACCCCCCAGATACGCAGTATTTTGGCCCA	CASSSGVGDPPDTQYF	2
CGAGGAGATTCGGCAGCTTATTTCTGTGCCAGCTCACCCGGACAAGCCATGAACACTGAAGCTTTCTTTGGACAA	CASSPGQAMNTEAFF	6
CCTCCCAGACATCTGTGTACTTGTGTGCCAGCAGGCAGGGGGCGTTGGGGGATACGTAGTATTTTGGCCCA	CASRQGALGDT*YF	4
TYCTCAGTGACTCTGGCTTCTATCTCTGTGCCTGGAGTGATGGGACACCCGGCGCAGCTTTCTTTGGACAA	CAWSDGTPGAAFF	7
AGCTTGGTGACTCTGCTGTGTATTTCTGTGCCAGCTCCATGGGCAGGGGGGGTATAGGAGGCAATCAGCCCCAGCATTTTGGTGAT	CASSMGRGGIGGNQPQHF	5
CAAAAGAACCCGACAGCTTTCTATCTCTGTGCCAGTAGTTCTGCAGCGGGGGGAATTTACAATGAGCAGTTCTTTGGGCCA	CASSSAAGGIYNEQFF	2
ATCCTGAAGACAGCAGCTTCTACATCTGCAGTACTAGTCCCCCGGGCGGGGGAAACGAGCAGTACTTCGGGCCG	CSTSPPGGGNEQYF	1
TGGGGGACTCAGCTTTGTATTTCTGTGCCAGCAGCCCCTTCAGATCCTCCTACAATGAGCAGTTCTTCGGGCCA	CASSPFRSSYNEQFF	5
CCTCCCAGACATCTGTGTACTTGTGTGCCAGCAGTTACRACAGCTCTGGGGCCAACGTCCTGACTTTCGGGGCC	CASSYXSSGANVLTF	1
AACCCAGGGACTCAGCTGTGTATTTTTGTGCCAGCACCCACGGACTAGCGGTTCACAGATACGCAGTATTTTGGCCCA		2
CCCAACCAGACAGCTCTTTACTTCTGTGCCAGCAGGGGACTATACAATGAGCAGTTCTTCGGGCCA	CASRGLYNEQFF	1
CCTCCCAGACATCTGTGTACTTGTGTGCCAGCAGTTACCGGACAGGGCCGAATGAGCAGTTCTTCGGGCCA	CASSYRTGPNEQFF	5
ATCCTGAAGACAGCAGCTTCTACATCTGCAGTGCTAGAGGTGACCACGGACGCACAGATACGCAGTATTTTGGCCCA	CSARGDHGRTDTQYF	2
ATCCTGAAGACAGCAGCTTCTACATCTGCAGTGCTAGATCCACTAGCGGGAGTAGTTACGAGCAGTACTTCGGGCCG	CSARSTSGSSYEQYF	2
TYRGGRGACWCAGCWYKGTATTTCTGTGCCAGCAGCGTAGTCGGGAGCTCGAGTGAGCAGTACTTCGGGCCG	CASSVVGSSSEQYF	14
TGGGGGACTCAGCTTTGTATTTCTGTGCCAGCAGCCTCCGGGCCATCGATCAGCCCCAGCATTTTGGTGAT	CASSLRAIDQPQHF	2
CCCAACCAGACAGCTCTTTACTTCTGTGCCAGCAGTTTACAGGGGGGCACTGAAGCTTTCTTTGGACAA	CASSLQGGTEAFF	5
GACTCGGCCRTGTATSKCTGTGCCAGCAGCTTAGAGGAGGCAGGGACGACCTACGAGCAGTACTTCGGGCCG	CASSLEEAGTTYEQYF	21
TGGGGGACTCAGCTTTGTATTTCTGTGCCAGCAGCGGAGATGGACAGGGGAGAACCGGGGAGCTGTTTTTTGGAGAA	CASSGDGQGRTGELFF	6
CCTCCCAGACATCTGTGTACTTGTGTGCCAGCAACCAACAGAACTCCTACGAGCAGTACTTCGGGCCG	CASNQQNSYEQYF	1
CCCAACCAGACAGCTCTTTACTTCTGTGCCAGCAGTTTTCTATAGGGGTTAGGACTCTGGGGCCAACGTCCTGACTTTCGGGGCC		1
AGCTTGGTGACTCTGCTGTGTATTTCTGTGCCAGCAGCCAAGGGACTAGCGGGGTGCTCACAGATACGCAGTATTTTGGCCCA	CASSQGTSGVLTDTQYF	2
CCTCCCAGACATCTGTGTACTTGTGTGCCAGCAGAGGGGCCACTGACTCCTCAAGGCAGTTCTTCGGGCCA	CASRGATDSSRQFF	13
GACGCAGCCATGTACCTGTGTGCCACCAGCAGACTCCCAGGGGGACCCTTCGGCGAGCAGTACTTCGGGCCG	CATSRLPGGPFGEQYF	9
CAGAAGACTCAGCCCTGTATCTCTGCGCCAGCAGCCAAGATAGAACAGGGGGGGGAGCAACTAATGAAAAACTGTTTTTTGGCAGT	CASSQDRTGGGATNEKLFF	2
GACTCGGCCGTGTATGTCTGTGCCAGCAGCTTTTGGGCGGTAGCGGGAGGCATCCAAGAGACCCAGTACTTCGGGCCA	CASSFWAVAGGIQETQYF	1
GACTCGGCCGTGTATGTCTGTGCCAGCAGCTTAGTTAGCGCTAGCACAGATACGCAGTATTTTGGCCCA	CASSLVSASTDTQYF	9
CCCAACCAGACAGCTCTTTACTTCTGTGCCAGGAATAGGGACGATACCGTGCAACTAATGAAAAACTGTTTTTTGGCAGT		5
CAAAAGAACCCGACAGCTTTCTATCTCTGTGCCAGTACCCTCTCGAGGGGCAACTATGGCTACACCTTCGGTTCG	CASTLSRGNYGYTF	1
CGAAGCTTGAGGATTCAGCAGTGTATTTTTGTGCCAGCAGCCAAGGGACAGGGGGCCGTGGGGTTGAAGCTTTCTTTGGACAA	CASSQGTGGRGVEAFF	3
CCTCCCAGACATCTGTGTACTTGTGTGCCAGCTGCCCCCCGTACACGAACACTGAAGCTTTCTTTGGACAA	CASCPPYTNTEAFF	1
GACTCGGCCGTGTATGTCTGTGCCAGCAGCCCAGGGACAGCTGGGGCCAACGTCCTGACTTTCGGGGCC	CASSPGTAGANVLTF	2
AACCCAGGGACTCAGCTGTGTATTTTTGTGCTAGTGGTTTGGTGGAGGGGGAGCTATGGCTACACCTTCGGTTCG		1
GAGGGACTCAGCCGTGTATCTCTACGCCAGCAGCCAATGACAGGGTTTCGGCTACGAGCAGTACTTCGGGCCG	YASSQ*QGFGYEQYF	27
GCTGGCAAGCCACGTTTGGTGCCAGCCAGACCTCTGTACCTCTGTGCCAGCAGTTTATTAGGGGAACAGCCCCAGCATTTTGGTGAT	CASSLLGEQPQHF	8
CAAAAGAACCCGACAGCTTTCTATCTCTGTGCCAGTAGTATAGTCCCAGGCACTGAAGCTTTCTTTGGACAA	CASSIVPGTEAFF	7
CCCAACCAGACAGCTCTTTACTTCTGTGCCAGCAGCCAGACCGGGACAGGGAGGTATGGCTACACCTTCGGTTCG	CASSQTGTGRYGYTF	1
CAAAAGAACCCGACAGCTTTCTATCTCTGTGCCAGTACCCAGGTACAGGGGGCGGGTCAGCCCCAGCATTTTGGTGAT	CASTQVQGAGQPQHF	1
GACTCGGCCGTGTATGTCTGTGCCAGCAGCTTGGCTGGCGGCGCGGGTATTAACAATGAGCAGTTCTTCGGGCCA	CASSLAGGAGINNEQFF	8
TCTGCTGTGTATTTCTGTGCCAGCAGCCACGGACTAGCGGGAGCCAAAAGAGTGTACCAAGAGACCCAGTACTTCGGGCCA	CASSHGLAGAKRVYQETQYF	6
CCCAGGGACTCAGCTGTGTATTTTTGTGCTAGTGGCGGAGAGGGGCTAGCGGGAGGAAGCTCCTACAATGAGCAGTTCTTCGGGCCA	CASGGEGLAGGSSYNEQFF	3
GACGCAGCCATGTACCTGTGTGCCACCAGCAGAGATCAGCGGGGCACCAACACTGAAGCTTTCTTTGGACAA	CATSRDQRGTNTEAFF	1
CCTCCCAGACATCTGTGTACTTGTGTGCCATCTTGGCGGGAGGGACCGGGGAGCTGTTTTTTGGAGAA	CAILAGGTGELFF	4
CGACTCGGCTGTGTATCTCTGTGCCACCCACGGGTACGGTGAACTATGGCTACACCTTCGGTTCG		3
GACTCGGCCGTGTATCTCTGTGCCAGCAGCCCCCCCCAGACAAATGAGCAGTTCTTCGGGCCA	CASSPPQTNEQFF	1
GACTCGGCCGTGTATGTCTGTGCCAGCAGCTTGGTCGGCGGGGGGGTTGCAGATACGCAGTATTTTGGCCCA	CASSLVGGGVADTQYF	17
CCTCCCAGACATCTGTGTACTTGTGTGCCAGCAGTTCGGGACTAGAATACAATGAGCAGTTCTTCGGGCCA	CASSSGLEYNEQFF	7
AACCCAGGGACTCAGCTGTGTATTTTTGTGCTAGTGGTTTGGTAGGCGGGACATACGCACAGATACGCAGTATTTTGGCCCA		1
GACTCGGCCGTGTATGTCTGTGCCAGCAGCCAAGAGGACGGCGGCGGGGAGACCCAGTACTTCGGGCCA	CASSQEDGGGETQYF	2
ATCCTGAAGACAGCAGCTTCTACATCTGCAGTGCTAGAGAGGGGACTAGCGGCTCTTACAATGAGCAGTTCTTCGGGCCA	CSAREGTSGSYNEQFF	8
GACTCGGCCGTGTATGTCTGTGCCAGCAGCTTCGGGAGACAGGGTGAAAAACTGTTTTTTGGCAGT	CASSFGRQGEKLFF	7
TGGGGGACTCAGCTTTGTATTTCTGTGCCAGCAGTTGGCCGAGCACAGATACGCAGTATTTTGGCCCA	CASSWPSTDTQYF	4
AACCCAGGGACTCAGCTGTGTATTTTTGTGCCACAGAATTACGGAGCACCGGGGAGCTGTTTTTTGGAGAA	CATELRSTGELFF	30
CAAAAGAACCCGACAGCTTTCTATCTCTGTGCCAGCTGCCTCGGCGGGCTAACAAGCAATGAGCAGTTCTTCGGGCCA	CASCLGGLTSNEQFF	2
AACYSRGGGACTCAGCTKTGTATTTYTGTGCCAGCAGATTGAGTAGCGGGAGGCAAGGGGCAGATACGCAGTATTTTGGCCCA	CASRLSSGRQGADTQYF	3
CCTCCCAGACATCTGTGTACTTGTGTGCCAGCAGTTACTCGAGGTCGGGCAGGTCCGCCTACGAGCAGTACTTCGGGCCG	CASSYSRSGRSAYEQYF	20
GACTCGGCCGTGTATSTCTGTGCCAGCAGCCAAGCACTAGCTTACCAAGAGACCCAGTACTTCGGGCCA	CASSQALAYQETQYF	2
TTCTCAGTGACTCTGGCTTCTATCTCTGTGCCTGGAGTAAGCACATCTCACGGCTACACCTTCGGTTCG		6
GGGGGACTCRGCYGTGTATCTCTGTGCCAGCAGCCTGGACCTACCGCGAGGGCAGTACTTCGGGCCG	CASSLDLPRGQYF	2
GACTCGGCCGTGTATGTCTGTGCCAGCAGCTACAGACCGGGACAGGGGTCCTATGGCTACACCTTCGGTTCG	CASSYRPGQGSYGYTF	3
GACTCGGCCATGTATCGCTGTGCCAGCAGCACGGGGGTCGGAGGACTCTATGGCTACACCTTCGGTTCG	CASSTGVGGLYGYTF	5
CCTCCCAGACATCTGTGTACTTGTGTGCCAGCAGTCCCCCCCAAACAGGTCTAGGCTACACCTTCGGTTCG	CASSPPQTGLGYTF	5
AACCCAGGGACTCAGCTGTGTAYTTYTGTGCCAGCAGTTCCTCAAGTAGGGTTAATGAAAAACTGTTTTTTGGCAGT	CASSSSSRVNEKLFF	2
GACTCGGCCGTGTATGTCTGTGCCAGCAGCTTACTGGGCTCCTACAATGAGCAGTTCTTCGGGCCA	CASSLLGSYNEQFF	4
ATCCTGAAGACAGCAGCTTCTACATCTGCAGTGCTAGAAGGCGGGACAATGAGCAGTTCTTCGGGCCA	CSARRRDNEQFF	1
CCCTGAAGACAGCAGCATATATCTCTGCAGCGCTAACCCTAGCGGGAGTCGGGAGCAGTACTTCGGGCCG	CSANPSGSREQYF	11
CAAAAGAACCCGACAGCTTTCTATCTCTGTGCCAGTAGTATAGATCGGACAGAGAAACAAGAGACCCAGTACTTCGGGCCA	CASSIDRTEKQETQYF	2
CCTCCCAGACATCTGTGTACTTGTGTGCCAGCAGTTACTCAGGGAGCGGCTACACCTTCGGTTCG	CASSYSGSGYTF	7
CCCAACCAGACAGCTCTTTACTTCTGTGCCACCAGTGATTCGAGACTGGTGAGGCAGTTCTTCGGGCCA	CATSDSRLVRQFF	4
GACTCGGCCGTGTATGTCTGTGCCAGCAGCTTAGGCAGGAACACCGGGGAGCTGTTTTTTGGAGAA	CASSLGRNTGELFF	9
CAGAACTGGAGGATTCTGGAGTTTATTTCTGTGCCAGCAGCCGCTGGGACAGGTGGGCACTGAAGCTTTCTTTGGACAA		1
GACTCGGCCRTGTATSKCTGTGCCAGCAGCTTCTCGGGACCCTTACCAGATACGCAGTATTTTGGCCCA	CASSFSGPLPDTQYF	1
AACCCAGGGACTCAGCTGTGTATTTTTGTGCCAGCAGTTTCACAGGGGACTATGGCTACACCTTCGGTTCG	CASSFTGDYGYTF	6
CCTCCCAGACATCTGTGTACTTGTGTGCCAGCAGTGAACGTTGGGGCAGGGGCCAGCAGTACTTCGGGCCG	CASSERWGRGQQYF	2
ATCCTGAAGACAGCAGCTTCTACATCTGCAGTGCTAGAGACCCCGGGACAGGGGCCCCCGAGCAGTACTTCGGGCCG	CSARDPGTGAPEQYF	3
TCAGGAGACACAGCACGGTATTTCTGTGCCAGCATTCGACCTAACTATGGCTACACCTTCGGTTCG	CASIRPNYGYTF	11
GACTCGGCCGTGTATGTCTGTGCCAGCAGCCCGAGACCCCCCAGCGGGGGAGATACGCAGTATTTTGGCCCA	CASSPRPPSGGDTQYF	1
TTCTCAGTGACTCTGGCTTCTATCTCTGTGCCTGGAGCCGGGGACAGGAAGGTGGCTACACCTTCGGTTCG	CAWSRGQEGGYTF	3
TGGGGGACTCAGCTTTGTATTTCTGTGCCAGCAGCGTAGTCGCGGGGGCGGGGGCCGGGGAGCTGTTTTTTGGAGAA	CASSVVAGAGAGELFF	3
GCTCCCAGACATCTGTGTATTTCTGCGCCAGCAGTGAGTCTGACCCCTCGACAGGTTGGAACACTGAAGCTTTCTTTGGACAA	CASSESDPSTGWNTEAFF	1
CCTCCCAGACATCTGTGTACTTGTGTGCCATCAGTGAGAGGGGGGACACTGGGGAGCTGTTTTTTGGAGAA	CAISERGDTGELFF	3
CCTCCCAGACATCTGTGTACTTGTGTGCCAGCAGCCGTAGCGGTGCTCGATGGGGGGAGCAGTTCTTCGGGCCA	CASSRSGARWGEQFF	7
CCTCCCAGACATCTGTGTACTTGTGTGCCAGCAGTGAACTAGCGGGAGGAAAGGCCGAGCAGTACTTCGGGCCG	CASSELAGGKAEQYF	2
GACTCGGCCGTGTATGTCTGTGCCAGCAGCTTACGGTAGAAGAACACCGGGGAGCTGTTTTTTGGAGAA	CASSLR*KNTGELFF	3
AACCCAGGGACTCAGCTGTGTATTTTTGTGCTAGTGGTTTGGTAGTAAGAGAGAACACTGAAGCTTTCTTTGGACAA	CASGLVVRENTEAFF	12
AGCTTGGTGACTCTGCTGTGTATTTCTGTGCCAGCAGCCAATTAAGCACAGATACGCAGTATTTTGGCCCA	CASSQLSTDTQYF	2
TGGGGGACTCAGCTTTGTATTTCTGTGCCAGCAACCATAGCTACGGGGGGTCCACCACGAGCAGTACTTCGGGCCG		29
CCTCCCAGACATCTGTGTACTTGTGTGCCAGCAGTTACATCCAGAGATCACCCCTCCACTTTGGGAAC	CASSYIQRSPLHF	8
CCCTGAAGACAGCAGCATATATCTCTGCAGCGTTGAGTCGTTCGTAGGGCTCCAGTTTTTTGGCAGT	CSVESFVGLQFF	1
GACTCGGCCGTGTATGTCTGTGCCAGCAGCCCCAGACAGGCCTTTAACACTGAAGCTTTCTTTGGACAA	CASSPRQAFNTEAFF	1
GACTCGGCCRTGTATSKCTGTGCCAGCAGCCAATCTCCGGGACTAGGCCTTCCTACAATGAGCAGTTCTTCGGGCCA		8
GACTCGGCCGTGTATGTCTGTGCCAGAAGCTTGGAGGACCGACAGGAATGCTTAGCTCCTATAATTCACCCCTCCACTTTGGGAAC		4
CCTCCCAGACATCTGTGTACTTGTGTGCCAGCAGTTGGGCTAGCGGGAACAAAGAGACCCAGTACTTCGGGCCA	CASSWASGNKETQYF	4
CCTCCCAGACATCTGTGTACTTGTGTGCCAGCAGTGAAACAGGGGGAAGCAATCAGCCCCAGCATTTTGGTGAT	CASSETGGSNQPQHF	4
CCTCCCAGACATCTGTGTACTTGTGTGCCAGCAGTGAATAAGGAGTACTCCCCGCAGGCACTGAAGCTTTCTTTGGACAA	CASSE*GVLPAGTEAFF	1
CCTCCCAGACATCTGTGTACTTGTGTGCCAGCAGTTACCCAGGGTACCGCGGCTACACCTTCGGTTCG	CASSYPGYRGYTF	3
CGAGGAGATTCGGCAGCTTATTTCTGTGCCAGCTCACCACGTCCGAACCAGCAAGAGACCCAGTACTTCGGGCCA	CASSPRPNQQETQYF	14
CCTCCCAGACATCTGTGTACTTGTGTGCCAGTAGTTACAGGGGTTCTGAAGCTTTCTTTGGACAA	CASSYRGSEAFF	1
GGCAAGCCACGTTTGGTGCCCCAACCAGACAGCTTTTACTTCTGTGCCACCAGGGGGGAGGAGAGTGATACGCAGTATTTTGGCCCA	CATRGEESDTQYF	1
TYCTCAGTGACTCTGGCTTCTATCTCTGTGCCTGGAGTGGGACGAAAGGTGAAGCTTTCTTTGGACAA	CAWSGTKGEAFF	6
TYRGGRGACWCAGCWYKGTATTTCTGTGCCAGCAGCGGGCGTGGGACAGGGGATGAAAAACTGTTTTTTGGCAGT	CASSGRGTGDEKLFF	34
CCTCCCAGACATCTGTGTACTTGTGTGCCAGCAGTGAAGAGGGTTATGGTGGCTACACCTTCGGTTCG	CASSEEGYGGYTF	1
CCCAACCAGACAGCTCTTTACTTCTGTGCCACCAGTGATTTGCACACAGGGGTAGTTCTTCGGGCCA		4
TGGRGGACTCAGCYRTGTAYYTCTGTGCCAGCAGTTTAGCTCCAGGTTCCTACAATGAGCAGTTCTTCGGGCCA	CASSLAPGSYNEQFF	7
GACTCGGCCRTGTATSKCTGTGCCAGCAGCCCCAGGGATGGGGCTGGAGAGACCCCTCCACTTTGGGAAC		6
GACTCGGCCGTGTATGTCTGTGCCAGCAGCTTAGTGGGAGGGAGCTCCTACGAGCAGTATTTCGGGCCG	CASSLVGGSSYEQYF	8
CCCTGAAGACAGCAGCATATATCTCTGCAGCGTCCGACAGGTTGAACACTGAAGCTTTCTTTGGACAA		1
TSRGGGACTCAGCTKTGTAYTTCTGTGCCAGCAGCGGCGGGACAGGGGGCCGTATGACTACCTATGGCTACACCTTCGGTTCG	CASSGGTGGRMTTYGYTF	5
GAGACACGGCACTGTATCTCTGCGCCAGCAGTCAATTGGAGGGGCAGGGGTTCCTACGAGCAGTACTTCGGGCCG		7
MAGAAGACTCAGCYSYGTATCTCTGCGCCAGCCGCCAGGGGGATGGGGGGAACACTGAAGCTTTCTTTGGACAA	CASRQGDGGNTEAFF	1
CCTCCCAGACATCTGTGTACTTGTGTGCCAGTTACCCCGTATGGGGAGCTAACTATGGCTACACCTTCGGTTCG	CASYPVWGANYGYTF	4
CCCAACCAGACAGCTCTTTACTTCTGTGCCAGCAGTTTATATATGGGGACGGGCCCTCAGTACTTCGGGCCG	CASSLYMGTGPQYF	22
GCTCCCAGACATCTGTGTATTTCTGCGCCAGCAGTGAGTTCGGTAACACTGAAGCTTTCTTTGGACAA	CASSEFGNTEAFF	5
GACTCGGCCGTGTATGTCTGTGCCAGAAATCCCCGGGGGCCCCGGTACACCGGGGAGCTGTTTTTTGGAGAA	CARNPRGPRYTGELFF	3
TCAGGAGACACAGCACGGTATTTCTGTGCCAGAAGGGTGGGGGGGACTGAAGCTTTCTTTGGACAA	CARRVGGTEAFF	2
CRRRRGACTCAGCCSTGTATCTCTRCGCCAGCAGCCAAGTTCAGCTCGGAGATACGCAGTATTTTGGCCCA	XASSQVQLGDTQYF	6
TGGGGGACTCAGCTKTGTATYTCTGTGCCAGCAGCGCGTTCAGGGGGCAGGGCACTGAAGCTTTCTTTGGACAA	CASSAFRGQGTEAFF	1
TCAGGAGACACAGCACGGTATTTCTGTGCCAGCAGCTCGGGACTAGCGCAAGAGACCCAGTACTTCGGGCCA	CASSSGLAQETQYF	8
CCCAACCAGACAGCTCTTTACTTCTGTGCCAGCAGTTTATCGAAGGCCGGGGGAGGCTACACCTTCGGTTCG	CASSLSKAGGGYTF	4
CCTCCCAGACATCTGTGTACTTGTGTGCCAGCAGTTGCCCCGTCGGGAAATGAGCAGTTCTTCGGGCCA		1
CACCAACCAGACATCTATGTACCTCTGTGCCAGCACACCAGGGGGGGCATTTGCAATCGATGAGCAGTTCTTCGGGCCA	CASTPGGAFAIDEQFF	4
CCTCCCAGACATCTGTGTACTTGTGTGCCAGCATCAACCGCCTTTACTATGGCTACACCTTCGGTTCG	CASINRLYYGYTF	30
CAAAAGAACCCGACAGCTTTCTATCTCTGTGCTACCCGAATCGGTCGGCAGATGAACACCGGGGAGCTGTTTTTTGGAGAA	CATRIGRQMNTGELFF	6
CAGAACTGGAGGATTCTGGAGTTTATTTCTGTGCCAGCAGCCAAGAAGGTGGTCTTGAGGCTACACCTTCGGTTCG		3
CCTCCCAGACATCTGTGTACTTGTGTGCCAGCAGTTACCAGGGTGGGACTAGAGGCTACGAGCAGTACTTCGGGCCG	CASSYQGGTRGYEQYF	1
CAAAAGAACCCGACAGCTTTCTATCTCTGTGCCAGTAGCTCGGCGGGATTCTATGAGCAGTTCTTCGGGCCA	CASSSAGFYEQFF	3
GACTCGGCCGTGTATGTCTGTGCCAGCAGCTTCGGCGGGCAGGGTCGCGAGCAGTACTTCGGGCCG	CASSFGGQGREQYF	1
CCTCCCAGACATCTGTGTACTTGTGTGCCAGCAGTCTTAGACAACATCTACGAGCAGTACTTCGGGCCG		14
GACTCGGCCGTGTATCTCTGTGCCAGCAGCTTTCAGTATGCTGAAAAACTGTTTTTTGGCAGT	CASSFQYAEKLFF	14
CCCTGAAGACAGCAGCATATATCTCTGCAGCGCCGATGGGCTTCCCTACAATGAGCAGTTCTTCGGGCCA	CSADGLPYNEQFF	6
CAAAAGAACCCGACAGCTTTCTATCTCTGTGCCAGTAGTCATCCGGAACAATGAGCAGTTCTTCGGGCCA		7
CCTCCCAGACATCTGTGTACTTGTGTGCCAGCAGCACAAATCGGGACCCGACGAACACCGGGGAGCTGTTTTTTGGAGAA	CASSTNRDPTNTGELFF	1
CAAAAGAACCCGACAGCTTTCTATCTCTGTGCCAGTAGGGTGACAGGGGGCGCGGGTTCCGGGGAGCTGTTTTTTGGAGAA	CASRVTGGAGSGELFF	28
ATCCTGAAGACAGCAGCTTCTACATCTGCAGTGCTAGGGACAGGGGCTCCCCAGAGACCCAGTACTTCGGGCCA	CSARDRGSPETQYF	1
GACTCGGCCGTGTATGTCTGTGCCAGCAGCGCAGCTCAGGGGGCAGACTATGGCTACACCTTCGGTTCG	CASSAAQGADYGYTF	6
TCMRGRGACWCAGCWSKGTAYTTCTGTGCCAGCAGTCAGGACAGGGGACAGCCCCAGCATTTTGGTGAT	CASSQDRGQPQHF	4
CCTCCCAGACATCTGTGTACTTGTGTGCCAGCACCAGGGACAGGGGGCGCGGCTACACCTTCGGTTCG	CASTRDRGRGYTF	3
GACTCGGCCGTGTATGTCTGTGCCAGCAGTGCTACGCTTGACGGAAATCAACCCCAGCATTTTGGTGAT	CASSATLDGNQPQHF	2
AGCTTGGTGACTCTGCTGTGTATTTCTGTGCCAGCAGCACACTAGCGGGGAGTAATAATGAGCAGTTCTTCGGGCCA	CASSTLAGSNNEQFF	4
CCCAACCAGACAGCTCTTTACTTCTGTGCCAGCAGTCCCCGCATTCAGAGTTAAGTGTGGCACACCTTCGGTTCG	CASSPRIQS*VWHTF	15
CCTCCCAGACATCTGTGTACTTGTGTGCCGGACAATAGGGGCCCTTATGGCTACACCTTCGGTTCG		2
CGAGGAGATTCGGCAGCTTATTTCTGTGCCAGCTCACCCGGGGGCTATGGGGAGCAGTTCTTCGGGCCA	CASSPGGYGEQFF	1
CAGAACTGGAGGATTCTGGAGTTTATTTCTGTGCCAGCAGCCAAGATTCGGCAGCTAGCACAGATACGCAGTATTTTGGCCCA	CASSQDSAASTDTQYF	1
TTCTCAGTGACTCTGGCTTCTATCTCTGTGCCTGGGGCACCCGGGGGGGCCTCTATGGCTACACCTTCGGTTCG	CAWGTRGGLYGYTF	5
GACTCGGCCGTGTATGTCTGTGCCAGCAGCCCCCATAGCGGGAGCTACAATGAGCAGTTCTTCGGGCCA	CASSPHSGSYNEQFF	1
GACTCGGCCGTGTATGTCTGTGCCAGCAGCTTAGTCAGGGGGTACACTGAAGCTTTCTTTGGACAA	CASSLVRGYTEAFF	3
GACTCGGCCGTGTATGTCTGTGCCAGCAGCTCCGGACTCGGAATTGCAGATACGCAGTATTTTGGCCCA	CASSSGLGIADTQYF	1
AACCCAGGGACTCAGCTGTGTATTTTTGTGCCAGCAGTAGGGGGGACGCGGCGGCCGAGCAGTACTTCGGGCCG	CASSRGDAAAEQYF	3
TSRGGGACTCAGCTKTGTAYTTCTGTGCCAGCACTCTGGGCGGGACCGGGCAAGAGACCCAGTACTTCGGGCCA	CASTLGGTGQETQYF	25
GACTCGGCCGTGTATGTCTGTGCCAGCAGCCGCGGTGTTTTCGGTCCCAAGATACGCAGTATTTTGGCCCA		6
CAAAAGAACCCGACAGCTTTCTATCTCTGTGCCAGTAGTATAGCCCGGTCGGAACCAATATGAACACTGAAGCTTTCTTTGGACAA		15
CTCCCTCYCAGACWTCTGTKTACTTSTGTGCCAGCACCCTACCGGCGGGAGGGCCCTCGTTCGGGGAGCTGTTTTTTGGAGAA	CASTLPAGGPSFGELFF	21
CCTCCCAGACATCTGTGTACTTGTGTGCCAGCAGTCCGGCGGATTCGGACGAGCAGTACTTCGGGCCG	CASSPADSDEQYF	1
TGGGGGACTCAGCTTTGTATTTCTGTGCCAGCAGCGTAGTACCGGGGGCCGAAACCCTTTCATCAGCCCCAGCATTTTGGTGAT		1
ATCCTGAAGACAGCAGCTTCTACATCTGCAGTGCTAGAGATCTCGAGAGCGGGAGGACTGAAGCTTTCTTTGGACAA	CSARDLESGRTEAFF	1
TTCTCAGTGACTCTGGCTTCTATCTCTGTGCCCAATGGGGGCCAACTAATGAAAAACTGTTTTTTGGCAGT	CAQWGPTNEKLFF	1
TGTACCCTCYCAGACATCTGTGTACTTSTGTGCCAGCAGTGACTATCCCGGGAGTCGGGTCTTTGGACAA	CASSDYPGSRVF	1
GGACTCGGCCCTTTATCTTTGCGCCAGCAGCTTCGATGGACAGGGCGGCAATCAGCCCCAGCATTTTGGTGAT	CASSFDGQGGNQPQHF	2
GACTCGGCCGTGTATGTCTGTGCCAGCAGCCCAAATTCGATGGGACCCCAAGAGACCCAGTACTTCGGGCCA	CASSPNSMGPQETQYF	1
GACTCGGCCGTGTATGTCTGTGCCAGCAGCTTGGCCGGGGGGCTCTATTATTCACCCCTCCACTTTGGGAAC	CASSLAGGLYYSPLHF	6
CCTCCCAGACATCTGTGTACTTGTGTGCCAGCAGTCCCCGAGGACAGGGCTACGAGCAGTACTTCGGGCCG	CASSPRGQGYEQYF	2
CCCAACCAGACAGCTCTTTACTTCTGTGCCAGCAGTTTGTCGGGCCAGGGGGTAAGCAACGAGCAGTACTTCGGGCCG	CASSLSGQGVSNEQYF	25
GACTCGGCCGTGTATGTCTGTGCCAGCAGCCAAGGGAGCGGCCTAACCTACGAGCAGTACTTCGGGCCG	CASSQGSGLTYEQYF	5
GACTCGGCCGTGTATGTCTGTGCCAGCAGCTTACCCAGAACCCCCCACGAGCAGTACTTCGGGCCG	CASSLPRTPHEQYF	7
CCTCCCAGACATCTGTGTACTTGTGTGCCAGCAGTCCCTTTAGAACCGGGGAGCTGTTTTTTGGAGAA	CASSPFRTGELFF	12
CCTCCCAGACATCTGTGTACTTGTGTGCCAGCAGAGATAACAGGCGATACACTGAAGCTTTCTTTGGACAA	CASRDNRRYTEAFF	2
CCTCCCAGACATCTGTGTACTTGTGTGCCAGCAGTTACTCGCCTAGCGGGAGGCACGAGCAGTACTTCGGGCCG	CASSYSPSGRHEQYF	2
ATCCTGAAGACAGCAGCTTCTACATCTGCAGTGCTAGAAGGGCAGGGGGCGTTAACACTGAAGCTTTCTTTGGACAA	CSARRAGGVNTEAFF	15
GACTCGGCCGTGTATGTCTGTGCCAGCAGCTTACAGGGTTCGGCGGGGACAGGCCTGAACACTGAAGCTTTCTTTGGACAA	CASSLQGSAGTGLNTEAFF	1
CGAGGAGATTCGGCAGCTTATTTCTGTGCCAGCTCACCGGGCGACAGGGGTACCTACGAGCAGTACTTCGGGCCG	CASSPGDRGTYEQYF	2
GGGGGACTYGGCYRTGTATCTCTGTGCCAGCAGCCTCGACGGTTTCTACAATGAGCAATTCTTCGGGCCA	CASSLDGFYNEQFF	1
GACTCGGCCGTGTATGTCTGTGCCAGCAGCTTGGTTCTGAGGAACACTGAAGCTTTCTTTGGACAA	CASSLVLRNTEAFF	5
CACCAACCAGACATCTATGTACCTCTGTGCCAGCAAACGTCAGAACACTGAAGCTTTCTTTGGACAA	CASKRQNTEAFF	6
GACTCGGCCGTGTATGTCTGTGCCAGCAGCCTAGGAGCCAAGATCGGGGGGCAAGATACGCAGTATTTTGGCCCA	CASSLGAKIGGQDTQYF	9
CACCAACCAGACATCTATGTACCTCTGTGCCAGCAGTTTCTCGTCCGCAGGGCAGGGCGAGCAGTACTTCGGGCCG	CASSFSSAGQGEQYF	1
GACTCGGCCGTGTATGTCTGTGCCAGCAGCTTGGAGGGCGAAGGGGGTGAGCAGTTCTTCGGGCCA	CASSLEGEGGEQFF	4
GACTCGGCCGTGTATGTCTGTGCCAGCAGCTTAGTCGACGGGACAGCTAATGAAAAACTGTTTTTTGGCAGT	CASSLVDGTANEKLFF	18
TGGGGGACTCAGCTTTGTATTTCTGTGCCAGCAGGGACCAGACAGGGGCGATCGGGGAGCTGTTTTTTGGAGAA	CASRDQTGAIGELFF	14
ATCCTGAAGACAGCAGCTTCTACATCTGCAGTGTCGGGGGTTGGACGGCTAGCACAGATACGCAGTATTTTGGCCCA	CSVGGWTASTDTQYF	7
TGGGGGACTCAGCTTTGTATTTCTGTGCCAGCACCCTAGCGGGGAACTATGGCTACACCTTCGGTTCG	CASTLAGNYGYTF	4
CAGAAGACTCAGCCCTGTATCTCTGCACCAGCAGCCAAGAGGGGGTGGGGGGGGTGCTACGAGCAGTACTTCGGGCCG		1
GGACTCGGCCCTTTATCTTTGCGCCAGCAGCTTGGGTGGGACAGGGGTGTACGAGCAGTACTTCGGGCCG	CASSLGGTGVYEQYF	1
MAGAAGACTCAGCYSYGTATCTCTGCGCCAGCAGCCAAGTACCAGAAGAGACCCAGTACTTCGGGCCA	CASSQVPEETQYF	1
GACTCGGCCGTGTATCTCTGTGCTAGCAGCTTACAGTTAGTGGAGACCCAGTACTTCGGGCCA	CASSLQLVETQYF	7
GACTCGGCCGTGTATGTCTGTGCCAGCAGCTTAGGGACAGCGGGGTCTGGCGAGCAGTACTTCGGGCCG	CASSLGTAGSGEQYF	1
GACGCAGCCATGTACCTGTGTGCCACCAGCAGAGATCTGGACAGGGTGACCGGGGAGCTGTTTTTTGGAGAA	CATSRDLDRVTGELFF	7
AAGAAGACTCAGCTGCGTATCTCTGCGCCAGCAGCCAAGCCCTTGGGGATCGCGGAAGCTCCTACGAGCAGTACTTCGGGCCG	CASSQALGDRGSSYEQYF	7
CCCAACCAGACAGCTCTTTACTTCTGTGCCAGCCGATTGGACAGGGGTATAATTCACCCCTCCACTTTGGGAAC		6
TGGGGGACTCAGCTTTGTATTTCTGTGCCAGCAGCGTACTGACAGAACTAGGGGGTGAGCAGTTCTTCGGGCCA	CASSVLTELGGEQFF	3
TCAGGAGACACAGCACGGTATTTCTGTGCCAGCAGTTCGGCAGGCTACAACACCGGGGAGCTGTTTTTTGGAGAA	CASSSAGYNTGELFF	3
AACYSRGGGACTCAGCTKTGTATTTYTGTGCCAGCAGCCCATTAGGACAGGGTAGCTCCTACGAGCAGTACTTCGGGCCG	CASSPLGQGSSYEQYF	10
CAGAAGACTCAGCCCTGTATCTCTGCGCCAGCAGCCAAGATATAACTATGGCTACACCTTCGGTTCG		4
ATCCTGAAGACAGCAGCTTCTACATCTGCAGTGGGTCCCAGGGAGGGGCGGACGAGCAGTACTTCGGGCCG	CSGSQGGADEQYF	5
TSRGGGACTCAGCTKTGTAYTTCTGTGCCAGCAGTGAATCAAGGGAGCAGCCCCAGCATTTTGGTGAT	CASSESREQPQHF	4
GACTCGGCCGTGTATGTCTGTGCCAGCAGCCGGGGGGGCGGGAATCGGCCCCAGCATTTTGGTGAT	CASSRGGGNRPQHF	1
ATCCTGAAGACAGCAGCTTCTACATCTGCAGTGCTATTATGGCGTCGAACACTGAAGCTTTCTTTGGACAA	CSAIMASNTEAFF	1
TYCTCAGTGACTCTGGCTTCTATCTCTGTGCCTGGAGTGTACCCGGGACAGCAACCTACAATGAGCAGTTCTTCGGGCCA	CAWSVPGTATYNEQFF	3
CAACCAGACAGCTCTTTACTTCTGTGCCACCTCCCGGGGTGAGTGGGGTCCGTAATCCACTCTGGAAACACCATATATTTTGGAGAG		29
GGACTCGGCCCTTTATCTTTGCGCCAGCAGCCCGGACAGGGCCCCCCGCGAGCAGTACTTCGGGCCG	CASSPDRAPREQYF	2
CACCAACCAGACATCTATGTACCTCTGTGCCACCAAAGCCCACAGTAAATTCTATGGCTACACCTTCGGTTCG	CATKAHSKFYGYTF	9
TGGRGGACTCAGCYWTGTAYTTCTGTGCCAGCAGTGGGCAGTATACTGTGCCCCAGCATTTTGGTGAT	CASSGQYTVPQHF	2
SGACTCGGCYSTGTATCTCTGTGCCAGCAGCCAAGGGAGGGCCCAGGGAGTCTATGGCTACACCTTCGGTTCG	CASSQGRAQGVYGYTF	6
TTTCTGTGCCAGCGCCTGGCTGGCTAAAGCGTAGATAGGACTAGCGGGGGGTCAAGAGACCCAGTACTTCGGGCCA	CASAWLAKA*IGLAGGQETQYF	1
CCTCCCAGACATCTGTGTACTTGTGTGCCATCAGTGAGTCATTAGGGACAGGGAGGAGCACTGAAGCTTTCTTTGGACAA	CAISESLGTGRSTEAFF	1
CCTCCCAGACATCTGTGTACTTGTGTGCCAGTAAGCTCGAGGGGGGGACTGAAGCTTTCTTTGGACAA	CASKLEGGTEAFF	2
GACTCGGCCGTGTATGTCTGTGCCAGCAGCACGGGACAGGGGAGGAACACTGAAGCTTTCTTTGGACAA	CASSTGQGRNTEAFF	3
CGAGGAGATTCGGCAGCTTATTTCTGTGCCAGCCAAGGGGACCCGGAGACCCAGTACTTCGGGCCA	CASQGDPETQYF	2
CCTCCCAGACATCTGTGTACTTGTGTGCCAGCAGTGGCCTTCTTGGGGACGGGCTCCCCTGGCTACACCTTCGGTTCG		2
AACCCAGGGACTCAGCTGTGTAYTTYTGTGCCAGCACCCAAAACCGGGACTAGCGGGAGGTCCGAGACCCAGTACTTCGGGCCA		2
AACCCAGGGACTCAGCTGTGTAYTTYTGTGCCAGCAGCCTCCCCGACGACGCTGGAAACACCATATATTTTGGAGAG	CASSLPDDAGNTIYF	3
CAAAAGAACCCGACAGCTTTCTATCTCTGTGCCAGTAGTATTAAGAACACCATATATTTTGGAGAG	CASSIKNTIYF	1
GACTCGGCCRTGTATSKCTGTGCCAGCAGCTTATCGAGAACTTCATAGCCAAAAACATTCAGTACTTCGGCGCC		1
CCTCCCAGACATCTGTGTACTTGTGTGCCAGCAGTTACGGGGCACAGGGCTGGGGAGAGACCCAGTACTTCGGGCCA	CASSYGAQGWGETQYF	6
GACTCGGCCGTGTATGTCTGTGCTAGCAGCTTAAAAAGGCAGGTCAACACTGAAGCTTTCTTTGGACAA	CASSLKRQVNTEAFF	5
GACTCGGCCGTGTATGTCTGTGCCAGCAGCGGGGACAGCCTAGCCAAAAACATTCAGTACTTCGGCGCC	CASSGDSLAKNIQYF	44
GACTCGGCCRTGTATSKCTGTGCCAGCAGCTTAGCTAATAGCAATCAGTCCCAGCATTTTGGTGAT	CASSLANSNQSQHF	2
GACTCGGCCGTGTATGTCTGTGCCAGCAGCCGTACAGCTCTGGGGCCAACGTCCTGACTTTCGGGGCC		1
GACTCGGCCGTGTATGTCTGTGCCAGCAGCTTAGACCCGGGGAGCTACGAGCAGTACTTCGGGCCG	CASSLDPGSYEQYF	16
GAAGACTCAGCCCTGTATCTCTGCGCCAGCAGCCAAGATATAAGCTTGGTAGGACAGGGACTTACCTACGAGCAGTACTTCGGGCCG	CASSQDISLVGQGLTYEQYF	6
GACTCGGCCGTGTATGTCTGTGCCAGCAGCTTAATAGGGACTAGTCTTTACAATGAGCAGTTCTTCGGGCCA	CASSLIGTSLYNEQFF	6
TGTACCCTCYCAGACATCTGTGTACTTSTGTGCCAGCTCCCCCTCTGGGGCCAACGTCCTGACTTTCGGGGCC	CASSPSGANVLTF	2
GACTCGGCCGTGTATGTCTGTGCCAGCAGCTTGGGGGCAACAGGGGTCAGCACAGATACGCAGTATTTTGGCCCA	CASSLGATGVSTDTQYF	11
CCTCCCAGACATCTGTGTACTTGTGTGCCAGCAGAGGGAGGTCCTACAATGAGCAGTTCTTCGGGCCA	CASRGRSYNEQFF	16
AGCTTGGTGACTCTGCTGTGTATTTCTGTGCCAGCAGCCATACGTCCAGGTTCTACGAGCAGTACTTCGGGCCG	CASSHTSRFYEQYF	2
MAGAAGACTCAGCYSYGTATCTCTGCGCCAGCAGCCAGGTTACAGGGGTGGGTGGCTACACCTTCGGTTCG	CASSQVTGVGGYTF	16
CAAAAGAACCCGACAGCTTTCTATCTCTGTGCCAGTACCCCGGACAGGTCCCATGGCTACACCTTCGGTTCG	CASTPDRSHGYTF	18
GACGCAGCCATGTACCTGTGTGCCACCAGCAGAGAACGAGGGGGCGAAGATACGCAGTATTTTGGCCCA	CATSRERGGEDTQYF	5
AACCCAGGGACTCAGCTGTGTAYTTYTGTGCCAGCACTGGACCTGAGGGCGAGACCCAGTACTTCGGGCCA	CASTGPEGETQYF	20
GACTCGGCCGTGTATGTCTGTGCCAGCAGCTTATCGATGCCTTACAATGAGCAGTTCTTCGGGCCA	CASSLSMPYNEQFF	8
CAAAAGAACCCGACAGCTTTCTATCTCTGTGCCAGTAGTAGAACCCGGGACACCACCTACGAGCAGTACTTCGGGCCG	CASSRTRDTTYEQYF	2
CAAAAGAACCCGACAGCTTTCTATCTCTGTGCCAGTAGCACCGCCAGACAGGGGGCGAATACGCAGTATTTTGGCCCA	CASSTARQGANTQYF	6
CAAAAGAACCCGACAGCTTTCTATCTCTGTGCCAGTAATGGGGGCCCAGGCAGGGAGAATGAGCAGTTCTTCGGGCCA	CASNGGPGRENEQFF	1
CACCAACCAGACATCTATGTACCTCTGTGCCAGCAGAGAAGAGGACAGGCGCTCCTACGAGCAGTACTTCGGGCCG	CASREEDRRSYEQYF	1
CCAGGGACTCAGCTGTGTATTTTTGTGCCAGCAGTCCCCACGGACTAGCGGGAGGGCCCTCTCAAGGAGACCCAGTACTTCGGGCCA		15
AACCCAGGGACTCAGCTGTGTATTTTTGTGCTAGCGCCGCCCGGGTATACGAGCAGTACTTCGGGCCG	CASAARVYEQYF	12
CCTCCCAGACATCTGTGTACTTGTGTGCCAGCAGGCCAATAAACTATGGCTACACCTTCGGTTCG	CASRPINYGYTF	2
CCAACCAGACCTCTCTGTACTTCTGTGCCAGCTGCCGGGACGGAGATACCCTAACTATGGCTACACCTTCGGTTCG		1
GACTCGGCCRTGTATSKCTGTGCTAGCAGCCCTGTCGCGAACACCGGGGAGCTGTTTTTTGGAGAA	CASSPVANTGELFF	1
CACCAACCAGACATCTATGTACCTCTGTGCCAGCAGTTTATGGGGGACTGGGGACGCTGAAGCTTTCTTTGGACAA	CASSLWGTGDAEAFF	7
CCTCCCAGACATCTGTGTACTTGTGTGCCAGCAGTTACTCGCCGGGAGGCACTGAAGCTTTCTTTGGACAA	CASSYSPGGTEAFF	1
CAGGGACTCAGCTGTGTACTTCTGTGCCAGCATATCGGACAGCAACAGCGGGGAGCTGTTTTTTGGAGAA	CASISDSNSGELFF	35
CCTCCCAGACATCTGTGTACTTGTGTGCCAGCAGTTACCTACTGAGGGCAGACGACTATGGCTACACCTTCGGTTCG	CASSYLLRADDYGYTF	1
AGCTTGGTGACTCTGCTGTGTATTTCTGTGCCAGCAGCCAAGCCGGGAATGGCTACACCTTCGGTTCG	CASSQAGNGYTF	2
AACCCAGGGACTCAGCTGTGTAYTTYTGTGCCAGCAGTTTTCGAGGGGGCGGTGGCTACACCTTCGGTTCG	CASSFRGGGGYTF	2
TGGGGGACTCAGCTTTGTATTTCTGTGCCAGCAGCGTAGCATCCGTCGGGAGCGAGCAGTACTTCGGGCCG	CASSVASVGSEQYF	4
CAGGGACTCAGCTGTGTACTTCTGTGCCAGCAGTTTAGGGCGAGGGGGCAAGAGACCCAGTACTTCGGGCCA		2
CCTCCCAGACATCTGTGTACTTGTGTGCCAGCAGTGAAACCGACAGGGGTGAGCAGTTCTTCGGGCCA	CASSETDRGEQFF	2
CAGGGACTCAGCTGTGTACTTCTGTGCCAGCAGGGGGACTAACAGGGGCACAGATACGCAGTATTTTGGCCCA	CASRGTNRGTDTQYF	2
CAAAAGAACCCGACAGCTTTCTATCTCTGTGCCAGTAGTATAGGGACTGAGCGGGGGGGCCCGGATGAGCAGTTCTTCGGGCCA	CASSIGTERGGPDEQFF	1
GGACTCGGCCCTTTATCTTTGCGCCAGCAGCTCCCCGGGACAGGGAACAGATACGCAGTATTTTGGCCCA	CASSSPGQGTDTQYF	1
GGACTCGGCCCTTTATCTTTGCGCCAGCAGCCCTACTAGCGGAGGGACCGGGGAGCTGTTTTTTGGAGAA	CASSPTSGGTGELFF	40
CAAAAGAACCCGACAGCTTTCTATCTCTGTGCCAGTAGTATTCAAGCGGGGGCGTCCTACAATGAGCAGTTCTTCGGGCCA	CASSIQAGASYNEQFF	4
GACTCGGCCGTGTATGTCTGTGCCAGCAGCTCCCCCCGGGGCGACCAAGAGACCCAGTACTTCGGGCCA	CASSSPRGDQETQYF	3
TGYWCCCTCTCAGACWTCTGTKTACTTCTGTGCCATCCGAGCCTCCTACGAGCAGTACTTCGGGCCG	CAIRASYEQYF	1
AACCCAGGGACTCAGCTGTGTATTTTTGTGCTAGTGGTTGGAGGGACAGGGGGCTACGAGCAGTACTTCGGGCCG		3
AGCTTGGTGACTCTGCTGTGTATTTCTGTGCCAGCAACGGACAGGGAACTTCACTTGGGGGCTACACCTTCGGTTCG	CASNGQGTSLGGYTF	8
CCAGGGACTCAGCTGTGTATTTTTGTGCCAGCAGCTCCCCCGGACACAAAGGGGGGGAGCTCCTACAATGAGCAGTTCTTCGGGCCA		13
TSRGGGACTCAGCTKTGTAYTTCTGTGCCAGCAGTGCTCCGGGACAGGCGAACACTGAAGCTTTCTTTGGACAA	CASSAPGQANTEAFF	2
TGGGGGACTCAGCTTTGTATTTCTGTGCCAGCAGCGTTGGGACGGGTAACACTGAAGCTTTCTTTGGACAA	CASSVGTGNTEAFF	1
AGCTTGGTGACTCTGCTGTGTATTTCTGTGCCAGCAGCCAAGAACACCTCTGCGAGCAGTACTTCGGGCCG	CASSQEHLCEQYF	21
CGAGGAGATTCGGCAGCTTATTTCTGTGCCAGCTCGATAATGTAAACGGGGGGCATAGCACAGATACGCAGTATTTTGGCCCA		4
TGGGGGACTCAGCTTTGTATTTCTGTGCCATATCGGGAGGCCCCTACAATGAGCAGTTCTTCGGGCCA	CAISGGPYNEQFF	3
GACTCGGCCRTGTATSKCTGTGCCAGCAGCCCGCGAGATTGGCGGGGAGTAACCTACGAGCAGTACTTCGGGCCG	CASSPRDWRGVTYEQYF	1
TGGGGGACTCAGCTTTGTATTTCTGTGCCAGCAGCGATACCCCCGGACAGCCCTATAATTCACCCCTCCACTTTGGGAAC	CASSDTPGQPYNSPLHF	2
CCCTGAAGACAGCAGCATATATCTCTGCAGCGTCCGGGGGTGGTATACGAGCAGTACTTCGGGCCG		10
TGGGGGACTCAGCTTTGTATTTCTGTGCCAGCAGTGCGGACGGGGGGGAAAAACTGTTTTTTGGCAGT	CASSADGGEKLFF	1
TCAGGAGACACAGCACGGTATTTCTGTGCCAGCAGCCCTATGAGCGGGGGGCCTAATGAGCAGTTCTTCGGGCCA	CASSPMSGGPNEQFF	2
CAAAAGAACCCGACAGCTTTCTATCTCTGTGCCAGTAGTCGGGCCTGGGGCTCCTACAATGAGCAGTTCTTCGGGCCA	CASSRAWGSYNEQFF	5
CAGCCATGTACCTGTGTGCCACCAGCAGAGATCACGGGGAGGACTAGCGGGAGGTGGGTATGGTGAGAGACCCAGTACTTCGGGCCA		12
GACTCGGCCGTGTATCTCTGTGCCAGCAGCTTAGATGGATGGGGGAGTTTCCATTTTGGTGAT	CASSLDGWGSFHF	7
CCTCCCAGACATCTGTGTACTTGTGTGCCAGCACGGGACTAGCGGTAGCATACGAGCAGTACTTCGGGCCG	CASTGLAVAYEQYF	2
GACGCAGCCATGTACCTGTGTGCCACCAGCAGAGATAGGGCCCTTAAGACGGAGACCCAGTACTTCGGGCCA	CATSRDRALKTETQYF	13
CCCTGAAGACAGCAGCATATATCTCTGCAGCGTTGGGGACAACCGACGGAGGAACACTGAAGCTTTCTTTGGACAA	CSVGDNRRRNTEAFF	4
CAGAACTGGAGGATTCTGGAGTTTATTTCTGTGCCAGGAAGCTCGGCAGCGGGAGGGTTAACAATGAGCAGTTCTTCGGGCCA	CARKLGSGRVNNEQFF	8
GGACTCRGCCRTGTATSKCTGTGCTAGCAGCTTAGCAACGTACTAGCGGCCATTCCTACAATGAGCAGTTCTTCGGGCCA		1
CCTCCCAGACATCTGTGTACTTGTGTGCCAGCAGTGATACGGGACAGCCAAAAACATTCAGTACTTCGGCGCC		7
AACCCAGGGACTCAGCTGTGTATTTTTGTGCCAGCAGTTCCGCAGATACGCAGTATTTTGGCCCA	CASSSADTQYF	5
GACTCGGCCGTGTATGTCTGTGCCAGCAGCGGGACAGGGGTGGCATACGAGCAGTACTTCGGGCCG	CASSGTGVAYEQYF	7
CGAGGAGATTCGGCAGCTTATTTCTGTGCCAGCTCGCCTCAGGGGGCTGCCTATGGCTACACCTTCGGTTCG	CASSPQGAAYGYTF	1
CCTCCCAGACATCTGTGTACTTGTGTGCCAGCAGTTACTCGGGACCAGACACAGATACGCAGTATTTTGGCCCA	CASSYSGPDTDTQYF	2
GACTCGGCCGTGTATCTCTGTGCCAGCAGCCCTCGGGGGTACAATGAGCAGTTCTTCGGGCCA	CASSPRGYNEQFF	2
CCTCCCAGACATCTGTGTACTTGTGTGCCAGCAGTTACTCGAAGGGGCCCTGGCAGATACGCAGTATTTTGGCCCA		20
GCTCCCAGACATCTGTGTATTTCTGCGCCAGCAGTGCCGGGACTCGGGGGGGAAATGAGCAGTTCTTCGGGCCA	CASSAGTRGGNEQFF	12
CAAAAGAACCCGACAGCTTTCTATCTCTGTGCCAGTAGTTCACCGGGACGTAATGAAAAACTGTTTTTTGGCAGT	CASSSPGRNEKLFF	3
TYRGGRGACWCAGCWYKGTATTTCTGTGCCAGCAGTGAAATGTCTAGCGGAAGCTCCTACAATGAGCAGTTCTTCGGGCCA	CASSEMSSGSSYNEQFF	3
GACTCGGCCGTGTATGTCTGTGCCAGCAGCTTAGTTTCTCGGGGCGGGACAGATACGCAGTATTTTGGCCCA	CASSLVSRGGTDTQYF	4
GACTCGGCCGTGTATSTCTGTGCCAGCAGCTTGGGGACAGGGCATCGCTACGAGCAGTACTTCGGGCCG	CASSLGTGHRYEQYF	1
CCTCCCAGACATCTGTGTACTTGTGTGCCAGCAGGGGAGAAGGGTTGACTGAAGCTTTCTTTGGACAA	CASRGEGLTEAFF	1
GACTCGGCCGTGTATGTCTGTGCAAGTCGCTYTCTGCTCCAGACTAGCGACTAAGGGAGACCCAGTACTTCGGGCCA		3
ATCCTGAAGACAGCAGCTTCTACATCTGCAGTGCTAGGGGGACAGGGGGAGGGCAGTACTTCGGGCCG	CSARGTGGGQYF	1
GCTCCCAGACATCTGTGTATTTCTGCGCCAGCAGTGAGTCTCGCGGGGGGCCGGGTGAGCAGTTCTTCGGGCCA	CASSESRGGPGEQFF	4
CCCTGAAGACAGCAGCATATATCTCTGCAGCGTTGTGGACAGCAACCAAGAGACCCAGTACTTCGGGCCA	CSVVDSNQETQYF	16
ATCCTGAAGACAGCAGCTTCTACATCTGCAGTGCTAGAGATCGTCAAGAGACCCAGTACTTCGGGCCA	CSARDRQETQYF	1
CTCCCTCTCAGACTTCTGTTTACTTCTGTGCCAGCAGTGTTATCGCCCTAGATACGCAGTATTTTGGCCCA	CASSVIALDTQYF	3
GACTCGGCCGTGTATGTCTGTGCCAGCAGCTTAACGGAGGACAGGGGGCTGAAAAACTGTTTTTTGGCAGT		39
GACTCGGCCGTGTATGTCTGTGCCAGCAGCTTCGGCCAGATGAACACTGAAGCTTTCTTTGGACAA	CASSFGQMNTEAFF	3
GACTCGGCCGTGTATGTCTGTGCCAGCAGCTATGGGACAGGGACCTATGGCTACACCTTCGGTTCG	CASSYGTGTYGYTF	5
AACCCAGGGACTCAGCTGTGTATTTTTGTGCCAGCAGCCGGTTGACAGGGAACACCGGGGAGCTGTTTTTTGGAGAA	CASSRLTGNTGELFF	6
ARRRRGACTCAGCYGYGTATCTCTRCGCCAGCAGCCAAGATAGGATAGACCCCTACGAGCAGTACTTCGGGCCG	XASSQDRIDPYEQYF	20
CCTCCCAGACATCTGTGTACTTGTGTGCCAGCAGTGACCTAGCGGATTTGGATACGTAGTATTTTGGCCCA	CASSDLADLDT*YF	7
GACTCGGCCGTGTATGTCTGTGCCAGCAGCCAAGAGACTAGCGGGGGGGCCGATACGCAGTATTTTGGCCCA	CASSQETSGGADTQYF	9
CCCTGAAGACAGCAGCATATATCTCTGCAGCGTTGTGGGGACAGCCAACACTGAAGCTTTCTTTGGACAA	CSVVGTANTEAFF	4
ATCCTGAAGACAGCAGCTTCTACATCTGCAGTGCTAGACCGAGCGGGAGGGGCTCCTACAATGAGCAGTTCTTCGGGCCA	CSARPSGRGSYNEQFF	7
GACTCGGCCGTGTATCTCTGTGCCAGCAGCAAGACTAGCACAGATACGCAGTATTTTGGCCCA	CASSKTSTDTQYF	2
TGYWCCCTCTCAGACWTCTGTKTACTTCTGTGCCAGCAGTTACGTCCATACGCAGTATTTTGGCCCA	CASSYVHTQYF	3
ATCCTGAAGACAGCAGCTTCTACATCTGCAGTGCTACCGGGACGGGAACACTGAAGCTTTCTTTGGACAA		5
CCCTGAAGACAGCAGCATATATCTCTGCAGCGTTGGAACAGAGCGAGAGACCCAGTACTTCGGGCCA	CSVGTERETQYF	4
GACTCGGCCRTGTATSKCTGTGCCAGCAGCCGAATTCCAGACACTTGGAACCAAGCTTTCTTTGGACAA	CASSRIPDTWNQAFF	5
CCTCACATACCTCTCAGTACCTCTGTGCCAGCAGTGAGGGTAATACAGATACGCAGTATTTTGGCCCA	CASSEGNTDTQYF	4
GGACTCGGCCCTTTATCTTTGCGCCAGCAGCTGGCCGACAGACCAGGGGAACATTCAGTACTTCGGCGCC	CASSWPTDQGNIQYF	25
GACTCGGCCGTGTATGTCTGTGCCAGCAGCCGTGCCGGGACCTCCTATGGCTACACCTTCGGTTCG	CASSRAGTSYGYTF	14
GAGACACGGCACTGTATCTCTGCGCCAGCAGTCAATCGGGACAGGGGGACGAAYACCGGGGAGCTGTTTTTTGGAGAA		2
CCTCCCAGACATCTGTGTACTTGTGTGCCAGCAGTTACCGATACAATGAGCAGTTCTTCGGGCCA	CASSYRYNEQFF	3
GACTCGGCCGTGTATCTCTGTGCCAGCAGCTTAGGCCCCCGGGGCGAGCAGTACTTCGGGCCG	CASSLGPRGEQYF	13
CCTCCCAGACATCTGTGTACTTGTGTGCCAGCAGTGAAGTTAGGGTACCTCCTACGAGCAGTACTTCGGGCCG		1
CAAAAGAACCCGACAGCTTTCTATCTCTGTGCCAGTAGTATAGATCGGTCTGTGAGTGAGCAGTTCTTCGGGCCA	CASSIDRSVSEQFF	1
CGACTCGGCYGTGTATSTCTGTGCCAGCAGCCGCGAAGTAGCGGGGGGCAATGAGCAGTTCTTCGGGCCA	CASSREVAGGNEQFF	3
AACCCAGGGACTCAGCTGTGTATTTTTGTGCCAGCAGTTTGAGGGCTTTGAATGAAAAACTGTTTTTTGGCAGT	CASSLRALNEKLFF	7
ATCCTGAAGACAGCAGCTTCTACATCTGCAGTGCCTGGCGGGCGACTGAAGCTTTCTTTGGACAA	CSAWRATEAFF	10
GGACTCGGCCCTTTATCTTTGCGCCAGCAGCTTGGTCGTAGGGCTCCCGGAGACCCAGTACTTCGGGCCA	CASSLVVGLPETQYF	12
GACTCGGCCGTGTATGTCTGTGCCAGCAGCTTGACAGGCCCAACTAATGAAAAACTGTTTTTTGGCAGT	CASSLTGPTNEKLFF	2
GACTCGGCCGTGTATGTCTGTGCCAGCAGCTCGACAGGGGGCGCGACGGGAACTGAAGCTTTCTTTGGACAA	CASSSTGGATGTEAFF	1
CCTCCCAGACATCTGTGTACTTGTGTGCCAGCAGTTACAGGGCGGGGACCGGGGAGCTGTTTTTTGGAGAA	CASSYRAGTGELFF	1
CGAAGCTTGAGGATTCAGCAGTGTATTTTTGTGCCAGCAGCCCCAACTTAGACACCTACGAGCAGTACTTCGGGCCG	CASSPNLDTYEQYF	2
CAAAAGAACCCGACAGCTTTCTATCTCTGTGCCAGTAGTATATACACAGAACAGCCCCAGCATTTTGGTGAT	CASSIYTEQPQHF	1
AGCTTGGTGACTCTGCTGTGTATTTCTGTGCCAGCAGCCAAACCCGGCAGGGACCCTATAGCAATCAGCCCCAGCATTTTGGTGAT	CASSQTRQGPYSNQPQHF	3
CAAAAGAACCCGACAGCTTTCTATCTCTGTGCCAGTAGTCCGACCTACAGGGGACGAGGCGGAAACACCATATATTTTGGAGAG	CASSPTYRGRGGNTIYF	9
CCCTGAAGACAGCAGCATATATCTCTGCAGCGTGGCACCGGGACAGCTCCGGAACGAGCAGTACTTCGGGCCG	CSVAPGQLRNEQYF	24
CCTCCCAGACATCTGTGTACTTGTGTGCCATCAGTGGGGCCAGCCACGAGCAGTACTTCGGGCCG	CAISGASHEQYF	6
AGCTTGGTGACTCTGCTGTGTATTTCTGTGCCAGCAGCCATTCGGGCGGGGGCTACAATGAGCAGTTCTTCGGGCCA	CASSHSGGGYNEQFF	1
CCTCACATACCTCTCAGTACCTCTGTGCCAGCAGTGAAGAACATTGAGGGCAACTGGACCCGGGGAGCTGTTTTTTGGAGAA		1
TTCTCAGTGACTCTGGCTTCTATCTCTGTGCCTGGACTAGCGGGATCGTCACAGATACGCAGTATTTTGGCCCA	CAWTSGIVTDTQYF	1
CCTCCCAGACATCTGTGTACTTGTGTGCCATCAGTGAAGGGTGGAACTCCTACGAGCAGTACTTCGGGCCG	CAISEGWNSYEQYF	3
GAGACACGGCACTGTATCTCTGCGCCAGCATGGTCCCCGGCTAGCGGAACCTACGAGCAGTACTTCGGGCCG		8
GAGACACGGCACTGTATCTCTGCGCCAGCAGTCCTCACAGGGGTCCTGAGCAGTTCTTCGGGCCA	CASSPHRGPEQFF	12
CTCCCTCYCAGACWTCTGTKTACTTSTGTGCCAGCACGACAGCGAGCACAGATACGCAGTATTTTGGCCCA	CASTTASTDTQYF	19
CCTCCCAGACATCTGTGTACTTGTGTGCCAGTGTAGCGGGACACGGTAGCGACGAGCAGTACTTCGGGCCG	CASVAGHGSDEQYF	1
CCTCACATACCTCTCAGTACCTCTGTGCCAGCAGGGGGGGACTAGGGATAGGCGAGCAGTTCTTCGGGCCA	CASRGGLGIGEQFF	3
CGAGGAGATTCGGCAGCTTATTTCTGTGCCAGCTCACCCCCGGCACGCGGAGAGCAGTTCTTCGGGCCA	CASSPPARGEQFF	9
CTCCCTCYCAGACWTCTGTKTACTTSTGTGCCAGCAGTGAGGACCAGTTCGGGGCCAAAAAACATTCAGTACTTCGGCGCC		3
ATCCTGAAGACAGCAGCTTCTACATCTGCAGTGCTTCCCTAAAGGGTCCAGATACGCAGTATTTTGGCCCA	CSASLKGPDTQYF	6
AAGAAGACTCAGCTGCGTATCTCTGCACCAGCAGCCAAGGGGTGCGGGGTGACACAGATACGCAGTATTTTGGCCCA	CTSSQGVRGDTDTQYF	42
GACTCGGCCGTGTATGTCTGTGCCAGCAGCTTAAGGTTGGGTTAGGGACTATGGCTACACCTTCGGTTCG		2
TGGGGGACTCAGCTTTGTATTTCTGTGCCAGCAGCGTAACGGGACAGGGCGGTGGCACTGAAGCTTTCTTTGGACAA	CASSVTGQGGGTEAFF	1
AACCCAGGGACTCAGCTGTGTATTTTTGTGCCAGCAGCCCCGGACAGGCCGAGCAGTTCTTCGGGCCA	CASSPGQAEQFF	3
ATCCTGAAGACAGCAGCTTCTACATCTGCAGTGGCTTAACGGGACTGGGCCACGAGCAGTACTTCGGGCCG	CSGLTGLGHEQYF	5
ATCCTGAAGACAGCAGCTTCTACATCTGCAGTGCTAGAGCCTTAGCGGGGGGGCCTGGCGGCGACGAGCAGTACTTCGGGCCG	CSARALAGGPGGDEQYF	1
GACTCGGCCGTGTATGTCTGTGCCAGCGCCCCGTGGACTACGGCCACTGAAGCTTTCTTTGGACAA	CASAPWTTATEAFF	1
GACTCGGCCGTGTATGTCTGTGCCAGCAGCTTACGGCCGGACGGAGAAAGAAATGAGCAGTTCTTCGGGCCA	CASSLRPDGERNEQFF	3
AGCTTGGTGACTCTGCTGTGTATTTCTGTGCCAGCAGCCAGGGAACTGTTGGAGAGACCCAGTACTTCGGGCCA	CASSQGTVGETQYF	7
GGACTCRGCCRTGTATSKCTGTGCCAGCAGCTTAGTCGGGGTCGGGAGGCTCCCTACCGAGCAGTACTTCGGGCCG	CASSLVGVGRLPTEQYF	29
GACTCGGCCRTGTATSKCTGTGCCAGCAGCGTTAGCGGAGGGCTCTCCTACGAGCAGTACTTCGGGCCG	CASSVSGGLSYEQYF	3
GACTCGGCCGTGTATGTCTGTGCCAGCAGCTCCCTATGGACAGCGGAGTACAATGAGCAGTTCTTCGGGCCA	CASSSLWTAEYNEQFF	1
CACCAACCAGACATCTATGTACCTCTGTGCCAGCAGTACAGACAGGGGGGAACAAAAACATTCAGTACTTCGGCGCC		2
GACTCGGCCGTGTATGTCTGTGCCAGCAGTTTTAACGACAGGGGAGTACCAAGAGACCCAGTACTTCGGGCCA		5
AGCTTGGTGACTCTGCTGTGTATTTCTGTGCCAGCAGCCAGGGACAGGGTGAAACAGATACGCAGTATTTTGGCCCA	CASSQGQGETDTQYF	4
CAGAACTGGAGGATTCTGGAGTTTATTTCTGTGCCAGCAGCCAAGATTCCGCCGCAATCACAGATACGCAGTATTTTGGCCCA	CASSQDSAAITDTQYF	2
GCTCCCAGACATCTGTGTATTTCTGCGCCAGCATGGGGGGGGCGGGAGATGGCTACACCTTCGGTTCG	CASMGGAGDGYTF	6
GACTCGGCCGTGTATGTCTGTGCCAGCAGCTTAGTAGGGACAGCCTACGAGCAGTACTTCGGGCCG	CASSLVGTAYEQYF	7
AGCTTGGTGACTCTGCTGTGTATTTCTGTGCCAGCCGGGACAGGTCCTACGAGCAGTACTTCGGGCCG	CASRDRSYEQYF	4
GACTCGGCCGTGTATGTCTGTGCCAGCAGCCCCCGAGGCGCGGGAGGAAGAAATGAGCAGTTCTTCGGGCCA	CASSPRGAGGRNEQFF	4
TTCTCAGTGACTCTGGCTTCTATCTCTGTGCCTGGGGACAGAGCTATGGCTACACCTTCGGTTCG	CAWGQSYGYTF	16
CCTCCCAGACATCTGTGTACTTGTGTGCCATCAGATCCCAGGGGGGCTGGTCGCGGGCCAAAAACATTCAGTACTTCGGCGCC	CAIRSQGGWSRAKNIQYF	3
AGCTTGGTGACTCTGCTGTGTATTTCTGTGCCAGCCCCAAGGGCGGTTGCAAGAGACCCAGTACTTCGGGCCA		4
GGACTCGGCCCTTTATCTTTGCGCCAGCAGCTTGGCCCCAGGGGCGCGGGGAGATGGCTACACCTTCGGTTCG	CASSLAPGARGDGYTF	10
CGAGGAGATTCGGCAGCTTATTTCTGTGCCAGCTCACGGAACAGGGGGCAAGATACGCAGTATTTTGGCCCA	CASSRNRGQDTQYF	1
CCCTGAAGACAGCAGCATATATCTCTGCAGCGTCAGGGGGGACTCCGGGGCCAACGTCCTGACTTTCGGGGCC	CSVRGDSGANVLTF	4
GACTCGGCCGTGTATGTCTGTGCCAGCAGCTTGAATTCGGGGGGGAGTGAAAAACTGTTTTTTGGCAGT	CASSLNSGGSEKLFF	1
AACCCAGGGACTCAGCTGTGTAYTTYTGTGCCAGCAGTTTCCACAGTGACTAGCGGGCTACGAGCAGTACTTCGGGCCG		4
CCTCCCAGACATCTGTGTACTTGTGTGCCAAACTGGAGAACGACAGAGCCGCACAGATACGCAGTATTTTGGCCCA		6
GACTCGGCCGTGTATGTCTGTGCCAGCAGCTTGGAGGCAGGGGTTGGCTATGGCTACACCTTCGGTTCG	CASSLEAGVGYGYTF	1
CGAGGAGATTCGGCAGCTTATTTCTGTGCCAGCTCACCATCGTTTAGGGTAAAGAAGCTTTCTTTGGACAA		1
AACCCAGGGACTCAGCTGTGTATTTTTGTGCCAGCAGTTTAGTACAGGGCCCTGAAGCTTTCTTTGGACAA	CASSLVQGPEAFF	1
ATCCTGAAGACAGCAGCTTCTACATCTGCAGTGCTAGTAATTCCCTAGGGCCGCGCGCTGAAGCTTTCTTTGGACAA	CSASNSLGPRAEAFF	14
AGCTTGGTGACTCTGCTGTGTATTTCTGTGCCAGCAGCCATTGACAGTAGGAAACACCATATATTTTGGAGAG		2
GACTCGGCCGTGTATGTCTGTGCCAGCAGCTTATCGGGGGCGAATTCACCCCTCCACTTTGGGAAC	CASSLSGANSPLHF	11
GACTCGGCCGTGTATGTCTGTGCCAGCAGGCTACGTCTGGGATCGGATACGCAGTATTTTGGCCCA	CASRLRLGSDTQYF	9
CGAGGAGATTCGGCAGCTTATTTCTGTGCCAGCTCAGATATTGGACGGGCCGCCTACAATGAGCAGTTCTTCGGGCCA	CASSDIGRAAYNEQFF	5
GGACTCGGCCSTSTATCTCTGTGCCAGCAGCTCCCTTAGGAGCCCCGGGTGGATGGCTACACCTTCGGTTCG		8
ATCCTGAAGACAGCAGCTTCTACATCTGCAGTGCTAGAGCTAGCGGGAGCATCTACGAGCAGTACTTCGGGCCG	CSARASGSIYEQYF	3
AGCTTGGTGACTCTGCTGTGTATTTCTGTGCCAGCAGCCAAGCAGGGAACACAGATACGCAGTATTTTGGCCCA	CASSQAGNTDTQYF	7
CCCTGAAGACAGCAGCATATATCTCTGCAGCGTTGAAAACTCCGGGGATGAGCAGTTCTTCGGGCCA	CSVENSGDEQFF	3
CCTCCCAGACATCTGTGTACTTGTGTGCCAGCAGTTACAGGACAGCGAACACCGGGGAGCTGTTTTTTGGAGAA	CASSYRTANTGELFF	4
TYCTCAGTGACTCTGGCTTCTATCTCTGTGCCTGGACCCTAACTAATACGCAGTATTTTGGCCCA	CAWTLTNTQYF	1
CCTCACATACCTCTCAGTACCTCTGTGCCAGCAGTGAACAATAGGGACCTATGGCTACACCTTCGGTTCG		3
CCTCCCAGACATCTGTGTACTTGTGTGCCATCAGCAAATTCGGACAGGGTAAAATCCTACGAGCAGTACTTCGGGCCG		2
GGACTCGGCCCTTTATCTTTGCGCCAGCAGCTGGTCCGGGACTAGCGTCACCGGGGAGCTGTTTTTTGGAGAA	CASSWSGTSVTGELFF	1
AGCTTGGTGACTCTGCTGTGTATTTCTGTGCCAGCCGTCGATATGGACTCGCAATATACGAGCAGTACTTCGGGCCG	CASRRYGLAIYEQYF	3
CCTCCCAGACATCTGTGTACTTGTGTGCCAGCAGTTACGCGGGGGACTCCTACAATGAGCAGTTCTTCGGGCCA	CASSYAGDSYNEQFF	4
GACTCGGCCGTGTATCTCTGTGCCAGCAGTGGAAACATGAACACTGAAGCTTTCTTTGGACAA	CASSGNMNTEAFF	33
GGACTCGGCCCTTTATCTTTGCGCCAGCAGCCATAATCGGACAGGGTTTTTTAGCGAGCAGTACTTCGGGCCG	CASSHNRTGFFSEQYF	2
TCTGTGCCAGCCGTTTCTTAGAGTGGACAGAACTAGCGGGAGGGGAAAGCTCCTACGAGCAGTACTTCGGGCCG	CASRFLEWTELAGGESSYEQYF	3
AAAGAACCCGACAGCTTTCTATCTCTGTGCCAGTAGCCCACAAAATAATCGGTTAGYTCCTATAATTCACCCCTCCACTTTGGGAAC		1
GGACTCRGCCRTGTATSKCTGTGCTAGCAGCCCCGGGGGGGACTTATACCAAGAGACCCAGTACTTCGGGCCA	CASSPGGDLYQETQYF	2
CCTCCCAGACATCTGTGTACTTGTGTGCCAGCAGTTACCGACTAGGAAACACCGGGGAGCTGTTTTTTGGAGAA	CASSYRLGNTGELFF	3
CAGAACTGGAGGATTCTGGAGTTTATTTCTGTGCCAGCAGGGGCAGGGGATCCTACGAGCAGTACTTCGGGCCG	CASRGRGSYEQYF	1
AACCCAGGGACTCAGCTGTGTATTTTTGTGCCAGCAGCTGGGGACTGCTCTCTGGGGCCAACGTCCTGACTTTCGGGGCC	CASSWGLLSGANVLTF	12
TGGGGGACTCAGCTTTGTATTTCTGTGCCAGCAGCACCCGGACAGGGCTCGGGGAGACCCAGTACTTCGGGCCA	CASSTRTGLGETQYF	1
CCTCCCAGACATCTGTGTACTTGTGTGCCAGCAGTGACTCTAAGCACTAGCGGAGATGAGCTACAATGAGCAGTTCTTCGGGCCA		1
GACTCGGCCGTGTATGTCTGTGCCAGCAGCTTAGAAGAGGCGGGGACGACCAATGAGCAGTTCTTCGGGCCA	CASSLEEAGTTNEQFF	7
ATCCTGAAGACAGCAGCTTCTACATCTGCAGTGCTATTACCCCCCCGTACGGGGATTCACCCCTCCACTTTGGGAAC	CSAITPPYGDSPLHF	4
GACTCGGCCGTGTATGTCTGTGCCAGCAGCTTGGACCCTAGCGGGAGTAACTACGAGCAGTACTTCGGGCCG	CASSLDPSGSNYEQYF	1
GGACTCRGCCATGTATCGCTGTGCCAGCAGCACCGGGACTAGCGGGAGGCGGGCCACAGATACGCAGTATTTTGGCCCA	CASSTGTSGRRATDTQYF	1
CAAAAGAACCCGACAGCTTTCTATCTCTGTGCCAGTAACGTTGGGGCGGGACTCCTAAATCAGCCCCAGCATTTTGGTGAT	CASNVGAGLLNQPQHF	1
CAAAAGAACCCGACAGCTTTCTATCTCTGTGCCCCATTGGTCGAGGGGAGACAGTTGGGGGCTACACCTTCGGTTCG		4
CCTCCCAGACATCTGTGTACTTGTGTGCCAGCAGTTCCCTGAGCACTAGCTCTTACGAGCAGTACTTCGGGCCG	CASSSLSTSSYEQYF	2
TGGGGGACTCAGCTTTGTATTTCTGTGCCAGCTAGTGCTACTCTGGAAACACCATATATTTTGGAGAG	CAS*CYSGNTIYF	4
CCTCCCAGACATCTGTGTACTTGTGTGCCCGACGGGACCGACTAGGACCTACGAGCAGTACTTCGGGCCG		16
GACTCGGCCGTGTATGTCTGTGCCAGCAGCTTATTAGGACAGAGAGATGAAAAACTGTTTTTTGGCAGT	CASSLLGQRDEKLFF	8
AGGACTCCGCCGTGTATCTCTGTGCCAGCAGCCCCGACTCTGGAAACACCATATATTTTGGAGAG	CASSPDSGNTIYF	3
GAGACACGGCACTGTATCTCTGCGCCAGCAGCAAAGAAGCCGGGCCAAAAATCAGGGTGAAAAACTGTTTTTTGGCAGT		2
GACTCGGCCGTGTATGTCTGTGCCAGCAGCCCAACGGCGAGAGGGGGCCCAGATACGCAGTATTTTGGCCCA	CASSPTARGGPDTQYF	11
CGAGGAGATTCGGCAGCTTATTTCTGTGCCAGCTCACCACTTAAGCGGGGGGGCTTCGCGGACACCGGGGAGCTGTTTTTTGGAGAA	CASSPLKRGGFADTGELFF	7
GACTCGGCCGTGTATGTCTGTGCCAGCAGCTTAGGCCCGGGACGGCCCTCTGGGGCCAACGTCCTGACTTTCGGGGCC	CASSLGPGRPSGANVLTF	6
GAGACACGGCACTGTATCTCTGCGCCAGCATTCCGGGACAAAAAACACTGAAGCTTTCTTTGGACAA		4
CCTCCCAGACATCTGTGTACTTGTGTGCCAGCAGTTACTCGAGAGATCAGCCCCAGCATTTTGGTGAT	CASSYSRDQPQHF	22
GACTCGGCCGTGTATGTCTGTGCCAGCAGCTTGGGCGACAGGGTTGGGGAGACCCAGTACTTCGGGCCA	CASSLGDRVGETQYF	2
CAAAAGAACCCGACAGCTTTCTATCTCTGTGCCCCCCCGGATTAAGATCACTCCCTAACGAACACCGGGGAGCTGTTTTTTGGAGAA	CAPPD*DHSLTNTGELFF	29
GACTCGGCCGTGTATCTCTGTGCCAGCAGCCAAGATACCGCAACCGAGCAGTACTTCGGGCCG	CASSQDTATEQYF	5
GACTCGGCCGTGTATGTCTGTGCCAGCAGCTTGGAGACAGGGTACAATGAGCAGTTCTTCGGGCCA	CASSLETGYNEQFF	1
CAGGGACTTGGGCCTATATTTCTGTGCCAGCAGCTCACCGTGGCAGGGAACTCGGACTAATGAAAAACTGTTTTTTGGCAGT	CASSSPWQGTRTNEKLFF	10
CCCTGAAGACAGCAGCATATATCTCTGCAGCGTTGAGGCACAGGACTATGGCTACACCTTCGGTTCG	CSVEAQDYGYTF	1
GCTGGCAAGCCACGTTTGGTGCCAGCCAGACCTCTGTACCTCTGTGCCACCAGGGGGGAGGAGAGTGATACGCAGTATTTTGGCCCA	CATRGEESDTQYF	18
GACTCGGCCGTGTATGTCTGTGCCAGCAGCTTAACGGGGGGCGGCAATCAGCCCCAGCATTTTGGTGAT	CASSLTGGGNQPQHF	1
CTCCCTCYCAGACWTCTGTKTACTTSTGTGCCAGCAGTGACTCGCGGGGGGGCACAGATACGCAGTATTTTGGCCCA	CASSDSRGGTDTQYF	3
GACTCGGCCGTGTATGTCTGTGCCAGCACCCCCGGAGGGGCAGAGGCCTATGGCTACACCTTCGGTTCG	CASTPGGAEAYGYTF	1
CCTCCCAGACATCTGTGTACTTGTGTGCCAGCAGTCTTAGGACAGGGGCATACGGCTACACCTTCGGTTCG	CASSLRTGAYGYTF	8
CAAAAGAACCCGACAGCTTTCTATCTCTGTGCCAGTACCTCCTACGGCTCACTGTTAGATACGCAGTATTTTGGCCCA	CASTSYGSLLDTQYF	2
GACTCGGCCGTGTATGTCTGTGCCAGCAGCGAACTAGCGGGAGGCTACAATGAGCAGTTCTTCGGGCCA	CASSELAGGYNEQFF	6
ATCCTGAAGACAGCAGCTTCTACATCTGCAGTGCTCGCACGCAGGAAAGCAATCAGCCCCAGCATTTTGGTGAT	CSARTQESNQPQHF	9
ATCCTGAAGACAGCAGCTTCTACATCTGCAGTGCTCGGCAGTTAGAGACCCAGTACTTCGGGCCA	CSARQLETQYF	23
CCTCCCAGACATCTGTGTACTTGTGTGCCAGCACGGCAGCACATAGCAATCAGCCCCAGCATTTTGGTGAT	CASTAAHSNQPQHF	4
GACTCGGCCGTGTATGTCTGTGCCAGCAGCCCCGGGGGGGGTAGACGACGGGGCTACACCTTCGGTTCG	CASSPGGGRRRGYTF	7
CCCAACCAGACAGCTCTTTACTTCTGTGCCACCTCAGGGGGCGACGGCTACAATGAGCAGTTCTTCGGGCCA	CATSGGDGYNEQFF	68
CCCWMCCAGACAKCTSTKTACTTSTGTGCCAGCAGTCTGTCAGGGGCACTAATGAAAAACTGTTTTTTGGCAGT		1
AGCTTGGTGACTCTGCTGTGTATTTCTGTGCCAGCAGCCAAGATCAGGGTCGGGTTAACTATGGCTACACCTTCGGTTCG	CASSQDQGRVNYGYTF	20
AGCTTGGTGACTCTGCTGTGTATTTCTGTGCCAGCAGCCAAGATGGGACTAGCGGGCGCGAGCAGTACTTCGGGCCG	CASSQDGTSGREQYF	4
GACTCGGCCGTGTATGTCTGTGCCAGCAGCTTAGTGAGCGCGAACACCGGGGAGCTGTTTTTTGGAGAA	CASSLVSANTGELFF	5
GGACTCGGCCCTTTATCTTTGCGCCAGCAGCTTGGACCTGGGCATGAACACTGAAGCTTTCTTTGGACAA	CASSLDLGMNTEAFF	8
CGAGGAGATTCGGCAGCTTATTTCTGTGCCAGCTCACCGTCTGGGGGACTAGCGGGAGAATATCCCGGTACGCAGTATTTTGGCCCA	CASSPSGGLAGEYPGTQYF	14
CAAAAGAACCCGACAGCTTTCTATCTCTGTGCCAGTAGTAAACCGGGACTAGCGGTCTACGAGCAGTACTTCGGGCCG	CASSKPGLAVYEQYF	3
TGGGGGACTCAGCTTTGTATTTCTGTGCCAGCAGCGTAGGCCTCCTAGCGGGCACAGATACGCAGTATTTTGGCCCA	CASSVGLLAGTDTQYF	7
TGGGGGACTCAGCTTTGTATTTCTGTGCCAGCAGCGGACAGGGTGGCGAGCAGTACTTCGGGCCG	CASSGQGGEQYF	23
AGCTTGGTGACTCTGCTGTGTATTTCTGTGCCAGCGCGCATATGGACAGTTCCTACGAGCAGTACTTCGGGCCG	CASAHMDSSYEQYF	2
TCAGGAGACACAGCACGGTATTTCTGTGCCAGCAGCAAAGGGGCGGGGAGCTGTTTTTTGGAGAA		10
GACTCGGCCGTGTATGTCTGTGCCAGCAGCTCTTCAGGGGTTACAGAGACCCAGTACTTCGGGCCA	CASSSSGVTETQYF	36
CCTCCCAGACATCTGTGTACTTGTGTGCCAGCAGCCCGAGACAGAAAGGGAAGAACCTACGAGCAGTACTTCGGGCCG		2
AACCCAGGGACTCAGCTGTGTAYTTYTGTGCCAGCAGTTTAAGACGGACCTTCTATGGCTACACCTTCGGTTCG	CASSLRRTFYGYTF	10
CCCAACCAGACAGCTCTTTACTTCTGTGCCACCAGTGATCGGGCGGGCCATGAGCAGTTCTTCGGGCCA	CATSDRAGHEQFF	4
CAAAAGAACCCGACAGCTTTCTATCTCTGTGCCAGTAGTTTAGGCAGAGAGAATACTGAAGCTTTCTTTGGACAA	CASSLGRENTEAFF	5
TGTACCCTCTCAGACATCTGTGTACTTCTGTGCCAGCGACCGACAGGCTACGAGCAGTACTTCGGGCCG		3
CAAAAGAACCCGACAGCTTTCTATCTCTGTGCCAGTTGGACTAGCGACTACGGCGGGGAGCTGTTTTTTGGAGAA	CASWTSDYGGELFF	3
ATCCTGAAGACAGCAGCTTCTACATCTGCAGTGCTAGAGCCGGGACATTGACGGGAGAGACCCAGTACTTCGGGCCA	CSARAGTLTGETQYF	8
GACTCGGCCGTGTATGTCTGTGCCAGCAGCCCAGCGGGAAGAGCAGATACGCAGTATTTTGGCCCA	CASSPAGRADTQYF	7
AGCTTGGTGACTCTGCTGTGTATTTCTGTGCCAGCAGCCACTATCAAGAGACCCAGTACTTCGGGCCA	CASSHYQETQYF	3
GACTCGGCCGTGTATGTCTGTGCCAGCAGCCGACAGGGATTGGGTCAGCCCCAGCATTTTGGTGAT	CASSRQGLGQPQHF	4
GACTCGGCCGTGTATGTCTGTGCCAGCAGCTTGGGGAAGACGATAAGGGAAGGGTATGGCTACACCTTCGGTTCG	CASSLGKTIREGYGYTF	23
CCTCCCAGACATCTGTGTACTTGTGTGCCAGCAGTTATCTTGTAGCGGGGGGAGGAGAGACTTAGTACTTCGGGCCA	CASSYLVAGGGET*YF	4
CCCAACCAGACAGCTCTTTACTTCTGTGCCACCAGTGATTTTCCGACAGGGGGCGGTCACCGGGGAGCTGTTTTTTGGAGAA		1
CGACTCGGCTGTGTATCTCTGTGCCAGCAGCCGCTGGGACAGGGGACGAACTATGAACACTGAAGCTTTCTTTGGACAA	CASSRWDRGRTMNTEAFF	1
TYCTCAGTGACTCTGGCTTCTATCTCTGTGCCTGGAGTAGGCTAGCGATGAACACCGGGGAGCTGTTTTTTGGAGAA	CAWSRLAMNTGELFF	6
CCCTGAAGACAGCAGCATATATCTCTGCAGCGTTGAAGGGGGACCGATCTATGGCTACACCTTCGGTTCG	CSVEGGPIYGYTF	4
TGGGGGACTCAGCTTTGTATTTCTGTGCCAGCAGTGTAAGGCAGGGGCTGGGCACTGAAGCTTTCTTTGGACAA	CASSVRQGLGTEAFF	1
CCTCCCAGACATCTGTGTACTTGTGTGCCAGCACCGCTAGGACGCGACTGAGCTCCTACGAGCAGTACTTCGGGCCG	CASTARTRLSSYEQYF	87
ATCCTGAAGACAGCAGCTTCTACATCTGCAGTGCTAGAGCCATAGCAGATACGCAGTATTTTGGCCCA	CSARAIADTQYF	1
GACTCGGCCGTGTATGTCTGTGCCAGCAGCCTAAGGACAGGGCCCTACGAGCAGTACTTCGGGCCG	CASSLRTGPYEQYF	1
ATCCTGAAGACAGCAGCTTCTACATCTGCAGTGCCCTGAGCACAGATACGCAGTATTTTGGCCCA	CSALSTDTQYF	2
AACCCAGGGACTCAGCTGTGTATTTTTGTGCTAGCGGGACCGGGGTCAGGACTGAAGCTTTCTTTGGACAA	CASGTGVRTEAFF	5
GGACTCGGCCCTTTATCTTTGCGCCAGCAGCTCCGGGACCCTAGGGACTGAAGCTTTCTTTGGACAA	CASSSGTLGTEAFF	29
GACGCAGCCATGTACCTGTGTGCCACCACTAGGGACGGACCAAACACCGGGGAGCTGTTTTTTGGAGAA	CATTRDGPNTGELFF	7
GACTCGGCCGTGTATGTCTGTGCCAGCAGCCGCCGGAAAGCGGGGGCCTTCAATGAGCAGTTCTTCGGGCCA	CASSRRKAGAFNEQFF	4
ATCCTGAAGACAGCAGCTTCTACATCTGCAGTGCTAGAGCTAGTGCCTACAATGAGCAGTTCTTCGGGCCA	CSARASAYNEQFF	6
TYCTCAGTGACTCTGGCTTCTATCTCTGTGCCTGGAAGTCGGGGGGGACAGGAGGCTACACCTTCGGTTCG	CAWKSGGTGGYTF	2
ATCCTGAAGACAGCAGCTTCTACATCTGCAGTGTAAACCAGATAAGACAGGCTACTAGCACAGATACGCAGTATTTTGGCCCA	CSVNQIRQATSTDTQYF	7
CAAAAGAACCCGACAGCTTTCTATCTCTGTGCCAGTAGTCCAACCTCGGGACAGGCAGACTATGGCTACACCTTCGGTTCG	CASSPTSGQADYGYTF	19
CCCTGAAGACAGCAGCATATATCTCTGCAGCGTTGATGCGGAGGACACAGATACGCAGTATTTTGGCCCA	CSVDAEDTDTQYF	3
GACTCGGCCGTGTATGTCTGTGCCAGCACCCCTCAGGCAGGGCGGAACACCGGGGAGCTGTTTTTTGGAGAA	CASTPQAGRNTGELFF	2
AACYSRGGGACTCAGCTKTGTATTTYTGTGCCAGCAGTTTAGGTGGGGGGCGGAACACCGGGGAGCTGTTTTTTGGAGAA	CASSLGGGRNTGELFF	7
CAAAAGAACCCGACAGCTTTCTATCTCTGTGCCAGTAGTACGTCAGGGTTCGTTAGCTATGGCTACACCTTCGGTTCG	CASSTSGFVSYGYTF	2
CTTGGTGACTCTGCTGTGTATTTCTGTGCCAGCAGCCCGACGGGACTAGCGGGTGTTCGCTCCTACAATGAGCAGTTCTTCGGGCCA	CASSPTGLAGVRSYNEQFF	1
ATCCTGAAGACAGCAGCTTCTACATCTGCAGTGCTAGAGATCAGGGGACAGGGAACACTGAAGCTTTCTTTGGACAA	CSARDQGTGNTEAFF	3
CCCAACCAGACAGCTCTTTACTTCTGTGCCAGCAGCCACCTGGGTGGCGATGAGCAGTTCTTCGGGCCA	CASSHLGGDEQFF	11
CCTCCCAGACATCTGTGTACTTGTGTGCCAGCAGTGAAGGTCAGGGCAGCAGCCCCAGCATTTTGGTGAT		4
CRRRRGACTCAGCCSTGTATCTCTRCGCCAGCAGCCAAGAAGGAAAGGGCACATAAACTATGGCTACACCTTCGGTTCG		6
TGGGGGACTCAGCTTTGTATTTCTGTGCCAGCAGTGAACGACAGGGTCAAGAGACCCAGTACTTCGGGCCA	CASSERQGQETQYF	11
AGCTTGGTGACTCTGCTGTGTATTTCTGTGCCAGCAGCCAAGTCGGGGCAGGGGCCTACTACACYTTCGGTTCG	CASSQVGAGAYYTF	4
GACTCGGCCGTGTATGTCTGTGCCAGCAAACCGGGACAGATGAACACTGAAGCTTTCTTTGGACAA	CASKPGQMNTEAFF	1
TGTACCCTCTCAGACATCTGTGTACTTCTGTGCCAGCAGTGCCCGATAGAGACCCAGTACTTCGGGCCA		24
CTCCCTCTCAGACTTCTGTTTACTTCTGTGCCAGCAGTTACTCGATCCAGGGAGATCCTACGAGCAGTACTTCGGGCCG		3
AACCCAGGGACTCAGCTGTGTATTTTTGTGCCAGCAGGGAGGGGTGACTGAAGCTTTCTTTGGACAA		1
CAAAAGAACCCGACAGCTTTCTATCTCTGTGCCAGTAGTCGCACTAGCGGCGCACAGGGTGAGCAGTTCTTCGGGCCA	CASSRTSGAQGEQFF	6
CCCAACCAGACAGCTCTTTACTTCTGTGCCAGCAGTTTAAAGGACACCACTAAAGAAGAGACCCAGTACTTCGGGCCA	CASSLKDTTKEETQYF	7
AACCCAGGGACTCAGCTGTGTATTTTTGTGCCAGCGTGATGAGGAGCACAGATACGCAGTATTTTGGCCCA	CASVMRSTDTQYF	1
AGCTTGGTGACTCTGCTGTGTATTTCTGTGCCAGCAGCCAAGATTCGACAGGGCGAGGCTACACCTTCGGTTCG	CASSQDSTGRGYTF	4
CGACTCGGCYGTGTATSTCTGTGCCAGCAGCCCCGGGACGGCTGGAAACACCATATATTTTGGAGAG	CASSPGTAGNTIYF	1
TTCTCAGTGACTCTGGCTTCTATCTCTGTGCCTGGAGAGGCTCGAGGATAGCCGGCTACACCTTCGGTTCG	CAWRGSRIAGYTF	7
GAGACACGGCACTGTATCTCTGCGCCAGCAGTCACTCGAACAGGGACGAGAGAGCAGTACTTCGGGCCG		3
CCTCACATACCTCTCAGTACCTCTGTGCCAGCAGTGAAGCGGGACACACAGATACGCAGTATTTTGGCCCA	CASSEAGHTDTQYF	1
ATCCTGAAGACAGCAGCTTCTACATCTGCAGTGCCGCGGGACTAGCGGGAGCCTACAATGAGCAGTTCTTCGGGCCA	CSAAGLAGAYNEQFF	1
GACTCGGCCGTGTATGTCTGTGCCAGCAGCTTGGCTGGAGTGGTAATGAGCAGTTCTTCGGGCCA		6
GGACTCGGCCCTTTATCTTTGCGCCAGCAGCCCGACTAGCGGGAGTGGAAGATACGAGCAGTACTTCGGGCCG	CASSPTSGSGRYEQYF	3
CGAGGAGATTCGGCAGCTTATTTCTGTGCCAGCTCACCGGGGCCGGTTGAAGCTTTCTTTGGACAA	CASSPGPVEAFF	2
GACTCGGCCGTGTATGTCTGTGCCAGCAGCCTATTAGGGGGCCGACAGAACACTGAAGCTTTCTTTGGACAA	CASSLLGGRQNTEAFF	13
TGCGCCAGCAGTCAATCGTAGGCCGGGACTAGCGGGAGGCACAGCCAACTTCGCGGTTGAGCAGTTCTTCGGGCCA		4
CAGAACTGGAGGATTCTGGAGTTTATTTCTGTGCCAGCAGCCCGGGACAGGGGGCTGGAAACACCATATATTTTGGAGAG	CASSPGQGAGNTIYF	4
CCTCCCAGACATCTGTGTACTTGTGTGCCAGCAGTTACTCGGGGGGAAGCTACGAGCAGTACTTCGGGCCG	CASSYSGGSYEQYF	7
CCTCCCAGACATCTGTGTACTTGTGTGCCAGCAGTGAAAGAGTTGTCAGGTACCTACGAGCAGTACTTCGGGCCG		23
GGACTCGGCCCTTTATCTTTGCGCCAGCAGCCAGCCCTACGGGACTTTAGAACACTGAAGCTTTCTTTGGACAA		5
MAGAAGACTCAGCYSYGTATCTCTGCGCCAGCAGCCAAGAACCGGCGCAGGGGCGTGAGCAGTTCTTCGGGCCA	CASSQEPAQGREQFF	8
GACTCGGCCRTGTATSKCTGTGCTAGCAGAAGGTGGCAGGGTCGAACACTGAAGCTTTCTTTGGACAA		18
AGCTTGGTGACTCTGCTGTGTATTTCTGTGCCAGCAGCCTCTATGGGGCCAACGTCCTGACTTTCGGGGCC	CASSLYGANVLTF	1
CAGAACTGGAGGATTCTGGAGTTTATTTCTGTGCCAGCAGCCAAGTGGGCAATCTCTACGAGCAGTACTTCGGGCCG	CASSQVGNLYEQYF	2
GACTCGGCCGTGTATGTCTGTGCAAGTCGCTTAGTGGAAGCCCCATGAGGGGGCCTATGGCTACACCTTCGGTTCG		9
GACTCGGCCGTGTATGTCTGTGCCAGCAAAATTGGGGGGGGTGGAACCGGGGAGCTGTTTTTTGGAGAA	CASKIGGGGTGELFF	11
CAGAAGACTCAGCCCTGTATCTCTGCGCCAGCAGCCGGGACTCTCCTACGAGCAGTACTTCGGGCCG		10
CCCTGAAGACAGCAGCATATATCTCTGCAGCGAACGACAGGGGGCAAAATTCACCCCTCCACTTTGGGAAC		18
CCTCCCAGACATCTGTGTACTTGTGTGCCAGCAGTTACCGTGGAATAGGGGGGGGCCCACACGCTGAAGCTTTCTTTGGACAA	CASSYRGIGGGPHAEAFF	1
CGAGGAGATTCGGCAGCTTATTTCTGTGCCAGCTCACTGCCCGAGGTTGAGCAGTTCTTCGGGCCA	CASSLPEVEQFF	15
TGGGGGACTCAGCTTTGTATTTCTGTGCCAGCAGCGGCCGGGACAGGGGCAATAGACCCAGTACTTCGGGCCA		11
GGACTCGGCCMTSTATCKCTGTGCCAGAAGCTTGGGGCCTTCTCTGGAAACACCATATATTTTGGAGAG		1
ATCCTGAAGACAGCAGCTTCTACATCTGCAGTGCTAGTGACGGATACGAAGCTTTCTTTGGACAA	CSASDGYEAFF	12
CAAAAGAACCCGACAGCTTTCTATCTCTGTGCCAGCTGCCGGGTCTCAGTCGGATGAGCAGTTCTTCGGGCCA		6
TGGGGGACTCAGCTTTGTATTTCTGTGCCAGCAGTGGGCCGCGTCTCGATTCACCCCTCCACTTTGGGAAC	CASSGPRLDSPLHF	2
TGGGGGACTCAGCTTTGTATTTCTGTGCCAGCAGTGATCTCTTCTGGGGACCGACCTAACTATGGCTACACCTTCGGTTCG		3
CCTCCCAGACATCTGTGTACTTGTGTGCCAGAATACCCAACAGGGGGTCCACAGATACGCAGTATTTTGGCCCA	CARIPNRGSTDTQYF	7
ATCCTGAAGACAGCAGCTTCTACATCTGCAGTGCTTTATCTCGTGCTGATTGGTCCTACGAGCAGTACTTCGGGCCG	CSALSRADWSYEQYF	1
GACTCGGCCGTGTATGTCTGTGCCAGCAGCCCCGCGGCAGGGGGAGAAGAGACCCAGTACTTCGGGCCA	CASSPAAGGEETQYF	18
CCCAACCAGACAGCTCTTTACTTCTGTGCCACCAGTGGAGGGCCCGGCGAGCAGTTCTTCGGGCCA	CATSGGPGEQFF	8
CCTCCCAGACATCTGTGTACTTGTGTGCCAGCATTGGAGCGGGGCGGGTAGTGGAGACCCAGTACTTCGGGCCA	CASIGAGRVVETQYF	7
AGCTTGGTGACTCTGCTGTGTATTTCTGTGCCAGCAGCCAAGCAGGGAACCGGGAGACCCAGTACTTCGGGCCA	CASSQAGNRETQYF	2
ATCCTGAAGACAGCAGCTTCTACATCTGCAGTGCTAGAGATCCCCTCCCAGGGGACGAGCAGTACTTCGGGCCG	CSARDPLPGDEQYF	3
GGACTCGGCCCTTTATCTTTGCGCCAGCAGCTGGACCGCCGGGGCGAACACTGAAGCTTTCTTTGGACAA	CASSWTAGANTEAFF	3
ATCCTGAAGACAGCAGCTTCTACATCTGCAGTGCTAGTGAGGGGATAGCTAATGAAAAACTGTTTTTTGGCAGT	CSASEGIANEKLFF	2
GGACTCGGCCCTTTATCTTTGCGCCAGCAGCTTGGGACTAGCGGGAGCGTTCAATGAGCAGTTCTTCGGGCCA	CASSLGLAGAFNEQFF	5
CCTCCCAGACATCTGTGTACTTGTGTGCTTCAAGTCAGGGGGCGCTCACCGGGGAGCTGTTTTTTGGAGAA	CASSQGALTGELFF	2
AGCTTGGTGACTCTGCTGTGTATTTCTGTGCCAGCAGCCAAGGAGGGAGGGAGACAGATACGCAGTATTTTGGCCCA	CASSQGGRETDTQYF	9
AGCTTGGTGACTCTGCTGTGTATTTCTGTGCCAGCAGCCAAGCCGGGACAGGGGGCGGGGAGCAGTTCTTCGGGCCA	CASSQAGTGGGEQFF	5
ATCCTGAAGACAGCAGCTTCTACATCTGCAGTGCTTCCATGGCGGGAGCCGCCTACAATGAGCAGTTCTTCGGGCCA	CSASMAGAAYNEQFF	21
CACCAACCAGACATCTATGTACCTCTGTGCCAGCAGTTCTCAGGGGGCTGGGGCCAACGTCCTGACTTTCGGGGCC	CASSSQGAGANVLTF	3
TTCTCAGTGACTCTGGCTTCTATCTCTGTGCCTGGAGCCCCCTGCGGGGAGTATCTGGGGCCAACGTCCTGACTTTCGGGGCC	CAWSPLRGVSGANVLTF	2
ATCCTGAAGACAGCAGCTTCTACATCTGCAGTGCTAGATCCCTGGTCGCTGAAGCTTTCTTTGGACAA	CSARSLVAEAFF	8
CCTCCCAGACATCTGTGTACTTGTGTGCCAGCAGTTCGTGGAGGACTGAAGCTTTCTTTGGACAA	CASSSWRTEAFF	6
AGCTTGGTGACTCTGCTGTGTATTTCTGTGCCAGCAGCCAAGGAGATTTAGTAGTGGGACAGGGGCTTCGTGAAGTATTTTGGCCCA		4
TGGGGGACTCAGCTTTGTATTTCTGTGCCGGTAATTCTAACAGGGTTGGGGGCACAGATACGCAGTATTTTGGCCCA	CAGNSNRVGGTDTQYF	1
CAAAAGAACCCGACAGCTTTCTATCTCTGTGCCAGTAGGCTCGGAATAAACACTGAAGCTTTCTTTGGACAA	CASRLGINTEAFF	34
TGGRGGACTCAGCYWTGTAYTTCTGTGCCAGCAGTCGGGACTCAGGGGGCAATCAGCCCCAGCATTTTGGTGAT	CASSRDSGGNQPQHF	4
CCTCCCAGACATCTGTGTACTTGTGTGCCAGCAGTGAAGAGGGAACAGGGGGCCACGAGCAGTACTTCGGGCCG	CASSEEGTGGHEQYF	13
TYRGGRGACWCAGCWYKGTATTTCTGTGCCAGCAGCTCACACTGGTACTCCTAATTCACCCCTCCACTTTGGGAAC		1
TGGGGGACTCAGCTTTGTATTTCTGTGCCAGCAGTTTAGGGACAGGGGGCTACGAGCAGTACTTCGGGCCG	CASSLGTGGYEQYF	4
CCTCCCAGACATCTGTGTACTTGTGTGCCATCAGCGGACAGGGGGGCCTCGGATGAGCAGTACTTCGGGCCG		5
