nucleotide	aminoAcid	estimatedNumberGenomes
CAGCCAGAAGACTCAGCCCTGTATCTCTGCGCCAGCAGCCAAGATCCGGGGGGGGCGTTAGATAATGAAAAACTGTTTTTTGGCAGT	CASSQDPGGALDNEKLFF	1
GTAGTGCGAGGAGATTCGGCAGCTTATTTCTGTGCCAGCTCTAACTCTGAGGGGGGGCGGACTTCAGAGACCCAGTACTTCGGGCCA	CASSNSEGGRTSETQYF	1
CTGTGACATCGGCCCAAAAGAACCCGACAGCTTTCTATCTCTGTGCCAGCAACTAAAGGGAGTAGCTACGAGCAGTACTTCGGGCCG		1
CTGAATGTGAACGCCTTGTTGCTGGGGGACTCGGCCCTCTATCTCTGTGCCAGCAGCTGGACAGAGAATGAGCAGTTCTTCGGGCCA	CASSWTENEQFF	1
CTGAGCTCTCTGGAGCTGGGGGACTCAGCTTTGTATTTCTGTGCCAGCAGCGAAACAGGGGGAAATCAGCCCCAGCATTTTGGTGAT	CASSETGGNQPQHF	1
ATCCAGCAGGTAGTGCGAGGAGATTCGGCAGCTTATTTCTGTGCCAGCTCATCTTCCAGGTACAAGAATGAGCAGTTCTTCGGGCCA	CASSSSRYKNEQFF	1
CTGTGACATCGGCCCAAAAGAACCCGACAGCTTTCTATCTCTGTGCCAGTTGGGACTAGCGGGAGTAACGAGCAGTACTTCGGGCCG		1
GTGAGCAACATGAGCCCTGAAGACAGCAGCATATATCTCTGCAGCGTTGAAGAGGGGGGAGGAGGAGAGACCCAGTACTTCGGGCCA	CSVEEGGGGETQYF	1
GCCTTGTTGCTGGGGGACTCGGCCCTCTATCTCTGTGCCAGCAGCTTGGCCCCCCGGGACACTGGAAACACCATATATTTTGGAGAG	CASSLAPRDTGNTIYF	1
TCCGCCAGCACCAACCAGACATCTATGTACCTCTGTGCCAGCAGTTTAGAATGGAGGGGGAGAGACTATGGCTACACCTTCGGTTCG	CASSLEWRGRDYGYTF	2
ACCCTGGAGTCTGCCAGGCCCTCACATACCTCTCAGTACCTCTGTGCCAGCAGTGAATCCGGCGCCTACGAGCAGTACTTCGGGCCG	CASSESGAYEQYF	1
CTGACGATCCAGCGCACAGAGCAGCGGGACTCGGCCATGTATCGCTGTGCCAGCAGCGGGGGGGGCAATGAGCAGTTCTTCGGGCCA	CASSGGGNEQFF	1
CGCTCACCAGGCCTGGGGGACGCAGCCATGTACCTGTGTGCCACCAGCCCTAGACAGGGGGCGCAATACGAGCAGTACTTCGGGCCG	CATSPRQGAQYEQYF	1
CTACACACCCTGCAGCCAGAAGACTCGGCCCTGTATCTCTGTGCCAGCAGCTTGGTAGCAGGGGCCTATGGCTACACCTTCGGTTCG	CASSLVAGAYGYTF	2
CTGGAGTTGGCTGCTCCCTCCCAGACATCTGTGTACTTCTGTGCCAGCAACGTACCGGGGGAAAGGACTGAAGCTTTCTTTGGACAA	CASNVPGERTEAFF	1
GCAAAGCTTGAGGACTCGGCCGTGTATCTCTGTGCCAGCAGCTTTTTTGGAGGGCGGGGTACCACAGATACGCAGTATTTTGGCCCA	CASSFFGGRGTTDTQYF	2
CTACACGCCCTGCAGCCAGAAGACTCAGCCCTGTATCTCTGCGCCAGCAGCCATCAGGGGATGGGGGAGACCCAGTACTTCGGGCCA	CASSHQGMGETQYF	1
TCGGCCCAAAAGAACCCGACAGCTTTCTATCTCTGTGCCAGTAGCCGGACAGGGGGCGTCTTGAATCAGCCCCAGCATTTTGGTGAT	CASSRTGGVLNQPQHF	1
CAGCCCTCAGAACCCAGGGACTCAGCTGTGTACTTCTGTGCCAGCAGTTTCGGGTCTCGGACCTACAATGAGCAGTTCTTCGGGCCA	CASSFGSRTYNEQFF	1
CCCTCAGAACCCAGGGACTCAGCTGTGTACTTCTGTGCCAGCAGTTTACCTAGCGGGACCCGTCGAGATACGCAGTATTTTGGCCCA	CASSLPSGTRRDTQYF	1
TTGGAGCTGGGGGACTCGGCCCTTTATCTTTGCGCCAGCAGCCTCTCGGCTAGCGGGGGGGCCGGAGATGAGCAGTTCTTCGGGCCA	CASSLSASGGAGDEQFF	1
CTGGAGTCCGCCAGCACCAACCAGACATCTATGTACCTCTGTGCCAGCCTCTCTGGGGGAGCAGGGCCGGGCTACACCTTCGGTTCG	CASLSGGAGPGYTF	1
TCCACGGAGTCAGGGGACACAGCACTGTATTTCTGTGCCAGCTTGCTAGCCTAGCGGGCCGGTACCTACGAGCAGTACTTCGGGCCG	CASLLA*RAGTYEQYF	1
ACCTTGGAGCTGGGGGACTCGGCCCTTTATCTTTGCGCCAGCAGCTTGGCATCCCTGAGCTCCTACAATGAGCAGTTCTTCGGGCCA	CASSLASLSSYNEQFF	1
ACATCGGCCCAAAAGAACCCGACAGCTTTCTATCTCTGTGCCAGTAGGCAACAGGGGTTCGGCAATCAGCCCCAGCATTTTGGTGAT	CASRQQGFGNQPQHF	1
AGTTCTAAGAAGCTCCTTCTCAGTGACTCTGGCTTCTATCTCTGTGCCTGGACCCTCACGGGGGCAGATACGCAGTATTTTGGCCCA	CAWTLTGADTQYF	2
CTGCAGCCAGAAGACTCGGCCCTGTATCTCTGTGCCAGCAGCCAAGATTGGGAACAGGGGGCCACAGATACGCAGTATTTTGGCCCA	CASSQDWEQGATDTQYF	1
CACATCAATTCCCTGGAGCTTGGTGACTCTGCTGTGTATTTCTGTGCCAGCAGCCAAGATAAACCCGGGGAGCTGTTTTTTGGAGAA	CASSQDKPGELFF	1
GTGAGCACCTTGGAGCTGGGGGACTCGGCCCTTTATCTTTGCGCCAGCAGCTTGGACGGCCCTCGGACCATTCAGTACTTCGGCGCC	CASSLDGPRTIQYF	1
TCCGCTACCAGCTCCCAGACATCTGTGTACTTCTGTGCCATCACTAAGACAGCCTACGAAGCTGGAAACACCATATATTTTGGAGAG	CAITKTAYEAGNTIYF	1
GTGCCCATCCTGAAGACAGCAGCTTCTACATCTGCAGTGCTAGAGGGATTGTTGACTAGCCGCCCCTACGAGCAGTACTTCGGGCCG		1
ATCCAGCGCACACAGCAGGAGGACTCCGCCGTGTATCTCTGTGCCAGCAGCTTAGTAGCCAGCGGGTCTGGCTACACCTTCGGTTCG	CASSLVASGSGYTF	11
CAGGTAGTGCGAGGAGATTCGGCAGCTTATTTCTGTGCCAGCTCACCACCTATGGGGCCGGGTACAGAGACCCAGTACTTCGGGCCA	CASSPPMGPGTETQYF	1
CCAGGCCTGGGGGACGCAGCCATGTACCTGTGTGCCACCAGCAGGAACACCAGGGGAGCCGTCAATCAGCCCCAGCATTTTGGTGAT	CATSRNTRGAVNQPQHF	1
ACCTTGGAGCTGGGGGACTCGGCCCTTTATCTTTGCGCCAGCAGCTTGGAAGACTTCCCCCCCGGCAATGAGCAGTTCTTCGGGCCA	CASSLEDFPPGNEQFF	1
AATGTGAACGCCTTGGAGCTGGACGACTCGGCCCTGTATCTCTGTGCCAGCAGCCTCGGACGCCGGGCAGAACTGTTTTTTGGCAGT	CASSLGRRAELFF	4
GCCCTGCAGCCAGAAGACTCAGCCCTGTATCTCTGCGCCAGCAGCCAAGACGGTAAGGGTGGTCGCACTGAAGCTTTCTTTGGACAA	CASSQDGKGGRTEAFF	1
ACAGTGACCAGTGCCCATCCTGAAGACAGCAGCTTCTACATCTGCAGTGCTAGAGGGGGCGGCGTTGAAAAACTGTTTTTTGGCAGT	CSARGGGVEKLFF	1
ATCCAGCGCACAGAGCGGGGGGACTCAGCCGTGTATCTCTGTGCCAGCAGCTCCAGTTCAATCACAGATACGCAGTATTTTGGCCCA	CASSSSSITDTQYF	1
AATTCCCTGGAGCTTGGTGACTCTGCTGTGTATTTCTGTGCCAGCAGCCAAGAGTCGACAGGGTCCTATGGCTACACCTTCGGTTCG	CASSQESTGSYGYTF	1
CTGCTGTCGGCTGCTCCCTCCCAGACATCTGTGTACTTCTGTGCCAGCAGGGGGGGGGCAGCCAACACTGAAGCTTTCTTTGGACAA	CASRGGAANTEAFF	2
GAGATGAATGTGAGCACCTTGGAGCTGGGGGACTCGGCCCTTTATCTTTGCGCCAGCAGCTTGGGCAATACGCAGTATTTTGGCCCA	CASSLGNTQYF	1
TCGGCCCAAAAGAACCCGACAGCTTTCTATCTCTGTGCCAGTAGTATAGTTGCCGGAGGGGGTAACACTGAAGCTTTCTTTGGACAA	CASSIVAGGGNTEAFF	1
GCGTCTGCTGTACCCTCTCAGACATCTGTGTACTTCTGTGCCAGCAGTTCAAGCGGGGGAGACACAGATACGCAGTATTTTGGCCCA	CASSSSGGDTDTQYF	1
CTCACTCTGGAGTCCGCTACCAGCTCCCAGACATCTGTGTACTTCTGTGCCATCAGTGATAGGGCAGATACGCAGTATTTTGGCCCA	CAISDRADTQYF	1
ATCCTGAGTTCTAAGAAGCTCCTTCTCAGTGACTCTGGCTTCTATCTCTGTGCCTGGATGGACAGGGAAATTCCGTTCTTTGGCCCA	CAWMDREIPFF	1
AGTGCCCATCCTGAAGACAGCAGCTTCTACATCTGCAGTGCTAGAGATGAGGCGGGACCCCTCTCCTACGAGCAGTACTTCGGGCCG	CSARDEAGPLSYEQYF	1
GAGTCGGCTGCTCCCTCCCAGACATCTGTGTACTTCTGTGCCAGCACTTCAGACGGGGGAAAGGCCGGGGAGCTGTTTTTTGGAGAA	CASTSDGGKAGELFF	1
GAGTCGCCCAGCCCCAACCAGACCTCTCTGTACTTCTGTGCCAGCAGGGACCCAACCCGAGCTAACTATGGCTACACCTTCGGTTCG	CASRDPTRANYGYTF	2
CCTGCAAAGCTTGAGGACTCGGCCGTGTATCTCTGTGCCAGCAGCTCTAACCCGGGACAGGGGATCGACGAGCAGTACTTCGGGCCG	CASSSNPGQGIDEQYF	1
CTCACTGTGACATCGGCCCAAAAGAACCCGACAGCTTTCTATCTCTGTGCCACCCGGGACGGGAACTATGGCTACACCTTCGGTTCG	CATRDGNYGYTF	1
GAGATCCAGTCCACGGAGTCAGGGGACACAGCACTGTATTTCTGTGCCAGCAGAACAGGTTAGGTTCAGCCCCAGCATTTTGGTGAT	CASRTG*VQPQHF	1
CTGCTGTACCCTCTCAGACATCTGTGTACTTCTGTGCCAGCAGTGGAGTACAGGGGGCACGCGGGGAAGACCCAGTACTTCGGGCCA		2
ACAGAGCGGGGGGACTCAGCCGTGTATCTCTGTGCCAGCAGCTCCCTGACCGGGACTACCTACCCCGGGGAGCTGTTTTTTGGAGAA	CASSSLTGTTYPGELFF	1
ACTCTGGAGTCTGCTGCCTCCTCCCAGACATCTGTATATTTCTGCGCCGGCAGTGGGGCGGGGTTCTATGGCTACACCTTCGGTTCG	CAGSGAGFYGYTF	1
CAGGCCTGGGGGACGCAGCCATGTACCTGTGTGCCACCAGCAGAGGGTCTTTGCGGTGACTCAGAGGGGGAGCTGTTTTTTGGAGAA		1
CGCACAGAGCGGGGGGACTCAGCCGTGTATCTCTGTGCCAGCAGCTTAAATGGGGGATCGAACACCGGGGAGCTGTTTTTTGGAGAA	CASSLNGGSNTGELFF	3
TTGGAGCTGGGGGACTCGGCCCTTTATCTTTGCGCCAGCAGCCCTGGAGGGGGACAGGGAGGTGGAGAAAAACTGTTTTTTGGCAGT	CASSPGGGQGGGEKLFF	2
CAGCCCTCAGAACCCAGGGACTCAGCTGTGTACTTCTGTGCCAGCAGTTTTAATCTAGCCTGGCTCTACGAGCAGTACTTCGGGCCG	CASSFNLAWLYEQYF	1
ACGATCCAGCGCACACAGCAGGAGGACTCGGCCGTGTATCTCTGTGCCAGCAGCTTTCAAGGCACCGGGGAGCTGTTTTTTGGAGAA	CASSFQGTGELFF	3
ACAGTGACCAGTGCCCATCCTGAATACAGCAGCTTCTACATCTGCAGTGCTAGAGTGGACAGCAATCAGCCCCAGCATTTTGGTGAT	CSARVDSNQPQHF	1
AGGTAGTGCGAGGAGATTCGGCAGCTTATTTCTGTGCCAGCTCACCACCTCGGTTGACCCTCCTACAATGAGCAGTTCTTCGGGCCA		2
ACTGTGACATCGGCCCAAAAGAACCCGACAGCTTTCTATCTCTGTGCCAGTAGTAGGGACGTGAATCAGCCCCAGCATTTTGGTGAT	CASSRDVNQPQHF	1
AGGCTGGAGTTGGCTGCTCCCTCCCAGACATCTGTGTACTTCTGTGCCAGCAGTTATGACAGCCTACAGCCCCAGCATTTTGGTGAT	CASSYDSLQPQHF	1
CCCCTGACCCTGGAGTCTGCCAGGCCCTCACATACCTCTCAGTACCTCTGTGCCAGCAGCCAAATCCATGGCTACACCTTCGGTTCG	CASSQIHGYTF	1
ATCCTGTACCTTGGAGATCCAGTCCACGGAGTCAGGGGACACAGCACTGTATTTCTGTGCCAGGACTAAACCATATATTTTGGAGAG		6
TCCACAAAGCTGGAGGACTCAGCCATGTACTTCTGTGCCAGCAGATCGGGACTGAGGAGTTGGCCAGATACGCAGTATTTTGGCCCA	CASRSGLRSWPDTQYF	1
AGCACCTTGGAGCTGGGGGACTCGGCCCTTTATCTTTGCGCCAGCAGCCCCTTGGCGGGGGAAAGCGGAGAGCAGTTCTTCGGGCCA	CASSPLAGESGEQFF	1
CAGCCCTCAGAACCCAGGGACTCAGCTGTGTACTTCTGTGCCAGCAGTTTATTTGCGGGGGCGGTCACTGGAGCTTTCTTTGGACAA	CASSLFAGAVTGAFF	1
TTCTCAACTCTGACTGTGAGCAACATGAGCCCTGAAGACAGCAGCATATATCTCTGCAGCGTTGACTATGGCTACACCTTCGGTTCG	CSVDYGYTF	1
ATCCTGAAGACAGCAGCTTCTACATCTGCAGTGCTAGAGCCGACTAGCGGGCCCGTGAGACGCGGCTACGAGCAGTACTTCGGGCCG		1
CCAGGCCTGGGGGACGCAGCCATGTACCTGTGTGCCACCAGCAGAGCCTTGTTGGGACAGAGCAATCAGCCCCAGCATTTTGGTGAT	CATSRALLGQSNQPQHF	1
AGCTGGGGGACTCAGCTTTGTATTTCTGTGCCAGCAGCGTAGACGGGAAACAGGGGGCGCGACTCGGCTGGCTACACCTTCGGTTCG		1
CATCCTGAAGACAGCAGCTTCTACATCTGCAGTGCTAGACCTATAGACAGGGGAGGGGGCAGCAATCAGCCCCAGCATTTTGGTGAT	CSARPIDRGGGSNQPQHF	2
TCAGAACCCAGGGACTCAGCTGTGTACTTCTGTGCCAGCAGTTTATCTACTGGGGAGTCTGGGGCCAACGTCCTGACTTTCGGGGCC	CASSLSTGESGANVLTF	1
ACCAGACAGCTCTTTACTTCTGTGCCACCAGTGATTCCTCTCGACAGGGGGGGCTCCTCTGGGGCCAACGTCCTGACTTTCGGGGCC		1
AGGATCCAGCAGGTAGTGCGAGGAGATTCGGCAGCTTATTTCTGTGCCAGCTCACCAAACGTTGACTATGGCTACACCTTCGGTTCG	CASSPNVDYGYTF	1
CTGATCCTGGAGTCGCCCAGCCCCAACCAGACCTCTCTGTACTTCTGTGCCAGCAGTTTTGGGGGTAGGAAGCAGTTCTTCGGGCCA	CASSFGGRKQFF	1
CCCCTGATCCTGGAGTCGCCCAGCCCCAACCAGACCTCTCTGTACTTCTGTGCCAGCAGATCGGGACCACTCGAGTATTTTGGAGAG	CASRSGPLEYF	1
AGGCTGGAGTCGGCTGCTCCCTCCCAGACATCTGTGTACTTCTGTGCCAGCAGTGGGCGCGTGGAGGGACCCCAGTACTTCGGGCCA	CASSGRVEGPQYF	1
TCCCTGGAGCTTGGTGACTCTGCTGTGTATTTCTGTGCCAGCAGCCAAGAGGGGGACACGGCTGGTTCACCCCTCCACTTTGGGAAC	CASSQEGDTAGSPLHF	1
CTGACAGTGACCAGTGCCCATCCTGAAGACAGCAGCTTCTACATCTGCAGTGCTAGCTTAACTAATGACGAGCAGTACTTCGGGCCG	CSASLTNDEQYF	1
CCTGAAGACAGCAGCTTCTACATCTGCAGTGCTAGTACTTTGCTAGCGGGAGATCTAAACTCCTACAATGAGCAGTTCTTCGGGCCA	CSASTLLAGDLNSYNEQFF	1
AGCACCTTGGAGCTGGGGGACTCGGCCCTTTATCTTTGCGCCAGCACCTTGGGGGGGGATAAACGCAATGAGCAGTTCTTCGGGCCA	CASTLGGDKRNEQFF	4
TGCCTTGGAGCTGGGGGACTCGGCCCTGTATCTCTGTGCCAGAACGGGGGGGCGGTCCGCTACCAAGAGACCCAGTACTTCGGGCCA		1
GATTCTGGAGTCCGCCAGCACCAACCAGACATCTATGTACCTCTGTGCCAGCAGTACTAACGGGACTGCCGCCAGTACTTCGGGCCA		2
CTGAGCTGAATGTGAACGCCTTGTTGCTGGGGGACTCGGCCCTGTATCTCTGTGCCCGCACACGGGGATACGCAGTATTTTGGCCCA		1
AGCACCTTGGAGCTGGGGGACTCGGCCCTTTATCTTTGCGCCAGCAGCTTTTCCGGGACAGGGAACACTGAAGCTTTCTTTGGACAA	CASSFSGTGNTEAFF	1
GCCTTGGAGCTGGACGACTCGGCCCTGTATCTCTGTGCCAGCAGCTCTCAAGGACTAGCGGGAGTAAATGAGCAGTTCTTCGGGCCA	CASSSQGLAGVNEQFF	1
CTGAGCTCTCTGGAGCTGGGGGACTCAGCTTTGTATTTCTGTGCCAGCAGCGGTAGCGGGAGGGCGAACGAGCAGTACTTCGGGCCG	CASSGSGRANEQYF	1
GGGGACTCGGCCCTTTATCTTTGCGCCAGCAGCATAATCGAACTCAATGATGTCAGGCATGACAGAGATGGCTAGTTCTTCGGGCCA	CASSIIELNDVRHDRDG*FF	1
TCGGCCCAAAAGAACCCGACAGCTTTCTATCTCTGTGCCAGTAGTATACTTAGCGGGAGTAGGAACAATGAGCAGTTCTTCGGGCCA	CASSILSGSRNNEQFF	1
TTGGCTGCTCCCTCCCAGACATCTGTGTACTTCTGTGCCAGCAGTCCCCCCCGAGACAGCGTTGGAAACACCATATATTTTGGAGAG	CASSPPRDSVGNTIYF	1
CTGTCGGCTGCTCCCTCCCAGACATCTGTGTACTTCTGTGCCAGCAGTTACTCATCCGGGGGGGCAGATACGCAGTATTTTGGCCCA	CASSYSSGGADTQYF	1
CTGTCGGCTGCTCCCTCCCAGACATCTGTGTACTTCTGTGCCAGCAGAGACCCCCGGGGTTCTGGAAACACCATATATTTTGGAGAG	CASRDPRGSGNTIYF	1
ACTGTGACATCGGCCCAAAAGAACCCGACAGCTTTCTATCTCTGTGCCAGTACTCCGGGACCCCAAGAGACCCAGTACTTCGGGCCA	CASTPGPQETQYF	1
AGGCTGGAGTCGGCTGCTCCCTCCCAGACATCTGTGTACTTCTGTGCCAGCCAGCCGGGACTAGCATACGAGCAGTACTTCGGGCCG	CASQPGLAYEQYF	2
ATCCAGCGCACAGGGCAGGGGGACTCGGCCATGTATCTCTGTGCCAGCAGCTTACCCGGGCCAAAATACGAGCAGTACTTCGGGCCG	CASSLPGPKYEQYF	6
GTGACATCGGCCCAAAAGAACCCGACAGCTTTCTATCTCTGTGCCAGTACCCTAGAGGGGTTTACCGGGGAGCTGTTTTTTGGAGAA	CASTLEGFTGELFF	1
ATCCAGCGCACAGAGCAGGGGGACTCGGCCATGTATCTCTGTGCCAGCAGCCCCCGTCGGGGAAACTATGGCTACACCTTCGGTTCG	CASSPRRGNYGYTF	2
CTGGAGCTGGGGGACTCAGCTTTGTATTTCTGTGCCAGCAGCGTAGTAGACGGGAGGGAAAGCACAGATACGCAGTATTTTGGCCCA	CASSVVDGRESTDTQYF	1
GGGTTGGAGTCGGCTGCTCCCTCCCAAACATCTGTGTACTTCTGTGCCAGCAGTGCTACAGGGCACTATGGCTACACCTTCGGTTCG	CASSATGHYGYTF	2
GTGAGCACCTTGGAGCTGGGGGACTCGGCCCTTTATCTTTGCGCCAGCCGCCCGACAGGGACGGGGAGTGGCTACACCTTCGGTTCG	CASRPTGTGSGYTF	8
GAGTCGGCTGCTCCCTCCCAGACATCTGTGTACTTCTGTGCCAGCAGTGAGTGGAACAGGGGGCATAGTGAGCAGTTCTTCGGGCCA	CASSEWNRGHSEQFF	1
AGCTCTCTGGAGCTGGGGGACTCAGCTTTGTATTTCTGTGCCAGCAGCGTAGGGGGGGTGGGAAATCAGCCCCAGCATTTTGGTGAT	CASSVGGVGNQPQHF	1
GCCTTGGAGCTGGACGACTCGGCCCTGTATCTCTGTGCCAGCAGCCCGGTGTTAGGGCGTTCCTACAATGAGCAGTTCTTCGGGCCA	CASSPVLGRSYNEQFF	1
AGTGCCCATCCTGAAGACAGCAGCTTCTACATCTGCAGTGCTAGAATCCAGGGGGCCCGCTTGGGTGAGACCCAGTACTTCGGGCCA	CSARIQGARLGETQYF	3
AGCACCTTGGAGCTGGGGGACTCGGCCCTTTATCTTTGCGCCAGCAGCTTGGCCGGTGCCATGAACACTGAAGCTTTCTTTGGACAA	CASSLAGAMNTEAFF	1
AGCTGGAGGACTCAGCCATGTACTTCTGTGCCAGCACTACCTCGGGACAGGCCTTGCGTAACCTACAATGAGCAGTTCTTCGGGCCA		1
AGGTGCAGCCTGCAGAACTGGAGGATTCTGGAGTTTATTTCTGTGCCAGCAGTGGGCCGATCGGACACTGAAGCTTTCTTTGGACAA		1
TTGGCGTCTGCTGTACCCTCTCAGACATCTGTGTACTTCTGTGCCAGCAGAAACCCCGGACAGACAGACACCATATATTTTGGAGAG	CASRNPGQTDTIYF	2
AGCTCTGAGCTGAATGTGAACGCCTTGGAGCTGGAGGACTCGGCCCTGTATCTCTGTGCCAGCAGCTATGGCTACACCTTCGGTTCG	CASSYGYTF	1
AGGAGGACTCCGCCGTGTATCTCTGTGCCAGCAGCGCCCACCCCAAATCACTACCAACGTAGCACAGATACGCAGTATTTTGGCCCA		1
TCCACAAAGCTGGAGGACTCAGCCATGTACTTCTGTGCCAGCAGTGAAGATGGGGGGGGGCGCACCGGGGAGCTGTTTTTTGGAGAA	CASSEDGGGRTGELFF	1
ACCAGTGCCCATCCTGAAGACAGCAGCTTCTACATCTGCAGTGCCATTCAAGGGGGGGGCCGGTATGCGACCCAGTACTTCGGGCCA	CSAIQGGGRYATQYF	1
AGCTGAATGTGAACGCCTTGGAGCTGGAGGACTCGGCCCTGTATCTCTGTGCCAGCAGCCGCATGTGATACGCAGTATTTTGGCCCA		2
CTGACCCTGGAGTCTGCCAGGCCCTCACATACCTCTCAGTACCTCTGTGCCAGCAGTGACTCCCGAGGGGGCTACACCTTCGGTTCG	CASSDSRGGYTF	1
CTGTCCCTAGAGTCTGCCATCCCCAACCAGACAGCTCTTTACTTCTGTGCCACCAAGGGGTTGGCGGGTGAGCAGTTCTTCGGGCCA	CATKGLAGEQFF	2
CTCACTGTGACATCGGCCCAAAAGAACCCGACAGCTTTCTATCTCTGTGCCAGTAGTATGAAGTCGGATACGCAGTATTTTGGCCCA	CASSMKSDTQYF	1
TCCACAAAGCTGGAGGACTCAGCCATGTACTTCTGTGCCAGCGGCATCTCCGCGGCGGGAGTGGAGGTCGAGCAGTACTTCGGGCCA	CASGISAAGVEVEQYF	1
ACCTTGGAGCTGGGGGACTCGGCCCTTTATCTTTGCGCCAGCAGCGTAGACATGACCCTAAGCACAGATACGCAGTATTTTGGCCCA	CASSVDMTLSTDTQYF	1
TCGGCTGCTCCCTCCCAAACATCTGTGTACTTCTGTGCCAGCAGTTACTCCAGGACAGGGGCATTCCCTGAAGCTTTCTTTGGACAA	CASSYSRTGAFPEAFF	1
AGCTGGAGTCAGCTGCTCCCTCTCAGACTTCTGTTTACTTCTGTGCCGCCGGAATGGGCAGCGGATCGCGAGCAGTACTTCGGGCCG		17
CCTCTCACTGTGACATCGGCCCAAAAGAACCCGACAGCTTTCTATCTCTGTGCCAGCTTTTGGGGACTTGAAGCTTTCTTTGGACAA	CASFWGLEAFF	1
AGCACCTTGGAGCTGGGGGACTCGGCCCTTTATCTTTGCGCCAGCAAAAGGGGGCTTGGGGACACAGATACGCAGTATTTTGGCCCA	CASKRGLGDTDTQYF	1
CAGCCCTCAGAACCCAGGGACTCAGCTGTGTACTTCTGTGCCAGCAGTGGCATGAGGATGTTCACAGATACGCAGTATTTTGGCCCA	CASSGMRMFTDTQYF	1
CTGAAGATCCAGCCCTCAGAACCCAGGGACTCAGCTGTGTACTTCTGTGCCAGCAGTTTACAGGGCTATGGCTACACCTTCGGTTCG	CASSLQGYGYTF	1
GACCCTGGAGTCTGCCAGGCCCTCACATACCTCTCAGTACCTCTGTGCCAGCAGTGAATAGAGGTCTACGAGCAGTACTTCGGGCCG		1
ACTGTGACATCGGCCCAAAAGAACCCGACAGCTTTCTATCTCTGTGCCAGTAGTCCTTGGGTGAACACTGAAGCTTTCTTTGGACAA	CASSPWVNTEAFF	2
GAGTCGGCTGCTCCCTCCCAAACATCTGTGTACTTCTGTGCCAGCAGTCTGCGACTAGCGGGGGGGAGTGAGCAGTACTTCGGGCCG	CASSLRLAGGSEQYF	1
GTGAGCACCTTGGAGCTGGGGGACTCGGCCCTTTATCTTTGCGCCAGCAGCGTGGGACAGGGGGAAAACATTCAGTACTTCGGCGCC	CASSVGQGENIQYF	1
CTGGAGCTTGGTGACTCTGCTGTGTATTTCTGTGCCAGCAGCCAAGATTCCCCCTCCGGTCAGGCGACACCCCTCCACTTTGGGAAC	CASSQDSPSGQATPLHF	5
ACATCGGCCCAAAAGAACCCGACAGCTTTCTATCTCTGTGCCAGTAGTGGACAACCCGGGATCGGAGAGACCCAGTACTTCGGGCCA	CASSGQPGIGETQYF	2
AGGATCCAGCAGGTAGTGCGAGGAGATTCGGCAGCTTATTTCTGTGCCAGCTCACTACAGGGTTACAATGAGCAGTTCTTCGGGCCA	CASSLQGYNEQFF	3
CGCACACAGCAGGAGGACTCGGCCGTGTATCTCTGTGCCAGCAGCTCGACAGGGGTAGGCTCCTACAATGAGCAGTTCTTCGGGCCA	CASSSTGVGSYNEQFF	1
CTGGAGTCTGCTGCCTCCTCCCAGACATCTGTATATTTCTGCGCCAGCAGTGAGTCGAGGGGTGCGGATGAGCAGTTCTTCGGGCCA	CASSESRGADEQFF	1
ACAGTGACCAGTGCCCATCCTGAAGACAGCAGCTTCTACATCTGCAGTGCCAGTGATAGCGCCACCTACGAGCAGTACTTCGGGCCA	CSASDSATYEQYF	4
CGGTCCACAAAGCTGGAGGACTCAGCCATGTACTTCTGTGCCAGCAGTGGAGCCAGGGGAGTATCCTACGAGCAGTACTTCGGGCCG	CASSGARGVSYEQYF	1
AATTCCCTGGAGCTTGGTGACTCTGCTGTGTATTTCTGTGCCAGCAGCCCCCACATGAACTCTGGAAACACCATATATTTTGGAGAG	CASSPHMNSGNTIYF	1
AACGCCTTGTTGCTGGGGGACTCGGCCCTGTATCTCTGTGCCAGCACCCGGACAGGCGGAACTAATGAAAAACTGTTTTTTGGCAGT	CASTRTGGTNEKLFF	2
TCGGCTGCTCCCTCCCAAACATCTGTGTACTTCTGTGCCAGCAGTCATATAATGACAGGGGGCCTTACTGAAGCTTTCTTTGGACAA	CASSHIMTGGLTEAFF	1
CTGAGCTCTCTGGAGCTGGGGGACTCAGCTTTGTATTTCTGTGCCAGCAGCCCACAGCGGGGGGAAGAGACCCAGTACTTCGGGCCA	CASSPQRGEETQYF	1
CTGTCGGCTGCTCCCTCCCAGACATCTGTGTACTTCTGTGCCAGCAGTTACTCGGGAACTAACTCCTACGAGCAGTACTTCGGGCCG	CASSYSGTNSYEQYF	1
GTGAACGCCTTGGAGCTGGACGACTCGGCCCTGTATCTCTGTGCCAGCAGCTTAGATCAAAGCTCCTACGAGCAGTACTTCGGGCCG	CASSLDQSSYEQYF	1
CTGAGGATCCAGCAGGTAGTGCGAGGAGATTCGGCAGCTTATTTCTGTGCCAGCTCAGCACAGAAAGAGACCCAGTACTTCGGGCCA	CASSAQKETQYF	1
ATCCGGTCCACAAAGCTGGAGGACTCAGCCATGTACTTCTGTGCCGGAAGAGACAGCACCTCTGGAAACACCATATATTTTGGAGAG	CAGRDSTSGNTIYF	1
CAGCGCACAGAGCAGGGGGACTCGGCCATGTATCTCTGTGCCAGCAGCTTACTAAGCGGGGCCACAGATACGCAGTATTTTGGCCCA	CASSLLSGATDTQYF	2
CTGAAGATCCGGTCCACAAAGCTGGAGGACTCAGCCATGTACTTCTGTGCCAGCAGTGAGTCGACCACTGAAGCTTTCTTTGGACAA	CASSESTTEAFF	1
AGATCCAGTCCACGGAGTCAGGGGACACAGCACTGTATTTCTGTGCCTCAACCGGGGGGGGAGAGAACTGAAGCTTTCTTTGGACAA		1
CTGGAGCTGGGGGACTCAGCTTTGTATTTCTGTGCCAGCAGCTTGGGACTAGCGGGGGGGCTTCAAGAGACCCAGTACTTCGGGCCA	CASSLGLAGGLQETQYF	1
GTGACCAGTGCCCATCCTGAAGACAGCAGCTTCTACATCTGCAGTGCTAGAGATGGGGGAGGGCCCAATGAGCAGTTCTTCGGGCCA	CSARDGGGPNEQFF	1
CGCACAGAGCAGGGGGACTCGGCCATGTATCTCTGTGCCAGCAGCTTAATGGGTGCGGGATCCAAAAACATTCAGTACTTCGGCGCC	CASSLMGAGSKNIQYF	1
AGCACCTTGGAGCTGGGGGACTCGGCCCTTTATCTTTGCGCTAGCAGCTTGGCGACAGGGTCTTCGAACGAGCAGTACTTCGGGCCG	CASSLATGSSNEQYF	1
CGCACAGAGCAGGGGGACTCGGCCATGTATCTCTGTGCCAGCAGCTTAGCGCGCGGGGGATTCAACTATGGCTACACCTTCGGTTCG	CASSLARGGFNYGYTF	6
TCCCTGGAGCTTGGTGACTCTGCTGTGTATTTCTGTGCCAGCAGCCAAGATATCCAGGGGGCCGTCAGGGGCTACACCTTCGGTTCG	CASSQDIQGAVRGYTF	1
GGCGTCTGCTGTACCCTCTCAGACATCTGTGTACTTCTGTGCCAGCAGTGAGGGGGAGACCTCAACTATGGCTACACCTTCGGTTCG		1
ATCCGCTCACCAGGCCTGGGGGACGCAGCCATGTACCTGTGTGCCACCAGCAGAGACGGGGCAACCGGGGAGCTGTTTTTTGGAGAA	CATSRDGATGELFF	1
AACCTGAGCTCTCTGGAGCTGGGGGACTCAGCTTTGTATTTCTGTGCCAGCAGCGTAGCTCTTCAGGGGCCCCAGCATTTTGGTGAT	CASSVALQGPQHF	1
CTGAGTTCTAAGAAGCTCCTTCTCAGTGACTCTGGCTTCTATCTCTGTGCCTGGGCCGGGACAGGGGATGGCTACACCTTCGGTTCG	CAWAGTGDGYTF	1
GCAGAACTGGAGGATTCTGGAGTTTATTTCTGTGCCAGCAGCCGGTCAAGGGGCCCGGGGCAGATCGGGGAGCTGTTTTTTGGAGAA	CASSRSRGPGQIGELFF	1
ACAGTGACCAGTGCCCATCCTGAAGACAGCAGCTTCTACATCTGCAGTGCTAGAGTTGGGGGGCTAGAGACCCAGTACTTCGGGCCA	CSARVGGLETQYF	1
CTCAGGCTGGAGTTGGCTGCTCCCTCCCAGACATCTGTGTACTTCTGTGCCAGCAGTTACGGAAGGGAGACCCAGTACTTCGGGCCA	CASSYGRETQYF	1
CCACGGAGTCAGGGGACACAGCACTGTATTTCTGTGCCAGCAGCCCCCACAAAACCGGGCTCCTACAATGAGCAGTTCTTCGGGCCA		1
GAGTCAGCTACCCGCTCCCAGACATCTGTGTATTTCTGCGCCAGCAGCCCGGGACTAGCGGGTCAGGGGACCCAGTACTTCGGGCCA	CASSPGLAGQGTQYF	1
CAGCGCACACAGCAGGAGGACTCGGCCGTGTATCTCTGTGCCAGCAGCGGAACTAGCGGGGCCTACAATGAGCAGTTCTTCGGGCCA	CASSGTSGAYNEQFF	1
TTGGGGCTGGGGGACTCGGCCCTTTATCTTTGCGCCAGCAGCTTGGTTCCTGGGACAGCCCCGGTGGATACGCAGTATTTTGGCCCA	CASSLVPGTAPVDTQYF	1
CTGAGCTCTCTGGAGCTGGGGGACTCAGCTTTGTATTTCTGTGCCAGCAGCCCAACGACTAGCGCAGAGACCCAGTACTTCGGGCCA	CASSPTTSAETQYF	1
TCCGCTACCAGCTCCCAGACATCTGTGTACTTCTGTGCCATCAGTGAGTCGAAGGGAGCTAGCACAGATACGCAGTATTTTGGCCCA	CAISESKGASTDTQYF	1
ACGATTCAGCGCACAGAGCAGCGGGACTCAGCCATGTATCGCTGTGCTAGCAGCTTAGATGACCAGGGGCCCCAGTACTTCGGGCCA	CASSLDDQGPQYF	1
GTGAGCACCTTGGAGCTGGGGGACTCGGCCCTTTATCTTTGCGCCAGCAGCTTGGAGGGGTTCAATTCACCCCTCCACTTTGGGAAC	CASSLEGFNSPLHF	1
CGGAGTCAGGGGACACAGCACTGTATTTCTGTGCCAGCAGCAAAGCTTCTTAGCGGGAGGCGTCCCTACGAGCAGTACTTCGGGCCG		1
GGCTGCTCCCTCCCAGACATCTGTGTACTTCTGTGCCAGCAAAAGTATGCCGAGAGCTCCTATAATTCACCCCTCCACTTTGGGAAC		3
CAGCGCACACAGCAGGAGGACTCGGCCGTGTATCTCTGTGCCAGCAGCTTAAGACAGGGAACGGCTTATGGCTACACCTTCGGTTCG	CASSLRQGTAYGYTF	1
ACCAGTGCCCATCCTGAAGACAGCAGCTTCTACATCTGCAGTGCTGAGGCCGGGACTAGCGGGAAATACGAGCAGTACTTCGGGCCG	CSAEAGTSGKYEQYF	1
AGGCTGGAGTTGGCTGCTCCCTCCCAGACATCTGTGTACTTCTGTGCCAGCAGTCATGGACAGCCCAATGAGCAGTTCTTCGGGCCA	CASSHGQPNEQFF	1
AGTGCCCATCCTGAAGACAGCAGCTTCTACATCTGCAGTGCTCCGATCCGGGGAGCGGGCTCCTACAATGAGCAGTTCTTCGGGCCA	CSAPIRGAGSYNEQFF	1
TCGGCTGCTCCCTCCCAAACATCTGTGTACTTCTGTGCCAGCAGTTACCTTCGGACAGGAACTCTACGAGAAGCTTTCTTTGGACAA	CASSYLRTGTLREAFF	1
AAGATCCAGCGCACACAGCAGGAGGACTCCGCCGTGTATCTCTGTGCCATCGAGGGGTCCAGCCAAGAGACCCAGTACTTCGGGCCA	CAIEGSSQETQYF	1
AAGATCCAGCCTGCAGAGCTTGGGGACTCGGCCGTGTATCTCTGTGCCAGCAGCACAGGGTCCAACAATGAGCAGTTCTTCGGGCCA	CASSTGSNNEQFF	1
CCTGCAGAACTGGAGGATTCTGGAGTTTATTTCTGTGCCAGCAGCCAAGACCCACAGGGGATTGGAAACACCATATATTTTGGAGAG	CASSQDPQGIGNTIYF	1
AACGCCTTGTTGCTGGGGGACTCGGCCCTGTATCTCTGCGCCAGCAGCCAGAGGACTAGCGGGAGAAACGAGCAGTACTTCGGGCCG	CASSQRTSGRNEQYF	1
ATCCAGCCCTCAGAACCCAGGGACTCAGCTGTGTACTTCTGTGCCAGCAGTTTACTCCTTCCGGAGAATGAGTAGTTCTTCGGGCCA	CASSLLLPENE*FF	1
CCAGTCCACGGAGTCAGGGGACACAGCACTGTATTTCTGTGCCAGCAGTGGGACTAGCGGCCCTACAATGAGCAGTTCTTCGGGCCA		1
CTGCAGCCAGAAGACTCAGCCCTGTATCTCTGCGCCAGCAGCCATATGGGGCGGGACAGATACAACAATGAGCAGTTCTTCGGGCCA	CASSHMGRDRYNNEQFF	1
AGTGCCCATCCTGAAGACAGCAGCTTCTACATCTGCAGTGCTAGACCCGGGACTAGCGGGAGTGCCGGGGAGCTGTTTTTTGGAGAA	CSARPGTSGSAGELFF	1
ACAAAGCTGGAGGACTCAGCCATGTACTTCTGTGCCAGCAGTGGGGACGCGGCGGGAGGCTTTTCAGATACGCAGTATTTTGGCCCA	CASSGDAAGGFSDTQYF	1
ATCCTGGAGTCGCCCAGCCCCAACCAGACCTCTCTGTACTTCTGTGCCTCACGGGGGGCCGCCGCCGGGGAGCTGTTTTTTGGAGAA	CASRGAAAGELFF	1
ACAAAGCTGGAGGACTCAGCCATGTACTTCTGTGCCAGCAGTTGGCGGGAGGGGACTAGGATCTCCTACGAGCAGTACTTCGGGCCG	CASSWREGTRISYEQYF	1
CTGAGCTCTCTGGAGCTGGGGGACTCAGCTTTGTATTTCTGTGCCAGCCAGGGAGAGGACCTAAACTATGGCTACACCTTCGGTTCG	CASQGEDLNYGYTF	1
CCTGCAGAGCTTGGGGACTCGGCCGTGTATCTCTGTGCCAGCAGCCTAGACGCCTAGCGGGAGTCCTACGAGCAGTACTTCGGGCCG	CASSLDA*RESYEQYF	3
CTTGGAGCTGGGGGACTCGGCCCTTTATCTTTGCGCCAGCAGCTTGCGGGACAGGAGTTTCTCAATCAGCCCCAGCATTTTGGTGAT		1
TCTGCTGTACCCTCTCAGACATCTGTGTACTTCTGTGCCAGCAGTGGTCTCACTAAGAGCTCCTACAATGAGCAGTTCTTCGGGCCA	CASSGLTKSSYNEQFF	1
GAGTCGGCTGCTCCCTCCCAGACATCTGTGTACTTCTGTGCCAGCAGTGGCCCCGGGGCCTCTAATCAGCCCCAGCATTTTGGTGAT	CASSGPGASNQPQHF	1
GAGCAGCGGGACTCGGCCATGTATCGCTGTGCCAGCAGCTTAGCGCTGCGTCTAGCGGAACTCTACAATGAGCAGTTCTTCGGGCCA	CASSLALRLAELYNEQFF	1
GCCTTGGAGCTGGACGACTCGGCCCTGTATCTCTGTGCCAGCAGCTTGTACCCCGGGACAGGGGTTGAAAAACTGTTTTTTGGCAGT	CASSLYPGTGVEKLFF	1
ATCAATTCCCTGGAGCTTGGTGACTCTGCTGTGTATTTCTGTGCCAGCACTAACAGGAACATAAACACTGAAGCTTTCTTTGGACAA	CASTNRNINTEAFF	1
CGGTCCACAAAGCTGGAGGACTCAGCCATGTACTTCTGTGCCAGCAGTGATCGGGGGCTCTCCTACAATGAGCAGTTCTTCGGGCCA	CASSDRGLSYNEQFF	1
AAGATCCAGCGCACAGAGCGGGGGGACTCAGCCGTGTATCTCTGTGCCAGCAGCTACCGGGACGGCTATGGCTACACCTTCGGTTCG	CASSYRDGYGYTF	1
GTAGTGCGAGGAGATTCGGCAGCTTATTTCTGTGCCAGCTCATCCTCTCCGGGACTAGCGGGAGCAAACATTCAGTACTTCGGCGCC	CASSSSPGLAGANIQYF	1
TCCAGCCTGCAGAGCTTGGGGACTCGGCCGTGTATCTCTGTGCCAGCAGCTCTGGACAGGGGGCGTGACACCATATATTTTGGAGAG		1
TAGAGTCTGCCATCCCCAACCAGACAGCTCTTTACTTCTGTGCCACCAACGGACAGGTGAGTCTCCTACGAGCAGTACTTCGGGCCG		2
ACTGTGAGCAACATGAGCCCTGAAGACAGCAGCATATATCTCTGCAGCGTTGTGGTGACCCCCGATCAGCCCCAGCATTTTGGTGAT	CSVVVTPDQPQHF	1
GTGACCAGTGCCCATCCTGAAGACAGCAGCTTCTACATCTGCAGTGCTAGACTACAGGGCCTTTCGGGAAAACTGTTTTTTGGCAGT	CSARLQGLSGKLFF	1
AAGCTGGAGGACTCAGCCATGTACTTCTGTGCCAGCAGTGAAATCGCCGCCGGGACAGGCGGGTTCGGGGAGCTGTTTTTTGGAGAA	CASSEIAAGTGGFGELFF	1
ACGCCTTGGAGCTGGACGACTCGGCCCTGTATCTCTGTGCCAGCAGCCAACCTACGGGCAGCTAATGAAAAACTGTTTTTTGGCAGT		5
AAGATCCAGCCCTCAGAACCCAGGGACTCAGCTGTGTACTTCTGTGCCAGCAGCGGGACAGTCGTCTACGAGCAGTACTTCGGGCCG	CASSGTVVYEQYF	1
AAGATCCGGTCCACAAAGCTGGAGGACTCAGCCATGTACTTCTGTGCCAGCACGCGGGACAGGGACACTGAAGCTTTCTTTGGACAA	CASTRDRDTEAFF	1
GAGTCTGCTGCCTCCTCCCAGACATCTGTATATTTCTGCGCCAGCAGCCCTCGACAGGGAGGGAACACTGAAGCTTTCTTTGGACAA	CASSPRQGGNTEAFF	1
ACTCTCAAGATCCAGCCTGCAGAGCTTGGGGACTCGGCCGTGTATCTCTGTGCCAGCAGCTTCGCGGATACGCAGTATTTTGGCCCA	CASSFADTQYF	1
GTTGCTGGGGGACTCGGCCCTCTATCTCTGTGCCAGCAGCTTGGAAGAGGGGGCGCGATAGGGGCCAACGTCCTGACTTTCGGGGCC		1
GCTCCCTCCCAAACATCTGTGTACTTCTGTGCCAGCAGACCGTTTCTAGGGAGAGGGAGTGGGGCCAACGTCCTGACTTTCGGGGCC	CASRPFLGRGSGANVLTF	1
AACGCCTTGTTGCTGGGGGACTCGGCCCTCTATCTCTGTGCCAGCAGCTTGGCCTTGGTGGGCCGGGGGGAGCAGTACTTCGGGCCG	CASSLALVGRGEQYF	1
CACACCCTGCAGCCAGAAGACTCGGCCCTGTATCTCTGCGCCAGCAGCCAAGAGGCTAGCTCCTACAATGAGCAGTTCTTCGGGCCA	CASSQEASSYNEQFF	1
ACTCTGGAGTCCGCTACCAGCTCCCAGACATCTGTGTACTTCTGTGCCATCGGGACTAGCGGCCAAGAGACCCAGTACTTCGGGCCA	CAIGTSGQETQYF	1
GTGAGCACCTTGGAGCTGGGGGACTCGGCCCTTTATCTTTGCGCCAGCCAGACAGGAAGCTCCACAGATACGCAGTATTTTGGCCCA	CASQTGSSTDTQYF	1
CCTGCAGCCAGAAGACTCAGCCCTGTATCTCTGCGCCAGCAGCCAAGCCGACTTGGGCTAGCGGGGGAGACCCAGTACTTCGGGCCA		1
CGCTCACCAGGCCTGGGGGACGCAGCCATGTACCTGTGTGCCACCAGCGAGGCCCGGTACCGAACCTACGAGCAGTACTTCGGGCCG	CATSEARYRTYEQYF	1
ACAGTGACCAGTGCCCATCCTGAAGACAGCAGCTTCTACATCTGCAGTGCCAGCCCCTCTGGGGCCAACGTCCTGACTTTCGGGGCC	CSASPSGANVLTF	2
GACCTTGTCCACTCTGACAGTGACCAGTGCCCATCCTGAAGACAGCAGCTTCTACATCTGCAGTGCACCCCCTGGGGCCCCGGGCCG		1
GTGAACGCCTTGTTGCTGGGGGACTCGGCCCTGTATCTCTGTGCCAGCAGCTAGGGTCAGGGGCACCATGGCTACACCTTCGGTTCG	CASS*GQGHHGYTF	1
GAGTCGCCCAGCCCCAACCAGACCTCTCTGTACTTCTGTGCCAGCAGTTTCAACAGGGGGCCGCGCGAAAAACTGTTTTTTGGCAGT	CASSFNRGPREKLFF	3
ACCTTGGAGCTGGGGGACTCGGCCCTTTATCTTTGCGCCAGCAGCCAAGGGACCTTTTTTAAGGGCGGGGAGCTGTTTTTTGGAGAA	CASSQGTFFKGGELFF	1
AACCTGAGCTCTCTGGAGCTGGGGGACTCAGCTTTGTATTTCTGTGCCAGCAGCGTAGGACTCTCCTATGAGCAGTACTTCGGGCCG	CASSVGLSYEQYF	1
CTGTCGGCTGCTCCCTCCCAGACATCTGTGTACTTCTGTGCCAGCAGTTACAGTCAGAGCTCCTACAATGAGCAGTTCTTCGGGCCA	CASSYSQSSYNEQFF	1
GCCTGCAGAGCAGGGGGACTCGGCCGTGTATGTCTGTGCAAGTCGCCCACTCTTTCAGGGGAGCCCTACGAGCAGTACTTCGGGCCA		1
CTGGAGTTGGCTGCTCCCTCCCAGACATCTGTGTACTTCTGTGCCAGCGGAGGGACAGGGGTACAAGAGACCCAGTACTTCGGGCCA	CASGGTGVQETQYF	1
CTACACACCCTGCAGCCAGAAGACTCAGCCCTGTATCTCTGCGCCAGCAGCCAAGAACGGGAGGATAATGAGCAGTTCTTCGGGCCA	CASSQEREDNEQFF	1
TTGGAGTCGGCTGCTCCCTCCCAAACATCTGTGTACTTCTGTGCCAGCAGCTCGACTACCACCAAAAACATTCAGTACTTCGGCGCC	CASSSTTTKNIQYF	1
CTGGAGTCGCCCAGCCCCAACCAGACCTCTCTGTACTTCTGTGCCAGCAGTTCAGGACAGGGGTGGTACGAGCAGTACTTCGGGCCG	CASSSGQGWYEQYF	1
CCTTGGAGCTGGACGACTCGGCCCTGTATCTCTGTGCCAGCAGCCGGATTACTAGCGGGAACTCGGGAGACCCAGTACTTCGGGCCA		1
GTCCACGGAGTCAGGGGACACAGCACTGTATTTCTGTGCCAGGACCGACTGGGACCGACCGTGGGTTCACCCCTCCACTTTGGGAAC		2
TTGTTGCTGGGGGACTCGGCCCTGTATCTCTGTGCCAGCAGCTTGGAGGGGACAGTCTATAGCAATCAGCCCCAGCATTTTGGTGAT	CASSLEGTVYSNQPQHF	1
CACGGAGTCAGGGGACACAGCACTGTATTTCTGTGCCAGCATTCCCTTCTGCAGGATAGCGGGACCTACGAGCAGTACTTCGGGCCA		2
GTGAACGCCTTGGAGCTAGACGACTCGGCCCTGTATCTCTGTGCCAGCAGCTTGGACCCAAGGACCATGGAGCAGTACTTCGGGCCG	CASSLDPRTMEQYF	1
CTGGAGTCCGCTACCAGCTCCCAGACATCTGTGTACTTCTGTGCCATCAGTAATTCTCTGGGGGGAGAGACCCAGTACTTCGGGCCA	CAISNSLGGETQYF	1
AAGATCCAGCCCTCAGAACCCAGGGACTCAGCTGTGTATTTTTGTGCTAGTGCCCCGACAGGGTCTTATGGCTACACCTTCGGTTCG	CASAPTGSYGYTF	1
AAGATCCAGCCCTCAGAACCCAGGGACTCAGCTGTGTACTTCTGTGCCAGCAGCTACAGGGGGGACACTGAAGCTTTCTTTGGACAA	CASSYRGDTEAFF	6
CACTCTGACAGTGACCAGTGCCCATCCTGAAGACAGCAGCTTCTACATCTGCAGTGACCAGGGTTTCTGGAGCTGTTTTTTGGAGAA		1
CTGACGATTCAGCGCACAGAGCAGCGGGACTCAGCCATGTATCGCTGTGCTAGCAGCTTAGTTTAAGGGGATGGGTTCTTCGGGCCA	CASSLV*GDGFF	1
GTGAACGCCTTGTTGCTGGGGGACTCGGCCCTCTATCTCTGTGCCAGCAGCTTGGGCAGCGGGGTATACGAGCAGTACTTCGGGCCG	CASSLGSGVYEQYF	1
TCTGCCATCCCCAACCAGACAGCTCTTTACTTCTGTGCCACCAGACCACCCCGGGACAGGGCTCTAGATACGCAGTATTTTGGCCCA	CATRPPRDRALDTQYF	1
CTGTCGGCTGCTCCCTCCCAGACATCTGTGTACTTCTGTGCCAGCAGAATAAGGGCCTCAACTAATGAAAAACTGTTTTTTGGCAGT	CASRIRASTNEKLFF	3
GTGACCAGTGCCCATCCTGAAGACAGCAGCTTCTACATCTGCAGTGCCCAAACGGGACAGGAGCAAGAGACCCAGTACTTCGGGCCA	CSAQTGQEQETQYF	1
TCCACGGAGTCAGGGGACACAGCACTGTATTTCTGTGCCAGCAGCAAAGTAAGCCAGGAGTTGCCAGATACGCAGTATTTTGGCCCA	CASSKVSQELPDTQYF	3
GTGAACGCCTTGGAGCTGGACGACTCGGCCCTGTATCTCTGTGCCAGCAGCTTGGCGGGGGTTGGGGAGACCCAGTACTTCGGGCCA	CASSLAGVGETQYF	1
CAGCGCACAGAGCGGGGGGACTCAGCCGTGTATCTCTGTGCCAGCAGCCCGGATCCAGGGCCGGGCTATGGCTACACCTTCGGTTCG	CASSPDPGPGYGYTF	1
CTGGAGTCTGCTGCCTCCTCCCAGACATCTGTATATTTCTGCGCCAGCAGTCTATCGGGGGGGTCAGATACGCAGTATTTTGGCCCA	CASSLSGGSDTQYF	1
GTGACATCGGCCCAAAAGAACCCGACAGCTTTCTATCTCTGTGCCAGTAGTATATGGGATAGGGAAAATGAGCAGTTCTTCGGGCCA	CASSIWDRENEQFF	1
GTGACATCGGCCCAAAAGAACCCGACAGCTTTCTATCTCTGTGCCAGTAGTATTGGGGGGGGCAATCAGCCCCAGCATTTTGGTGAT	CASSIGGGNQPQHF	1
ACAGTGACCAGTGCCCATCCTGAAGACAGCAGCTTCTACATCTGCAGTGCTGACGACGGAGGGCAAGAGACCCAGTACTTCGGGCCA	CSADDGGQETQYF	1
TTTCCTCTCACTGTGACATCGGCCCAAAAGAACCCGACAGCTTTCTATCTCTGTGCCGGGGGAATGGATACGCAGTATTTTGGCCCA	CAGGMDTQYF	1
CTGACAGTGACCAGTGCCCATCCTGAAGACAGCAGCTTCTACATCTGCAGTGCTAGTACGTCAGGGGTTGAAGCTTTCTTTGGACAA	CSASTSGVEAFF	1
ACCCAGGGACTCAGCTGTGTACTTCTGTGCCAGCAGTTCTGGACAGGGGCGAATACCAGAGGGGATTCACCCCTCCACTTTGGGAAC		1
AGTGCCCATCCTGAAGACAGCAGCTTCTACATCTGCAGTGCTAGACCGCTACTAGCGCCCAACACCGGGGAGCTGTTTTTTGGAGAA	CSARPLLAPNTGELFF	1
TCTCTGGAGCTGGGGGACTCAGCTTTGTATTTCTGTGCCAGCAGCGTATCCGGGACAGCAATGAACACTGAAGCTTTCTTTGGACAA	CASSVSGTAMNTEAFF	7
GAACCCAGGGACTCAGCTGTGTACTTCTGTGCCAGCAGTTTTTAGGGGGACACTCGCCCTGGGGCCAACGTCCTGACTTTCGGGGCC	CASSF*GDTRPGANVLTF	2
CTGCTGTCGGCTGCTCCCTCCCAGACATCTGTGTACTTCTGTGCCAGCAAATGGGACAGCAGCACAGATACGCAGTATTTTGGCCCA	CASKWDSSTDTQYF	1
AGTGCCCATCCTGAAGACAGCAGCTTCTACATCTGCAGTGCTAGCAGGGGGGGGATACCCGGGTTGGAGACCCAGTACTTCGGGCCA	CSASRGGIPGLETQYF	1
ACCAGGCCTGGGGGACGCAGCCATGTACCTGTGTGCCACCAGCGGGGGGGGCCCACCTCTGGGGCCAACGTCCTGACTTTCGGGGCC		1
CAGCCTGCAAAGCTTGAGGACTCGGCCGTGTATCTCTGTGCCAGCAGCTCCTATGGCAGTTACACCGGGGAGCTGTTTTTTGGAGAA	CASSSYGSYTGELFF	1
ACTCTGGAGTCCGCTACCAGCTCCCAGACATCTGTGTACTTCTGTGCCATCAGGGGACTGACGAACACTGAAGCTTTCTTTGGACAA	CAIRGLTNTEAFF	1
GAGTCGGCTGCTCCCTCCCAAACATCTGTGTACTTCTGTGCCAGCAGTTATTGGCCCACTTCGGCCTACGAGCAGTACTTCGGGCCG	CASSYWPTSAYEQYF	4
AACCCGACAGCTTTCTATCTCTGTGCCAGTAGTATAGGGTACAGGACAGGGGGCACCCCGATGGAAACTGAAGCTTTCTTTGGACAA	CASSIGYRTGGTPMETEAFF	1
CTGCTGGGGTTGGAGTCGGCTGCTCCCTCCCAAACATCTGTGTACTTCTGTGCCAGCAGTCGATTCCAAGAAGCTTTCTTTGGACAA	CASSRFQEAFF	1
GAACGCCTTGGAGCTGGACGACTCGGCCCTGTATCTCTGTGCCAGCAGCTTGGTGGACAGGGCAAGAACATTCAGTACTTCGGCGCC		3
CACGTTGGCGTCTGCTGTACCCTCTCAGACATCTGTGTACTTCTGTGCCAGCTCCAGGACAGGAACTATGGCTACACCTTCGGTTCG		1
ATCTTCACATCAATTCCCTGGAGCTTGGTGACTCTGCTGTGTATTTCTGTGCCAGCAGCCCGTTCGCCGCCGCCGTTCTTCGGGCCA		1
TTGGCTGCTCCCTCCCAGACATCTGTGTACTTCTGTGCCAGCAGTTCGCCTAGCGGGCTGCACCAAGAGACCCAGTACTTCGGGCCA	CASSSPSGLHQETQYF	1
ACTGTGACATCGGCCCAAAAGAACCCGACAGCTTTCTATCTCTGTGCCAGTAGTATGGGAGGGCTTCAGCCCCAGCATTTTGGTGAT	CASSMGGLQPQHF	1
GAGTCAGCTACCCGCTCCCAGACATCTGTGTATTTCTGCGCCAGCGAGCGCGGCGGGACAGGGAATGAAAAACTGTTTTTTGGCAGT	CASERGGTGNEKLFF	1
ACTGTGACATCGGCCCAAAAGAACCCGACAGCTTTCTATCTCTGTGCCAGTAGTGCAGGACAGTACAATGAGCAGTTCTTCGGGCCA	CASSAGQYNEQFF	1
TCCCTGGAGCTTGGTGACTCTGCTGTGTATTTCTGTGCCAGCAGCCAAGGGGGGAGCTCCTATAATTCACCCCTCCACTTTGGGAAC	CASSQGGSSYNSPLHF	1
ATCAATTCCCTGGAGCTTGGTGACTCTGCTGTGTATTTCTGTGCCAGCAGCCAAGAGGCGTCTTTGAGGGAGCAGTACTTCGGGCCG	CASSQEASLREQYF	3
AATCCTGTCCTCAGAACCGGGAGACACGGCACTGTATCTCTGCGCCAGCAGTCGCTACAGGGGGCGACTGAAGCTTTCTTTGGACAA		1
CTCAGGCTGGAGTCGGCTGCTCCCTCCCAGACATCTGTGTACTTCTGTGCCAGCAGTCAGGGTTTCAATGAGCAGTTCTTCGGGCCA	CASSQGFNEQFF	1
CCTGCAAAGCTTGAGGACTCGGCCGTGTATCTCTGTGCCAGCAGCTTAGATTCGAGCGGGGGAGGAGGTGAGCAGTTCTTCGGGCCA	CASSLDSSGGGGEQFF	1
ACGATCCAGCGCACAGAGCAGCGGGACTCGGCCATGTATCGCTGTGCCAGCAGCTCTACTCCCTATGAGACCCAGTACTTCGGGCCA	CASSSTPYETQYF	2
AGCTCTCTGGAGCTGGGGGACTCAGCTTTGTATTTCTGTGCCAGCAGCGTAGCTCTGTCCCCCGGAGCAGGCTACACCTTCGGTTCG	CASSVALSPGAGYTF	1
GTGACCAGTGCCCATCCTGAAGACAGCAGCTTCTACATCTGCAGTGCTCTCTATACAGCCGGTCCCGTTGTAGCTTTCTTTGGACAA	CSALYTAGPVVAFF	3
GCACCTTGGAGCTGGGGGACTCGGCCCTTTATCTTTGCGCCAGCAGCTTGGCAGGCAGGGAGAGCCGAGACCCAGTACTTCGGGCCA		1
GGCACCTTGGAGCTGGGGGACTCGGCCCTTTATCCTTGCGCCAGCAGCTTGACCGGGACTACACCCCAGGGGCAGTATTTTGGCCCA	CASSLTGTTPQGQYF	1
TGAGCACCTTGGAGCTGGGGGACTCGGCCCTTTATCTTTGCGCCAGCAGCGGGGGACAGGTTATCCTACGAGCAGTACTTCGGGCCA		1
AGTTCTAAGAAGCTCCTTCTCAGTGACTCTGGCTTCTATCTCTGTGCCTGGAGTGAACAGGGCCTCTATGGCTACACCTTCGGTTCG	CAWSEQGLYGYTF	1
CTACACGCCCTGCAGCCAGAAGACTCAGCCCTGTATCTCTGCGCCAGCAGCCCGGACAGGGGATCCTACGAGCAGTACTTCGGGCCG	CASSPDRGSYEQYF	1
TCTAAGAAGCTCCTTCTCAGTGACTCTGGCTTCTATCTCTGTGCCTGGAGTGCCGCCACTAGTACAGATACGCAGTATTTTGGCCCA	CAWSAATSTDTQYF	1
ATCCAGCAGGTAGTGCGAGGAGATTCGGCAGCTTATTTCTGTGCCAGCTCACCTGGGACGTCGATCTACGAGCAGTACTTCGGGCCG	CASSPGTSIYEQYF	1
CTGCTGTCGGCTGCTCCCTCCCAGACATCTGTGTACTTCTGTGCCAGCAGATCGAGGGGGTCCGACTATGGCTACACCTTCGGTTCG	CASRSRGSDYGYTF	1
ATCCAGCGCACACAGCAGGAGGACTCGGCCGTGTATCTCTGTGCCAGCAGCTTACCGAGGGTCCCCTACGAGCAGTACTTCGGGCCG	CASSLPRVPYEQYF	1
CTGAGTTCTAAGAAGCTCCTTCTCAGTGACTCTGGCTTCTATCTCTGTGCCTGGAGTGTAGTTAGTCTGGGACAGGACTTCGGGCCG	CAWSVVSLGQDF	1
CACACCCTGCAGCCAGAAGACTCGGCCCTGTATCTCTGCGCCAGCAGCCAACAAGCGGGGGTCAACACTGAAGCTTTCTTTGGACAA	CASSQQAGVNTEAFF	4
AAGATCCGGTCCACAAAGCTGGAGGACTCAGCCATGTACTTCTGTGCCAGCAGTGTACACCTCAGGGATGAGCAGTTCTTCGGGCCA	CASSVHLRDEQFF	1
GTCGGCTGCTCCCTCCCAGACATCTGTGTACTTCTGTGCCAGCAGTTACGGGACTCTCTAGCCAAAAACATTCAGTACTTCGGCGCC		1
CAGCCCTCAGAACCCAGGGACTCAGCTGTGTACTTCTGTGCCAGCAGTCTCGATAGCGGGAGGGCCAATGAGCAGTTCTTCGGGCCA	CASSLDSGRANEQFF	1
AACCAGACAGCTCTTTACTTCTGTGCCACCAGTGATAGAGGGACAGGAGGGCTCCACTCTGGGGCCAACGTCCTGACTTTCGGGGCC	CATSDRGTGGLHSGANVLTF	1
AAGATCCAGCCCTCAGAACCCAGGGACTCAGCTGTGTACTTCTGTGCCAGCAGTTTCGGGGGTTTCCAGCCCCAGCATTTTGGTGAT	CASSFGGFQPQHF	1
ACCAGTGCCCATCCTGAAGACAGCAGCTTCTACATCTGCAGTGCTAGAGGGAACCGCCCCACGAACAATGAGCAGTTCTTCGGGCCA	CSARGNRPTNNEQFF	1
GGGTTGGAGTCGGCTGCTCCCTCCCAAACATCTGTGTACTTCTGTGCCAGCACCTTTTCAGGGCAATACGAGCAGTACTTCGGGCCG	CASTFSGQYEQYF	1
ACCAGTGCCCATCCTGAAGACAGCAGCTTCTACATCTGCAGTGCTAGAGCCACAGGGCGGGAGAACTATGGCTACACCTTCGGTTCG	CSARATGRENYGYTF	2
ACAGTGACCAGTGCCCATCCTGAAGACAGCAGCTTCTACATCTGCAGTGCTCAGCTAGGAAGCAGCTATGGCTACACCTTCGGTTCG	CSAQLGSSYGYTF	1
ATCCGGTCCACAAAGCTGGAGGACTCAGCCATGTACTTCTGTGCCAGCAGACCGGGACTGCTAACCAACACCATATATTTTGGAGAG	CASRPGLLTNTIYF	1
AACGCCTTGTTGCTGGGGGACTCGGCCCTGTATCTCTGTGCCAGCAGCTTGGGCCGGGGACAGATGTACGAGCAGTACTTCGGGCCG	CASSLGRGQMYEQYF	1
CCGCTCAGGCTGGAGTCGGCTGCTCCCTCCCAGACATCTGTGTACTTCTGTGCCAGCAGTGAGTCCCCTGTGGCTTTCTTTGGACAA	CASSESPVAFF	1
TCGGCCCAAAAGAACCCGACAGCTTTCTATCTCTGTGCCAGTAGTATGTTCAGCGGGGGGGCCTCCGGGGAGCTGTTTTTTGGAGAA	CASSMFSGGASGELFF	1
GAGATGAATGTGAGCACCTTGGAGCTGGGGGACTCGGCCCTTTATCTTTGCGCCAGCACGGGACAACTGACGGTTCACTTCGGGCCA	CASTGQLTVHF	1
GCCCATCCTGAAGACAGCAGCTTCTACATCTGCAGTGCTAGAGATACACGACCGGGAGGCTGGGCCTATGGCTACACCTTCGGTTCG	CSARDTRPGGWAYGYTF	1
CTGAGCTCTCTGGAGCTGGGGGACTCAGCTTTGTATTTCTGTGCCAGCAGCGTAGACGCAGCTAACTATGGCTACACCTTCGGTTCG	CASSVDAANYGYTF	1
ATCAATTCCCTGGAGCTTGGTGACTCTGCTGTGTATTTCTGTGCCAGCAGCCAGACTAGCCCCCCCTACGAGCAGTACTTCGGGCCG	CASSQTSPPYEQYF	1
CGGTCCACAAAGCTGGAGGACTCAGCCATGTACTTCTGTGCCAGCACCCTCACTAGCGGGGGAACAGATACGCAGTATTTTGGCCCA	CASTLTSGGTDTQYF	1
AATGTGAACGCCTTGGAGCTGGACGACTCGGCCCTGTATCTCTGTGCCAGCAGCACACAGGGGGCTGAGGAGCAGTTCTTCGGGCCA	CASSTQGAEEQFF	1
CAGCGCACAGAGCAGGGGGACTCGGCCATGTATCTCTGTGCCAGCAGAACTAGCGGGGGGGCCTTGGAGACCCAGTACTTCGGGCCA	CASRTSGGALETQYF	1
AGAGCAGGGGGACTCGGCCATGTATCTCTGTGCCAGCAGCTTGGGGGTTGGTGCCGGTCTCACAAAGATACGCAGTATTTTGGCCCA		1
CCTCCCAGACATCTGTGTACTTCTGTGCCAGCAGTTACAAGATCCGGGACAGGGGAGCAAAGCTCCTACGAGCAGTACTTCGGGCCG		1
TCAGTGACTCTGGCTTCTATCTCTGTGCCTGGAGTGCGCGGGGGTCCACGGCGGGTAAGGTCCTACAATGAGCAGTTCTTCGGGCCA		1
CAGCAGGTAGTGCGAGGAGATTCGGCAGCTTATTTCTGTGCCAGCTCACCACCGGCAGGGGCGAATTCACCCCTCCACTTTGGGAAC	CASSPPAGANSPLHF	3
ATCCAGCAGGTAGTGCGAGGAGATTCGGCAGCTTATTTCTGTGCCAGCTCACCAACAGGAAGAGGGACTGAAGCTTTCTTTGGACAA	CASSPTGRGTEAFF	1
CGCTCACCAGGTCTGGGGGACGCAGCCATGTACCTGTGTGCCACCAGCAGACAGTACTATAGCAATCAGCCCCAGCATTTTGGTGAT	CATSRQYYSNQPQHF	1
AGCACCTTGGAGCTGGGGGACTCGGCCCTTTATCTTTGCGCCAGCAGCGGCGGGGGGGCCGACACCGGGGAGCTGTTTTTTGGAGAA	CASSGGGADTGELFF	1
AAGATCCAGCGCACAGAGCGGGGGGACTCAGCCGTGTATCTCTGTGCCAGCAGCTTTTCAAAAAACACTGAAGCTTTCTTTGGACAA	CASSFSKNTEAFF	1
TGGAGCTGGGGGACTCGGCCCTTTATCTTTGCGCCAGCAGCAAATCTTGACTAGCGGGGGGCAGAGGATACGCAGTATTTTGGCCCA		2
ATCAATTCCCTGGAGCTTGGTGACTCTGCTGTGTATTTCTGTGCCAGCAGCCAAGTGGCAGGAAACTATGGCTACACCTTCGGTTCG	CASSQVAGNYGYTF	2
ACCCTGGAGTCTGCCAGGCCCTCACATACCTCTCAGTACCTCTGTGCCAGCAGTGAATATTGGCAGTACGAGCAGTACTTCGGGCCG	CASSEYWQYEQYF	2
CGCCTTGGAGCTGGAGGACTCGGCCCTGTATCTCTGTGCCAGCAGCTTGGTCGGGGGGGACGGGGCAATGAGCAGTTCTTCGGGCCA		1
CTGTACCCTCTCAGACATCTGTGTACTTCTGTGCCAGCACCAATTTGGACAGGACCTAGGCTAAAAGAGACCCAGTACTTCGGGCCA		1
AGCTGGGGGACTCAGCTTTGTATTTCTGTGCCAGCAGCACACGACTAGCGGGGGGGATCGAACACCGGGGAGCTGTTTTTTGGAGAA		6
AGTCCGCTACCAGCTCCCAGACATCTGTGTACTTCTGTGCCATCAGTGAGGATTCGGGCGGGAGGCTACGAGCAGTACTTCGGGCCG		1
TCTTCACATCAATTCCCTGGAGCTTGGTGACTCTGCTGTGTATTTCTGTGCCAGCAGCTTAGCGGGAATGAGCAGTTCTTCGGGCCA		1
TGTACTTCTGTGCCAGCAGTCCCCCGGGAAGATTGTGTTTTTACCCTGTATAGGACTAGCGGAACCTACGAGCAGTACTTCGGGCCG		1
AAGATCCAGCCCTCAGAACCCAGGGACTCAGCTGTGTACTTCTGTGCCAGCAGTTTAAGAGGGGACACTGAAGCTTTCTTTGGACAA	CASSLRGDTEAFF	1
AGCTCTCTGGAGCTGGGGGACTCAGCTTTGTATTTCTGTGCCAGCAGCGTAGGTGGTCAGGGGGCAAATGAGCAGTTCTTCGGGCCA	CASSVGGQGANEQFF	1
AAGATCCAGCCTGCAAAGCTTGAGGACTCGGCCGTGTATCTCTGTGCCAGCAGCGCCGGATTTAACTATGGCTACACCTTCGGTTCG	CASSAGFNYGYTF	1
GTGAGCAACATGAGCCCTGAAGACAGCAGCATATATCTCTGCAGCGTCCCCCGGACGGAGAACACCGGGGAGCTGTTTTTTGGAGAA	CSVPRTENTGELFF	1
GGAGTTGGCTGCTCCCTCCCAGACATCTGTGTACTTCTGTGCCAGCAGGACACCGGGACAGGGGGTGAAAAACTGTTTTTTGGCAGT		5
AAGATCCAGCCTGCAAAGCTTGAGGACTCGGCCGTGTATCTCTGTGCCAGCACCGGACAGGGGGCGGGTGAGCAGTACTTCGGGCCG	CASTGQGAGEQYF	1
CAGCAGGTAGTGCGAGGAGATTCGGCAGCTTATTTCTGTGCCAGCTCACCACCGACTAGCGTCTCCTACGAGCAGTACTTCGGGCCG	CASSPPTSVSYEQYF	1
GCTACCAGCTCCCAGACATCTGTGTACTTCTGTGCCATCAGTGACCCCCAGTCAGAGGGTATGACAGATACGCAGTATTTTGGCCCA	CAISDPQSEGMTDTQYF	1
GAGCTGGGGGACTCGGCCCTTTATCTTTGCGCCAGCAGCTTGGTTGACTAGCGGGAGTACTCCTACAATGAGCAGTTCTTCGGGCCA	CASSLVD*REYSYNEQFF	3
CTTGGAGCTGGACGACTCGGCCCTGTATCTCTGTGCCAGCAGCCCGGATTTCCGGGACTTCCTTGCCCTGAAGCTTTCTTTGGACAA		1
AAGCTGGAGGACTCAGCCATGTACTTCTGTGCCAGCAGTTGGGAGGGGGCAGGGGAGGCTGGGGCCAACGTCCTGACTTTCGGGGCC	CASSWEGAGEAGANVLTF	1
TTGGAGCTGGGGGACTCGGCCCTTTATCTTTGCGCCAGCAGCTTACTGACTAGCGGGAGTTTCTCAGATACGCAGTATTTTGGCCCA	CASSLLTSGSFSDTQYF	4
CTCACTGTGACATCGGCCCAAAAGAACCCGACAGCTTTCTATCTCTGTGCCAGTAGTATGGCTAACTATGGCTACACCTTCGGTTCG	CASSMANYGYTF	1
CTGTCCCTAGAGTCTGCCATCCCCAACCAGACAGCTCTTTACTTCTGTGCCATTTAGCGGGAGCACTACGAGCAGTACTTCGGGCCG	CAI*REHYEQYF	1
TCTAAGAAGCTCCTTCTCAGTGACTCTGGCTTCTATCTCTGTGCCTGGAGGAAGGGGACAGGGGGAGAAAAACTGTTTTTTGGCAGT	CAWRKGTGGEKLFF	1
TGTGACATCGGCCCAAAAGAACCCGACAGCTTTCTATCTCTGTGCCAGTAGCGGCGGGGGTCCTTCTATGGCTACACCTTCGGTTCG		3
CTGCTGTCGGCTGCTCCCTCCCAGACATCTGTGTACTTCTGTGCCAGCAGACTGACAGGAGGTCGAATCGAGCAGTACTTCGGGCCG	CASRLTGGRIEQYF	1
GTGAACGCCTTGTTGCTGGGGGACTCGGCCCTGTATCTCTGTGCCAGCAGTGAGATAACTCTGAACACTGAAGCTTTCTTTGGACAA	CASSEITLNTEAFF	1
CCCTCAGAACCCAGGGACTCAGCTGTGTACTTCTGTGCCAGCATCTGGGGGGAACTGAGCTCCTACAATGAGCAGTTCTTCGGGCCA	CASIWGELSSYNEQFF	1
CTGGAGCTGGGGGACTCAGCTTTGTATTTCTGTGCCAGCAGCTTCTCGTGGACTAGCGGGAGTATAGATACGCAGTATTTTGGCCCA	CASSFSWTSGSIDTQYF	1
CGTTGGCGTCTGCTGTACCCTCTCAGACATCTGTGTACTTCTGTGCCAGCAGTGACTTGCCAGGGAAACACCATATATTTTGGAGAG		1
CTGAAGATCCGGTCCACAAAGCTGGAGGACTCAGCCATGTACTTCTGTGCCAGCACCCGGATTAAAGAGACCCAGTACTTCGGGCCA	CASTRIKETQYF	1
TGTCCTCAGAACCGGGAGACACGGCACTGTATCTCTGCGCCAGCAGTCAATCTAGGGGAAGGTAATTCACCCCTCCACTTTGGGAAC		1
ATCCGGTCCACAAAGCTGGAGGACTCAGCCATGTACTTCTGTGCCAGCAGAGGCGGGGGGGCGGCAGATACGCAGTATTTTGGCCCA	CASRGGGAADTQYF	1
ATCCAGCCTGCAAAGCTTGAGGACTCGGCCGTGTATCTCTGTGCCAGCAGCCGGCACCCCAGCACAGATACGCAGTATTTTGGCCCA	CASSRHPSTDTQYF	1
TCGGCCCAAAAGAACCCGACAGCTTTCTATCTCTGTGCCAGTAGTATCAGATCGGGAGGCTCTAATGAAAAACTGTTTTTTGGCAGT	CASSIRSGGSNEKLFF	1
AGGCTGGAGTTGGCTGCTCCCTCCCAGACATCTGTGTACTTCTGTGCCAGCACTTGGGACAGGGCCGCCGGCTACACCTTCGGTTCG	CASTWDRAAGYTF	1
CTGCTCCCTCCCAAACATCTGTGTACTTCTGTGCCAGCAGTTACTCGACTTGAGGGGCTTCCGAGCTACGAGCAGTACTTCGGGCCG		1
AATTCCCTGGAGCTTGGTGACTCTGCTGTGTATTTCTGTGCCAGCAGCCCACTAAATTATCTGACCGGGGAGCTGTTTTTTGGAGAA	CASSPLNYLTGELFF	1
CTGGAGCTTGGTGACTCTGCTGTGTATTTCTGTGCCAGCAGCCCTGGACTAGCGGGAAATCGCACAGATACGCAGTATTTTGGCCCA	CASSPGLAGNRTDTQYF	1
AAGATCCAGCCCTCAGAACCCAGGGACTCAGCTGTGTACTTCTGTGCCAGCAGTTTTCAAATCTACAATGAGCAGTTCTTCGGGCCA	CASSFQIYNEQFF	5
ATCCAGCCCTCAGAACCCAGGGACTCAGCTGTGTACTTCTGTGCCAGCAGTCCACCGGGACTAGCTGACATTCAGTACTTCGGCGCC	CASSPPGLADIQYF	1
CTGTCGGCTGCTCCCTCCCAGACATCTGTGTACTTCTGTGCCAGCAGTTACGGCTACGGCAGCTCCTACGAGCAGTACTTCGGGCCG	CASSYGYGSSYEQYF	1
CTGGAGTCCGCTACCAGCTCCCAGACATCTGTGTACTTCTGTGCCATCACCGAGGGGGAGAATAACTATGGCTACACCTTCGGTTCG	CAITEGENNYGYTF	2
GAGTCTGCCAGGCCCTCACATACCTCTCAGTACCTCTGTGCCAGCAAATTCGGGGACAGGGAAAGTGCTGAAGCTTTCTTTGGACAA	CASKFGDRESAEAFF	3
GTGAGCACCTTGGAGCTGGGGGACTCGGCCCTTTATCTTTGCGCCGGCAGCTTGTCAGGTGGCGACTATGGCTACACCTTCGGTTCG	CAGSLSGGDYGYTF	1
ACAGAGCGGGGGGACTCAGCCGTGTATCTCTGTGCCAGCAGCAGGTCAGGACAGGGGCCCTCCACCGGGGAGCTGTTTTTTGGAGAA	CASSRSGQGPSTGELFF	1
CTGAAGGTGCAGCCTGCAGAACTGGAGGATTCTGGAGTTTATTTCTGTGCCAGCAGCCAGATCGGGACCGAGCAGTTCTTCGGGCCA	CASSQIGTEQFF	1
CAGTCTGCAAAGCTTGAGGACTCGGCCGTGTATCTCTGTGCCAGCAGGTTGCGGGGTCGGGGCGCCGGGGAGCTGTTTTTTGGAGAA	CASRLRGRGAGELFF	1
ATCCAGCAGGTAGTGCGAGGAGATTCGGCAGCTTATTTCTGTGCCAGCTCACCGCAGGGGGCTTCGGGAGAGCAGTACTTCGGGCCG	CASSPQGASGEQYF	1
CCCTCAGAACCCAGGGACTCAGCTGTGTACTTCTGTGCCAGCAGTTTCCCCAGGTTTCTTAACACCGGGGAGCTGTTTTTTGGAGAA	CASSFPRFLNTGELFF	1
TGAATGTGAACGCCTTGGAGCTGGACGACTCGGCCCTGTATCTCTGTGCCAGCAGCCGCTAGATCCTACGAGCAGTACTTCGGGCCG		1
CAGCGCACAGAGCAGCGGGACTCGGCCATGTATCGCTGTGCCAGCAGCTCGGGGAGGGACAGCCGGAGGACCCAGTACTTCGGGCCA	CASSSGRDSRRTQYF	1
CACCTTGGAGCTGGGGGACTCGGCCCTTTATCTTTGCGCCAGCAGACTGGGACAGGGGGCCCATACAATGAGCAGTTCTTCGGGCCA		1
GCCTTGGAGCTGGGGGACTCGGCCCTGTATCTCTGTGCCAGAAGCTTGGTCATTAATGAGGGGGCACAGCCCCAGCATTTTGGTGAT	CARSLVINEGAQPQHF	2
TCCGCTACCAGCTCCCAGACATCTGTGTACTTCTGTGCCATCAGTGACCCTTCGGACATACTCTCCTACGAGCAGTACTTCGGGCCA	CAISDPSDILSYEQYF	1
ATTCAGCGCACAGAGCAGCGGGACTCAGCCATGTATCGCTGTGCTAGCAGCTTAGGGCGGGGCTACAATGAGCAGTTCTTCGGGCCA	CASSLGRGYNEQFF	1
GTGAGCAACATGAGCCCTGAAGACAGCAGCATATATCTCTGCAGCGTTGGTGGCGGGATCTCCTACAATGAGCAGTTCTTCGGGCCA	CSVGGGISYNEQFF	1
GCCTTGGAGCTGGAGGACTCGGCCCTGTATCTCTGTGCCAGCAGCCCTTGGGACAGGGGGAGCAATCAGCCCCAGCATTTTGGTGAT	CASSPWDRGSNQPQHF	2
TCGGCCATGTATCTCTGTGCCAGCAGCTTCACAAGACAGGGCCGGGACTAGCGCGAACCCAGCTCCTACGAGCAGTACTTCGGGCCG	CASSFTRQGRD*REPSSYEQYF	1
ACCCTGCAGCCAGAAGACTCGGCCCTGTATCTCTGTGCCAGCAGCCAACTTGGTACGGCACACATCTACGAGCAGTACTTCGGGCCG	CASSQLGTAHIYEQYF	3
ACCTTGGAGCTGGGGGACTCGGCCCTTTATCTTTGCGCCAGCAGCCAGGGACAGTCGTCGAACACCGGGGAGCTGTTTTTTGGAGAA	CASSQGQSSNTGELFF	1
CTGGAGCTGGGGGACTCAGCTTTGTATTTCTGTGCCAGCAGCGCAGAGTACACGGGACACCCTTACAATGAGCAGTTCTTCGGGCCA	CASSAEYTGHPYNEQFF	1
AGCACCAACCAGACATCTATGTACCTCTGTGCCAGCAGTTTATCGGGCGGAGTTGGGACGGGGGTCCACGAGCAGTACTTCGGGCCG	CASSLSGGVGTGVHEQYF	1
AGCAGGTAGTGCGAGGAGATTCGGCAGCTTATTTCTGTGCCAGCTCCGCCTACAGGGTTCATGAATTCACCCCTCCACTTTGGGAAC		1
CGCACAGAGCAGGGGGACTCGGCCATGTATCTCTGTGCCAGCAGCCCAAGCGGGACTAGCGGTTACAATGAGCAGTTCTTCGGGCCA	CASSPSGTSGYNEQFF	3
AGGCTGGAGTTGGCTGCTCCCTCCCAGACATCTGTGTACTTCTGTGCCAGCAGTTACGGGGACAGGGGGCAACAGTTCTTCGGGCCG	CASSYGDRGQQFF	1
AATCTTCACATCAATTCCCTGGAGCTTGGTGACTCTGCTGTGTATTTCTGTGCCAGCGGTACGACCTACGAGCAGTACTTCGGGCCG	CASGTTYEQYF	1
CAGCCAGAAGACTCGGCCCTGTATCTCTGTGCCAGCAGCCAACTCCCCCGGACTAGCGGGACCCTAGGTACGCAGTATTTTGGCCCA	CASSQLPRTSGTLGTQYF	1
GTGACCAGTGCCCATCCTGAAGACAGCAGCTTCTACATCTGCAGTGCTAGTTCCGGGGGCGGGGTGGAGACCCAGTACTTCGGGCCA	CSASSGGGVETQYF	1
TCAGGCTGGAGTTGGCTGCTCCCTCCCAGACATCTGTGTACTTCTGTGCCAGCAGTTACTAGGATCACTGAAGCTTTCTTTGGACAA		1
CAGCGCACACAGCAGGAGGACTCGGCCGTGTATCTCTGTGCCAGCAGCTTACTAGCGGGAGCGGGATACGAGCAGTACTTCGGGCCG	CASSLLAGAGYEQYF	1
AGCTTCTACATCTGCAGTGCTCGCGACAGGTAGAGGGTCGGGACTAGTCAAGACCGAGAGAACGCCGGGGAGCTGTTTTTTGGAGAA	CSARDR*RVGTSQDRENAGELFF	1
GAGTCGGCTGCTCCCTCCCAGACATCTGTGTACTTCTGTGCCAGCTATCGAGGGGGCCTTAGGACAGATACGCAGTATTTTGGCCCA	CASYRGGLRTDTQYF	1
GCTGCTCCCTCCCAGACATCTGTGTACTTCTGTGCCAGCAGTCCACCCAACAACAGGGGGGGATACAATGAGCAGTTCTTCGGGCCA	CASSPPNNRGGYNEQFF	2
GTGAGCACCTTGGAGCTGGGGGACTCGGCCCTTTATCTTTGCGCCAGCAGGTCTAGCGAATCCAAAAACATTCAGTACTTCGGCGCC	CASRSSESKNIQYF	2
CAGCAGGTAGTGCGAGGAGATTCGGCAGCTTATTTCTGTGCCAGCTCACCAGGGACTAGCGTAGCCGGGGAGCTGTTTTTTGGAGAA	CASSPGTSVAGELFF	1
CTGGAGTCCGCTACCAGCTCCCAGACATCTGTGTACTTCTGTGCCATCACCCGGACAGGGTCGAACACTGAAGCTTTCTTTGGACAA	CAITRTGSNTEAFF	1
CTGAGCTCTCTGGAGCTGGGGGACTCAGCTTTGTATTTCTGTGCCAGCAGCCTACGAGCCCGGACCGGGGAGCTGTTTTTTGGAGAA	CASSLRARTGELFF	1
CTGGAGTCTGCCAGGCCCTCACATACCTCTCAGTACCTCTGTGCCAGCAGTGAATATGTCGGGACAGATACGCAGTATTTTGGCCCA	CASSEYVGTDTQYF	1
CTGGAGCTTGGTGACTCTGCTGTGTATTTCTGTGCCAGCAGCGTCTCGAGCCATTTACACGCACGAAACACCATATATTTTGGAGAG	CASSVSSHLHARNTIYF	1
GCACAGAGCAGGGGGACTCGGCCATGTATCTCTGTGCCAGCAGCTTAAATCGCTAGCGGGAGTGGAGATACGCAGTATTTTGGCCCA		1
CCCTGCAGCCAGAAGACTCAGCCCTGTATCTCTGCGCCAGCAGCCAAGGAAGTGACAGGGCTTCAAGAGACCCAGTACTTCGGGCCA		1
ACTCTGGAGTCCGCTACCAGCTCCCAGACATCTGTGTACTTCTGTGCCATCAGTGACCCTTCCTTCACTGAAGCTTTCTTTGGACAA	CAISDPSFTEAFF	1
CAGCAGGTAGTGCGAGGAGATTCGGCAGCTTATTTCTGTGCCAGCTCACTCGGAGGGACAGGGACCACTGAAGCTTTCTTTGGACAA	CASSLGGTGTTEAFF	2
GTGAACGCCTTGTTGCTGGGGGACTCGGCCCTCTATCTCTGTGCCAGCAGCTCTACAGGGCGAGAGGGTGGCTACACCTTCGGTTCG	CASSSTGREGGYTF	1
AGCAGGTAGTGCGAGGAGATTCGGCAGCTTATTTCTGTGCCAGCTCACCACTTGGGGGAGAGCAATCAGCCCCAGCATTTTGGTGAT		1
CGCACAGAGCGGGGGGACTCAGCCGTGTATCTCTGTGCCAGCAGTAGACAGGGGACGGGGAGAGACACTGAAGCTTTCTTTGGACAA	CASSRQGTGRDTEAFF	1
AAGCTGGAGGACTCAGCCATGTACTTCTGTGCCAGCAGTGAATTTGGGGCAGGGGGCGGTTTAAAGGATGGCTACACCTTCGGTTCG	CASSEFGAGGGLKDGYTF	1
CGCACACAGCAGGAGGACTCGGCCGTGTATCTCTGTGCCAGCAGCTTAACTAGCGGGGGGACCCCCTACGAGCAGTACTTCGGGCCG	CASSLTSGGTPYEQYF	2
TAGAGTCTGCCATCCCCAACCAGACAGCTCTTTACTTCTGTGCCACCGAGAGAGGGGGAGAGCAATCAGCCCCAGCATTTTGGTGAT		1
CGGTCCACAAAGCTGGAGGACTCAGCCATGTACTTCTGTGCCAGCAGTTTAGCCACGACAGGGAACTATGGCTACACCTTCGGTTCG	CASSLATTGNYGYTF	1
CAGCCCTCAGAACCCAGGGACTCAGCTGTGTATTTTTGTGCTAGTGGTCCCCCTCGGACTATGAACACTGAAGCTTTCTTTGGACAA	CASGPPRTMNTEAFF	3
CCTCTCACTGTGACATCGGCCCAAAAGAACCCGACAGCTTTCTATCTCTGTGCCAGTAGTACCTCCTCGACGGGGTTCTTCGGGCCA	CASSTSSTGFF	1
CTGATCCTGGAGTCGCCCAGCCCCAACCAGACCTCTCTGTACTTCTGTGCCAGCAGTTTAATCCCTTCACCCCTCCACTTTGGGAAC	CASSLIPSPLHF	2
GGAGCTGGGGGACTCGGCCCTTTATCTTTGCGCCACCCCCTGACAGGGGACGGATCGGAGTCTGGAAACACCATATATTTTGGAGAG		3
GAGTCGGCTGCTCCCTCCCAGACATCTGTGTACTTCTGTGCCAGCAGCAGGGGGGGTTCCAAACCAGAGACCCAGTACTTCGGGCCA	CASSRGGSKPETQYF	1
GTGAGCACCTTGGAGCTGGGGGACTCGGCCCTTTATCTTTGCGCCAGCAGAGCAGACAGGTCCTACACTGAAGCTTTCTTTGGACAA	CASRADRSYTEAFF	2
CACGCCCTGCAGCCAGAAGACTCAGCCCTGTATCTCTGCGCCAGCAGCCGCAATCCGGGACAGACCTACGAGCAGTACTTCGGGCCG	CASSRNPGQTYEQYF	1
AATGTGAGCACCTTGGAGCTGGGGGACTCGGCCCTTTATCTTTGCGCCAGCAGCTTGGGAGTGAATTACGAGCAGTACTTCGGGCCG	CASSLGVNYEQYF	1
AGAGCGGGGGGACTCAGCCGTGTATCTCTGTGCCAGCAGGTTAAGCGATGGCTAGCAGGGGGCGCAGATACGCAGTATTTTGGCCCA		1
GAGCAGGGGGACTCGGCCATGTATCTCTGTGCCAGCAGCTTCCCCCGGGACAGGGGGGGCCTGGCCAACGTCCTGACTTTCGGGGCC	CASSFPRDRGGLANVLTF	1
CTGCAGAGCAGGGGGACTCGGCCGTGTATGTCTGTGCAAGTCGCCTTCGTCACTAGCGGGGACTCCTACGAGCAGTACTTCGGGCCG		1
CACATCAATTCCCTGGAGCTTGGTGACTCTGCTGTGTATTTCTGTGCCAGCAGCCAAGAGGGGGGCCATGGCTACACCTTCGGTTCG	CASSQEGGHGYTF	2
CTCAGGCTGGAGTCGGCTGCTCCCTCCCAGACATCTGTGTACTTCTGTGCCAGCAGTGAAATGGGGGCAGGGGCTTTCTTTGGACAA	CASSEMGAGAFF	1
GATTTCCCGCTCAGGCTGCTGTCGGCTGCTCCCTCCCAGACATCTGTGTACTTCTGTGCCAGCGGGTCCCCCCAGCATTTTGGTGAT	CASGSPQHF	1
TGGAGCTGGGGGACTCGGCCCTTTATCTTTGCGCCAGCAGCACCCGGGACTGAATGTTATAGCAATCAGCCCCAGCATTTTGGTGAT		1
CTGGGGTTGGAGTCGGCTGCTCCCTCCCAAACATCTGTGTACTTCTGTGCCAGCAGCCCGAGTAGCTACGAGCAGTACTTCGGGCCG	CASSPSSYEQYF	1
GAGTCCGCCAGCACCAACCAGACATCTATGTACCTCTGTGCCACCGCTAATCCCGACAGGGGAGATCAGCCCCAGCATTTTGGTGAT	CATANPDRGDQPQHF	1
GTGACATCGGCCCAAAAGAACCCGACAGCTTTCTATCTCTGTGCCAGTAGTATAGATAGAGAGAGGGTAAGAACTTTCTTTGGACAA	CASSIDRERVRTFF	1
AAGATCCAGCGCACACAGCAGGAGGACTCCGCCGTGTATCTCTGTGCCAGCAGCTTAGTCGCGGGTTATGGCTACACCTTCGGTTCG	CASSLVAGYGYTF	1
ACAGTGACCAGTGCCCATCCTGAAGACAGCAGCTTCTACATCTGCAGTGCTAGCGGCGGGACCACCTACGAGCAGTACTTCGGGCCG	CSASGGTTYEQYF	1
CTCAGGCTGCTGTCGGCTGCTCCCTCCCAGACATCTGTGTACTTCTGTGCCAGCCGTTCGGGGGGGACCGAGCAGTACTTCGGGCCG	CASRSGGTEQYF	1
CCAGCCTGCAGAGCTTGGGGACTCGGCCGTGTATCTCTGTGCCAGCAGCTCCCAGACCAAACAGGGGAAGAGCAGTACTTCGGGCCG		7
ACCTTGGAGCTGGGGGACTCGGCCCTTTATCTTTGCGCCAGCAGCTTGGGGCAGGCCTCTAGCACAGATACGCAGTATTTTGGCCCA	CASSLGQASSTDTQYF	1
CCCTAGAGTCTGCCATCCCCAACCAGACAGCTCTTTACTTCTGTGCCACCAAATACTATCGGCACAGATACGCAGTATTTTGGCCCA		1
CAGCGCACAGAGCGGGGGGACTCAGCCGTGTATCTCTGTGCCAGCAGCTTAACGTCCGGGACTAACAATGAGCAGTTCTTCGGGCCA	CASSLTSGTNNEQFF	1
CTGGAGTCGCCCAGCCCCAACCAGACCTCTCTGTACTTCTGTGCCAGCAGTTTATCACCCAGGGGGCTTGGCTACACCTTCGGTTCG	CASSLSPRGLGYTF	1
AACATGAGCTCCTTGGAGCTGGGGGACTCAGCCCTGTACTTCTGTGCCAGCAGCTTAGGAGGGATCTACGAGCAGTACTTCGGGCCA	CASSLGGIYEQYF	1
CTCACTCTGGAGTCCGCTACCAGCTCCCAGACATCTGTGTACTTCTGTGCCATCAGTGAAGAGGAGAGCACCATATATTTTGGAGAG	CAISEEESTIYF	2
CCAGAAGACTCAGCCCTGTATCTCTGCGCCAGCAGCCTCCAACCCGGGACTAGCGGGGTCTCCTACAATGAGCAGTTCTTCGGGCCA	CASSLQPGTSGVSYNEQFF	1
GTGACCAGTGCCCATCCTGAAGACAGCAGCTTCTACATCTGCAGTGCTAGAGAGGCCCAGGGAGCACAGCCCCAGCATTTTGGTGAT	CSAREAQGAQPQHF	1
CAGCCCTCAGAACCCAGGGACTCAGCTGTGTACTTCTGTGCCAGCAGTGCAAGCGTGGACGGCACAGATACGCAGTATTTTGGCCCA	CASSASVDGTDTQYF	1
TCCACAAAGCTGGAGGACTCAGCCATGTACTTCTGTGCCAGCAGTGTAGGGACTAGCGGGGGCACAGATACGCAGTATTTTGGCCCA	CASSVGTSGGTDTQYF	1
TCTGCCATCCCCAACCAGACAGCTCTTTACTTCTGTGCCACCAGTGCGGCTAGCGGGTCGAACACCGGGGAGCTGTTTTTTGGAGAA	CATSAASGSNTGELFF	1
GTGAACGCCTTGTTGCTGGGGGACTCGGCCCTCTATCTCTGTGCCAGCAGCCAACCGGGACCTGGAAACACCATATATTTTGGAGAG	CASSQPGPGNTIYF	1
GAGTCGCCCAGCCCCAACCAGACCTCTCTGTACTTCTGTGCCAGCAGTTTATATCCGACAGAGTTCGGAGGCTACACCTTCGGTTCG	CASSLYPTEFGGYTF	1
CACACCCTGCAGCCAGAAGACTCGGCCCTGTATCTCTGTGCCAGCAGCCAAGTGCAGGGGAGGGGAGAGACCCAGTACTTCGGGCCA	CASSQVQGRGETQYF	1
AGCACCAACCAGACATCTATGTACCTCTGTGCCAGCAGTTTAGAGGGGTCTCCGGCTCAGGGTGCCGGGGAGCTGTTTTTTGGAGAA	CASSLEGSPAQGAGELFF	1
TTGGAGCTGGGGGACTCGGCCCTTTATCTTTGCGCCAGCAGCTTGGCGGGCCGGGGTGGGATGAACACTGAAGCTTTCTTTGGACAA	CASSLAGRGGMNTEAFF	2
AAGATCCAGCCTGCAAAGCTTGAGGACTCGGCCGTGTATCTCTGTGCCAGCAGCTTAGCAGGGAACTATGGCTACACCTTCGGTTCG	CASSLAGNYGYTF	1
GAGTCGCCCAGCCCCAACCAGACCTCTCTGTACTTCTGTGCCAGCAGTTTAAACCGGGCCGCTGGCAGGGAGCTGCTTTTTGGAGAA	CASSLNRAAGRELLF	1
GTAGTGCGAGGAGATTCGGCAGCTTATTTCTGTGCCAGCTCACCTCGAGGCGGACAGGGGATCGGGGAGACCCAGTACTTCGGGCCA	CASSPRGGQGIGETQYF	2
CACATCAATTCCCTGGAGCTTGGTGACTCTGCTGTGTATTTCTGTGCCAGCAGCCACGGGCGGGAGGGGACCCAGTACTTCGGGCCA	CASSHGREGTQYF	1
CAGCGCACACAGCAGGAGGACTCGGCCGTGTATCTCTGTGCCAGCAGCTTAGCGGGGAGGGACCATTCACCCCTCCACTTTGGGAAC	CASSLAGRDHSPLHF	1
AGCAGGTAGTGCGAGGAGATTCGGCAGCTTATTTCTGTGCCAGCTCCGCCCTATTAAGAGAGGGGCAATGAGCAGTTCTTCGGGCCA		2
ATCCAGCGCACACAGCAGGAGGACTCGGCCGTGTATCTCTGTGCCAGCAGCTTATCTTTAGGGTTCCACGAGCAGTACTTCGGGCCG	CASSLSLGFHEQYF	1
ACAGTGACCAGTGCCCATCCTGAAGACAGCAGCTTCTACATCTGCAGTGCTAGAGATTTCCAGGTCTACGAGCAGTACTTCGGGCCG	CSARDFQVYEQYF	1
ACAGTGACCAGTGCCCATCCTGAAGACAGCAGCTTCTACATCTGCAGTGCTAGAGACCCCCGGGGCTTCGGCTACACCTTCGGTTCG	CSARDPRGFGYTF	1
CAGAGCTTGGGGACTCGGCCGTGTATCTCTGTGCCAGCAGATACACCCTCCTAGCGGGAGACCACAGATACGCAGTATTTTGGCCCA		1
AGTTCTAAGAAGCTCCTTCTCAGTGACTCTGGCTTCTATCTCTGTGCCTGGCAGGGGAACTCTGGAAACACCATATATTTTGGAGAG	CAWQGNSGNTIYF	1
CTGACTGTGAGCAACATGAGCCCTGAAGACAGCAGCATATATCTCTGCAGCGCAGGGGAGCGGGGTGAAAAACTGTTTTTTGGCAGT	CSAGERGEKLFF	1
GTCAGGGGACACAGCACTGTATTTCTGTGCCAGCAGCAAAAACCCCCTGAACAACACCCATCCACCTATGGCTACACCTTCGGTTCG		3
TGAAGATCCGGTCCACAAAGCTGGAGGACTCAGCCATGTACTTCTGTGCCACCAAGAGGGGTTTGCACTGAAGCTTTCTTTGGACAA		1
AAGATCCAGCCCTCAGAACCCAGGGACTCAGCTGTGTACTTCTGTGCCAGCAATCAGGTTTCCTACAATGAGCAGTTCTTCGGGCCA	CASNQVSYNEQFF	1
GCCCTGCAGCCAGAAGACTCAGCCCTGTATCTCTGCGCCAGCAGCCAAGGGACTAACGTAGGGCACTATGGCTACACCTTCGGTTCG	CASSQGTNVGHYGYTF	1
CCAGAAGACTCGGCCCTGTATCTCTGTGCCAGCAGCCAAGCCGGGACTAGCGGGAGGTACGCCTACAATGAGCAGTTCTTCGGGCCA	CASSQAGTSGRYAYNEQFF	3
GCTCCCAGACATCTGTGTACTTCTGTGCCATCAGTGCCAGACTGGGGCCGGTGGGGCACTTAAAGAGAGACCCAGTACTTCGGGCCA		1
CAGCGCACACAGCAGGAGGACTCCGCCGTGTATCTCTGTGCCAGCAGCCCCCGCAGCTACTCTGGAAACACCATATATTTTGGAGAG	CASSPRSYSGNTIYF	2
GTGAGCACCTTGGAGCTGGGGGACTCGGCCCTTTATCTTTGCGCCAGCAGCCTGGGACCAACTAATGAAAAACTGTTTTTTGGCAGT	CASSLGPTNEKLFF	1
ATCGGCCCAAAAGAACCCGACAGCTTTCTATCTCTGTGCCACCTAGGGGACAGGGGATAACCCTCCTACGAGCAGTACTTCGGGCCG		1
ACCTTGGAGCTGGGGGACTCGGCCCTTTATCTTTGCGCCCGCGAACGTCCGGGAGAGGACTCTGGAAACACCATATATTTTGGAGAG	CARERPGEDSGNTIYF	1
ATCCAGCGCACACAGCAGGAGGACTCCGCCGTGTATCTCTGTGCCAGCAGCTTAGCAACTGCCTACAATGAGCAGTTCTTCGGGCCA	CASSLATAYNEQFF	2
ACATCGGCCCAAAAGAACCCGACAGCTTTCTATCTCTGTGCCAGTAGTGAGACAGGGCCCACGAGGAATGAGCAGTTCTTCGGGCCA	CASSETGPTRNEQFF	1
CTGGAGTCGGCTGCTCCCTCCCAGACATCTGTGTACTTCTGTGCCAGCAGTGAACTAGCGGGCACAGATACGCAGTATTTTGGCCCA	CASSELAGTDTQYF	5
GAGTCCGCTACCAGCTCCCAGACATCTGTGTACTTCTGTGCCATCAGTTTCGGGCCAGGGGGGACGGGCGAGCAGTACTTCGGGCCG	CAISFGPGGTGEQYF	1
ACCCTGGAGTCTGCCAGGCCCTCACATACCTCTCAGTACCTCTGTGCCAGCAGTCCTAACAGGGGAAACACCATATATTTTGGAGAG	CASSPNRGNTIYF	1
GTGACCAGTGCCCATCCTGAAGACAGCAGCTTCTACATCTGCAGTGCTAGGGGGAGACAGGGGGCCTATGGCTACACCTTCGGTTCG	CSARGRQGAYGYTF	2
CCTGCAAAGCTTGAGGACTCGGCCGTGTATCTCTGTGCCAGCAGCTTAGCCAGGGTCGGCTCCCTGAACACCATATATTTTGGAGAG	CASSLARVGSLNTIYF	1
GTGACCAGTGCCCATCCTGAAGACAGCAGCTTCTACATCTGCAGTGCTAGAGCGGGGGACATAGTGAAAAAACTGTTTTTTGGCAGT	CSARAGDIVKKLFF	1
CTGCTGTCGGCTGCTCCCTCCCAGACATCTGTGTACTTCTGTGCCAGCAGTCCCAGGGGATTCACAGATACGCAGTATTTTGGCCCA	CASSPRGFTDTQYF	1
CACGCCCTGCAGCCAGAAGACTCAGCCCTGTATCTCTGCGCCAGCAGCCAAGAAACAGGGGCGAATTCACCCCTCCACTTTGGGAAC	CASSQETGANSPLHF	1
ACTCTGGAGTCTGCTGCCTCCTCCCAGACATCTGTATATTTCTGCGCCAGCAGCCCTGACCTTGGGTACGAGCAGTACTTCGGGCCG	CASSPDLGYEQYF	1
ATCCAGCCCTCAGAACCCAGGGACTCAGCTGTGTACTTCTGTGCCAGCAGGAGGGGGCAGTGGGGAGAAAAACTGTTTTTTGGCAGT	CASRRGQWGEKLFF	1
CACATCAATTCCCTGGAGCTTGGTGACTCTGCTGTGTATTTCTGTGCCACCAGCGACCGTGGGAGTGAAAAACTGTTTTTTGGCAGT	CATSDRGSEKLFF	1
AGGCTGCTGTCGGCTGCTCCCTCCCAGACATCTGTGTACTTCTGTGCCAGCAGTGGACAGGGTAGTCAGCCCCAGCATTTTGGTGAT	CASSGQGSQPQHF	1
CACACCCTGCAGCCAGAAGACTCGGCCCTGTATCTCTGTGCCAGCAGCCAAGGTGCTGACGGATCCTACGAGCAGTACTTCGGGCCG	CASSQGADGSYEQYF	3
ATCCAGCGCACACAGCAGGAGGACTCGGCCGTGTATCTCTGTGCCAGCAGCTTAGCGGGGAGCTACAATGAGCAGTTCTTCGGGCCA	CASSLAGSYNEQFF	1
CAGCGCACAGAGCGGGGGGACTCAGCCGTGTATCTCTGTGCCAGCAGCTTATTCCCGGGAGGCGCCTACGAGCAGTACTTCGGGCCG	CASSLFPGGAYEQYF	1
TCTCAAGATCCAGCCTGCAGAGCTTGGGGACTCGGCCATGTATCTCTGTGCCAGCAGCCACTGGGTCTCAAAGCTTTCTTTGGACAA		1
TCCCTAGAGTCTGCCATCCCCAACCAGACAGCTCTTTACTTCTGTGCCACCGCGGGAGGGTTGAACAATGAGCAGTTCTTCGGGCCA	CATAGGLNNEQFF	1
GTGAACGCCTTGTTGCTGGGGGACTCGGCCCTCTATCTCTGTGCCAGCAGCTTGGAGCTAGATAACCCCGAGCAGTTCTTCGGGCCA	CASSLELDNPEQFF	1
ATCCAGCGCACAGAGCAGGGGGACTCGGCCATGTATCTCTGTGCCAGCAGCCCCGGGACAGGGACCTACGAGCAGTACTTCGGGCCG	CASSPGTGTYEQYF	1
CAGTCCACGGAGTCAGGGGACACAGCACTGTATTTCTGTGCCACCAAGTCCAGGGGGGCCATTAATGAAAAACTGTTTTTTGGCAGT	CATKSRGAINEKLFF	1
TCTCTGGAGCTGGGGGACTCAGCTTTGTATTTCTGTGCCAGCAGCGTAGCTAACAGGGGTCCTTACAATGAGCAGTTCTTCGGGCCA	CASSVANRGPYNEQFF	1
CTGGAGTCGGCTGCTCCCTCCCAGACATCTGTGTACTTCTGTGCCAGCAGGCGGGACGAAGCCAAAAACATTCAGTACTTCGGCGCC	CASRRDEAKNIQYF	1
ACGATCCAGCGCACACAGCAGGAGGACTCGGCCGTGTATCTCTGTGCCAGCAGCTTCAGTAGCAATCAGCCCCAGCATTTTGGTGAT	CASSFSSNQPQHF	2
CTACACGCCCTGCAGCCAGAAGACTCAGCCCTGTATCTCTGCGCCAGCAGCCAAGCGGACAGGGCCTACGAGCAGTACTTCGGGCCG	CASSQADRAYEQYF	1
ATGTGAACGCCTTGGAGCTGGACGACTCGGCCCTGTATCTCTGTGCCAGCAGCTTGGGACTGAGTGAGGGAGCAGTACTTCGGGCCG		1
TTGCTGGGGGACTCGGCCCTCTATCTCTGTGCCAGCAGCTTGGGGGGATGACAGGGGAGTCATTGTTCACCCCTCCACTTTGGGAAC	CASSLGG*QGSHCSPLHF	1
GTGAGCACCTTGGAGCTGGGGGACTCGGCCCTTTATCTTTGCGCCAGCAGCTTGGACAGTAAGGCGAATGGCTACACCTTCGGTTCG	CASSLDSKANGYTF	1
AGGCTGGAGTTGGCTGCTCCCTCCCAGACATCTGTGTACTTCTGTGCCAGCAGTTACCAATCAAATGAAAAACTGTTTTTTGGCAGT	CASSYQSNEKLFF	1
CTGCAGCCAGAAGACTCAGCCCTGTATCTCTGCGCCAGCAGCCAAGATCGGCACAGGGAAGACACCGGGGAGCTGTTTTTTGGAGAA	CASSQDRHREDTGELFF	3
CTGAGGATCCAGCAGGTAGTGCGAGGAGATTCGGCAGCTTATTTCTGTGCCAGCTCACCCACTGGCAATGAGCAGTTCTTCGGGCCA	CASSPTGNEQFF	1
AATGTGAACGCCTTGGAGCTGGACGACTCGGCCCTGTATCTCTGTGCCAGCAGCCGGACACTGAACAATGAGCAGTTCTTCGGGCCA	CASSRTLNNEQFF	1
CCTGCAGAGCTTGGGGACTCGGCCGTGTATCTCTGTGCCAGCAGCTCCCGGACCGGACAGGGGGCTAATGAGCAGTTCTTCGGGCCA	CASSSRTGQGANEQFF	1
AACCTGAGCTCTCTGGAGCTGGGGGACTCAGCTTTGTATTTCTGTGCCAGCAGCCCTCAACCCGCGGCTGAAGCTTTCTTTGGACAA	CASSPQPAAEAFF	1
CCCTCAGAACCCAGGGACTCAGCTGTGTACTTCTGTGCCAGCAGCCCCCCCTAGGGCCTTCTTAGCAATGAGCAGTTCTTCGGGCCA	CASSPP*GLLSNEQFF	2
ACTCTGGAGTCCGCTACCAGCTCCCAGACATCTGTGTACTTCTGTGCCATCAGTGTTGGGGGGTACAATGAGCAGTTCTTCGGGCCA	CAISVGGYNEQFF	1
ATCCAGCGCACAGAGCAGGGGGACTCGGCCATGTATCTCTGTGCCAGCAGCTCCGGGGCCGGGGAACAGCCCCAGCATTTTGGTGAT	CASSSGAGEQPQHF	1
CAGCCTGCAAAGCTTGAGGACTCGGCCGTGTATCTCTGTGCCAGCAGCTTAGGTGCGCAGACCCAAGAGACCCAGTACTTCGGGCCA	CASSLGAQTQETQYF	1
CAGCAGGTAGTGCGAGGAGATTCGGCAGCTTATTTCTGTGCCAGCTCCCTCGGGGCAGGGGGGACCTATGGCTACACCTTCGGTTCG	CASSLGAGGTYGYTF	1
GGGTTGGAGTCGGCTGCTCCCTCCCAAACATCTGTGTACTTCTGTGCCAGCAGTGCAGGGGGGTCCGGGGAGCTGTTTTTTGGAGAA	CASSAGGSGELFF	1
CTGACAGTGACCAGTGCCCATCCTGAAGACAGCAGCTTCTACATCTGCAGTGCTACCCAGGGGGGATACGAGCAGTACTTCGGGCCG	CSATQGGYEQYF	1
ACATCGGCCCAAAAGAACCCGACAGCTTTCTATCTCTGTGCCAGTAACGGAATGGGCGGGATGAACACTGAAGCTTTCTTTGGACAA	CASNGMGGMNTEAFF	3
AGGCTGCTGTCGGCTGCTCCCTCCCAGACATCTGTGTACTTCTGTGCCAGCAGTCACGAGGGCCGGATAGAAGCTTTCTTTGGACAA	CASSHEGRIEAFF	2
TTGGAGCTGGGGGACTCGGCCCTTTATCTTTGCGCCAGCAGTTCTCCGGGAGACAGCTCGAACACCGGGGAGCTGTTTTTTGGAGAA	CASSSPGDSSNTGELFF	1
ACTCTGACAGTGACCAGTGCCCATCCTGAAGACAGCAGCTTCTACATCTGCAGTGCTTGGACAGCTGATGGCTACACCTTCGGTTCG	CSAWTADGYTF	1
ACCCGCTCCCAGACATCTGTGTATTTCTGCGCCAGCAAAACAAGACAGGGAGAGGAAGGGTACCAAGAGACCCAGTACTTCGGGCCA	CASKTRQGEEGYQETQYF	2
CTGGAGTCGCCCAGCCCCAACCAGACCTCTCTGTACTTCTGTGCCAGCGGGTTGGGACAGCGATTCAATGAGCAGTTCTTCGGGCCA	CASGLGQRFNEQFF	1
ACTCTGGAGTCCGCTACCAGCTCCCAGACATCTGTGTACTTCTGTGCCATCAGTGGACAGAGCAATCAGCCCCAGCATTTTGGTGAT	CAISGQSNQPQHF	1
TTGGAGTCGGCTGCTCCCTCCCAAACATCTGTGTACTTCTGTGCCAGCATAGGACTAGCGGACTCCTACGAGCAGTACTTCGGGCCG	CASIGLADSYEQYF	2
GTTCATCCTGAGTTCTAAGAAGCTCCTTCTCAGTGACTCTGGCTTCTATCTCTGTGCCTCGGCCCGTGTGGCTACACCTTCGGTTCG		2
GAGTCGGCTGCTCCCTCCCAGACATCTGTGTACTTCTGTGCCAGCAAACTACAGGGGGCTGGTGGAAACACCATATATTTTGGAGAG	CASKLQGAGGNTIYF	1
TGTGAACGCCTTGTTGCTAGGGGACTCGGCCCTCTATCTCTGTGCCAGCAGCTGACAGTCAGCCTCTACGAGCAGTACTTCGGGCCG		1
ATCAATTCCCTGGAGCTTGGTGACTCTGCTGTGTATTTCTGTGCCAGCAGCCTTGAGGGCTCTGGAAACACCATATATTTTGGAGAG	CASSLEGSGNTIYF	1
GACAGTGACCAGTGCCCATCCTGAAGACAGCAGCTTCTACATCTGCAGTGCTAGGGGCTTGAATAGTACGAGCAGTACTTCGGGCCG		1
CAGCGCACAGAGCGGGGGGACTCAGCCGTGTATCTCTGTGCCAGCAGCTTAAGGCGGGGCCACTCCTACGAGCAGTACTTCGGGCCG	CASSLRRGHSYEQYF	1
GCCTTGTTGCTGGGGGACTCGGCCCTGTATCTCTGTGCCAGCAGCTTGGAGTACAGGGAATCCCACTATGGCTACACCTTCGGTTCG	CASSLEYRESHYGYTF	1
CTGGAGTCAGCTACCCGCTCCCAGACATCTGTGTATTTCTGCGCCAGCAGTGAGTCGCGGGGCGGAGAGACCCAGTACTTCGGGCCA	CASSESRGGETQYF	3
TCGGCTGCTCCCTCCCAGACATCTGTGTACTTCTGTGCCAGCAGTTATGGAAAGACAGGGAGAGGCACTGAAGCTTTCTTTGGACAA	CASSYGKTGRGTEAFF	1
ACCAGTGCCCATCCTGAAGACAGCAGCTTCTACATCTGCAGTGCTATTCTTCCCAGAAACTCCAATGAAAAACTGTTTTTTGGCAGT	CSAILPRNSNEKLFF	10
AACGCCTTGGAGCTGGACGACTCGGCCCTGTATCTCTGTGCCAGCAGCTCGGGGCAGCCGCGTACGGATACGCAGTATTTTGGCCCA	CASSSGQPRTDTQYF	1
ATGAATGTGAGCACCTTGGAGCTGGGGGACTCGGCCCTTTATCTTTGCGCCAGCTCCCGGGGTAAAGAGACCCAGTACTTCGGGCCA	CASSRGKETQYF	1
GTGACCAGTGCCCATCCTGAAGACAGCAGCTTCTACATCTGCAGTGCTAGTGGGGACAGGGTGAATTCACCCCTCCACTTTGGGAAC	CSASGDRVNSPLHF	1
GAGTCCGCCAGCACCAACCAGACATCTATGTACCTCTGTGCCAGCACCGAAAGACAGGGATTGAACACTGAAGCTTTCTTTGGACAA	CASTERQGLNTEAFF	1
AATGTGAACGCCTTGTTGCTGGGGGACTCGGCCCTCTATCTCTGTGCCAGCAGCTTGGGACAGCCCGGGGAGCTGTTTTTTGGAGAA	CASSLGQPGELFF	1
CTCAGGCTGGAGTTGGCTGCTCCCTCCCAGACATCTGTGTACTTCTGTGCCAGCACAGGCAGAAGCAATGAGCAGTTCTTCGGGCCA	CASTGRSNEQFF	1
GACTGTGAGCAACATGAGCCCTGAAGACAGCAGCATATATCTCTGCAGCGTTGAAGGTCAGGGGGGGCACCCCTCCACTTTGGGAAC		3
ATCCAGCGCACACAGCAGGAGGACTCGGCCGTGTATCTCTGTGCCAGCAGCCCCGGCTTGAGTGTGATTGGCTACACCTTCGGTTCG	CASSPGLSVIGYTF	1
CTGCCATCCCCAACCAGACAGCTCTTTACTCTTTAGATTTGCGGGGACAGGGTAGGTAAATCCTCCTACGAGCAGTACTTCGGGCCG		1
TCAGAACCCAGGGACTCAGCTGTGTACTTCTGTGCCAGCAGCAAACGGGACTAGCGCGATCTTCGCGATACGCAGTATTTTGGCCCA	CASSKRD*RDLRDTQYF	1
ACCAGTGCCCATCCTGAAGACAGCAGCTTCTACATCTGCAGTGCTAATCTACTAGCGACCGGGGAGGGTACGCAGTATTTTGGCCCA	CSANLLATGEGTQYF	1
CCTCAGAACCCAGGGACTCAGCTGTGTACTTCTGTGCCAGTCGGACTAGCGGGAGTTGGGTCCTACAATGAGCAGTTCTTCGGGCCA		1
ATCCAGCGCACAGAGCAGCGGGACTCGGCCATGTATCGCTGTGCCAGCAGCGGGACAGGGGCTACCCACGAGCAGTACTTCGGGCCA	CASSGTGATHEQYF	1
AGCCTGCAGAGCTTGGGGACTCGGCCATGTATCTCTGTGCCAGCAGCGCTGCTATCTGCAACTAATGAAAAACTGTTTTTTGGCAGT		1
AGGCTGCTGTCGGCTGCTCCCTCCCAGACATCTGTGTACTTCTGTGCCAGCAGGCGCATGCCGGGGGTTGAAGCTTTCTTTGGACAA	CASRRMPGVEAFF	1
ATCCAGCCTGCAAAGCTTGAGGACTCGGCCGTGTATCTCTGTGCCAGCAGCTCCGACAGGGTGACTGAAAAACTGTTTTTTGGCAGT	CASSSDRVTEKLFF	1
CAGCCCTCAGAACCCAGGGACTCAGCTGTGTACTTCTGTGCCAGCAGCCAACAGGGATCGAGTAATTCACCCCTCCACTTTGGGAAC	CASSQQGSSNSPLHF	1
GGGTTGGAGTCGGCTGCTCCCTCCCAAACATCTGTGTACTTCTGTGCCAGCAGTGGGACGAAATTCTATGGCTACACCTTCGGTTCG	CASSGTKFYGYTF	1
GCCCAAAAGAACCCGACAGCTTTCTATCTCTGTGCCAGTACCGGCCCTGAGGAGGGGGCTCACCCCTATGGCTACACCTTCGGTTCG	CASTGPEEGAHPYGYTF	2
CTGGAGTCGGCTGCTCCCTCCCAGACATCTGTGTACTTCTGTGCCAGCAGTGATAACAGGTTGTGGGAAAAACTGTTTTTTGGCAGT	CASSDNRLWEKLFF	1
ACCCTGCAGCCAGAAGACTCGGCCCTGTATCTCTGTGCCAGCAGCCAAGCCGGATGGCGAACCTCCTACGAGCAGTACTTCGGGCCG	CASSQAGWRTSYEQYF	1
GAAGATCCAGCCCTCAGAACCCAGGGACTCAGCTGTGTACTTCTGTGCCAGCAGTTTACAGTAACCTACGAGCAGTACTTCGGGCCG		2
ATCAATTCCCTGGAGCTTGGTGACTCTGCTGTGTATTTCTGTGCCAGCAGTCGACAGGGGGCTGGAAACATCATATATTTTGGAGAG	CASSRQGAGNIIYF	1
CCCAGCCCCAACCAGACCTCTCTGTACTTCTGTGCGAACCTCCCCCCCGCCGGGACAGGGGAATTCTACGAGCAGTACTTCGGGCCG	CANLPPAGTGEFYEQYF	4
CCTGCAGAACTGGAGGATTCTGGAGTTTATTTCTGTGCCAGCAGCCTTCACCCCGACGGGACGGATTATGGCTACACCTTCGGTTCG	CASSLHPDGTDYGYTF	1
CAGTCCACGGAGTCAGGGGACACAGCACTGTATTTCTGTGCCAGCAGCAAGAAGGGAACTAGCAATCAGCCCCAGCATTTTGGTGAT	CASSKKGTSNQPQHF	4
AGGAGGACTCGGCCGTGTATCTCTGTGCCAGCAGCTTTATGCCCCGGGACAGGGAAGTTGGGGGCCAACGTCCTGACTTTCGGGGCC		1
ATCCAGCGCACACAGCAGGAGGACTCGGCCGTGTATCTCTGTGCCAGCACCCCCGGTCTCTTCTTAGATACGCAGTATTTTGGCCCA	CASTPGLFLDTQYF	1
TCTGCCATCCCCAACCAGACAGCTCTTTACTTCTGTGCCACCAGTGATTCCGGGACAGGGGGTTTGGAGACCCAGTACTTCGGGCCA	CATSDSGTGGLETQYF	1
TCTAAGAAGCTCCTTCTCAGTGACTCTGGCTTCTATCTCTGTGCCTGGACTCCCGGACGAGGAGGGACTGAAGCTTTCTTTGGACAA	CAWTPGRGGTEAFF	1
GTGAACGCCTTGGAGCTGGACGACTCGGCCCTGTATCTCTGTGCCAGCTGGGACAGAGAAGGTTCCTACGAGCAGTACTTCGGGCCA	CASWDREGSYEQYF	1
AGTGCCCATCCTGAAGACAGCAGCTTCTACATCTGCAGTGCTACCTACCTAGCGGGAATTGTGGACAATGAGCAGTTCTTCGGGCCA	CSATYLAGIVDNEQFF	1
GAGTCGCCCAGCCCCAACCAGACCTCTCTGTACTTCTGTGCCAGCAGTTCCCCGGACAGGGGCAAAAACATTCAGTACTTCGGCGCC	CASSSPDRGKNIQYF	1
GTGACATCGGCCCAAAAGAACCCGACAGCTTTCTATCTCTGTGCCAGTAGTACCCAGGCCGCCCCTTCACCCCTCCACTTTGGGAAC	CASSTQAAPSPLHF	1
CTCACTCTGGAGTCAGCTACCCGCTCCCAGACATCTGTGTATTTCTGCGCCAGCAGTGAAGGGGAACAGCCCCAGCATTTTGGTGAT	CASSEGEQPQHF	1
CCGCTCAGGCTGGAGTTGGCTGCTCCCTCCCAGACATCTGTGTACTTCTGTGCCAGCAGTCCCGGTTACGAGCAGTACTTCGGGCCG	CASSPGYEQYF	1
ACAGTGACCAGTGCCCATCCTGAAGACAGCAGCTTCTACATCTGCAGTGTTCGCGACAGGTTTGGTTACGAGCAGTACTTCGGGCCG	CSVRDRFGYEQYF	2
CTGCAGAACTGGAGGATTCTGGAGTTTATTTCTGTGCCAGCAGCCAAGATCAGCGGGATCTATAATTCACCCCTCCACTTTGGGAAC		1
AACCTTCACCTACACGCCCTGCAGCCAGAAGACTCAGCCCTGTATCTCTGCGCCAGCAGCCAAGCGTACGAGCAGTACTTCGGGCCG	CASSQAYEQYF	1
TCGGCCCAAAAGAACCCGACAGCTTTCTATCTCTGTGCCAGTAGTCTAGCCTCAGGGGGTACTAACTATGGCTACACCTTCGGTTCG	CASSLASGGTNYGYTF	1
CTGCTGTCGGCTGCTCCCTCCCAGACATCTGTGTACTTCTGTGCCAGCAGTGCAGGGTATAGCAATCAGCCCCAGCATTTTGGTGAT	CASSAGYSNQPQHF	1
GTGAACGCCTTGTTGCTGGGGGACTCGGCCCTCTATCTCTGTGCCAGCAGTCAAGCGGGGTTCACAGATACGCAGTATTTTGGCCCA	CASSQAGFTDTQYF	1
ATCCAGCCTGCAAAGCTTGAGGACTCGGCCGTGTATCTCTGTGCCAGCAGCCCGGGGGACAGGGGAGAGACCCAGTACTTCGGGCCA	CASSPGDRGETQYF	1
CACATCAATTCCCTGGAGCTTGGTGACTCTGCTGTGTATTTCTGTGCCAGCAGCCTGGCCTCTGGAAACACCATATATTTTGGAGAG	CASSLASGNTIYF	5
ATCCAGCGCACAGAGCAGGGGGACTCGGCCATGTATCTCTGTGCCAGCAGATACGCGGGAGGGCAAGAGACCCAGTACTTCGGGCCA	CASRYAGGQETQYF	1
CTGTGACATCGGCCCAAAAGAACCCGACAGCTTTCTATCTCTGTGCCAGTAGTACGTCAGGGTAACTATGGCTACACCTTCGGTTCG		1
ACGCCCTGCAGCCAGAAGACTCAGCCCTGTATCTCTGCGCCAGCAGCCACCCCCGGGACGTATTGAGAGACCCAGTACTTCGGGCCA		1
TGAATGTGAGCACCTTGGAGCTGGGGGACTCGGCCCTTTATCTTTGCGCCAGCTGACAGGGGGTTTACACCCCTCCACTTTGGGAAC		1
GCCTTGGAGCTGGACGACTCGGCCCTGTATCTCTGTGCCAGCAGCACGAGCCCAGGGGCCGATAATGAAAAACTGTTTTTTGGCAGT	CASSTSPGADNEKLFF	1
ACCAGTGCCCATCCTGAAGACAGCAGCTTCTACATCTGCAGTGCTGGCAGCAGGGTTGCAGGGGCCAACGTCCTGACTTTCGGGGCC	CSAGSRVAGANVLTF	1
CACACCCTGCAGCCAGAAGACTCGGCCCTGTATCTCTGCGCCAGCAGCCAAGTTCCAGTCTTCACAGATACGCAGTATTTTGGCCCA	CASSQVPVFTDTQYF	1
ATCCGGTCCACAAAGCTGGAGGACTCAGCCATGTACTTCTGTGCCAGCAGTAGAGGGGGCCTCGGAAACGAGCAGTACTTCGGGCCG	CASSRGGLGNEQYF	1
ATCCAGCGCACACAGCAGGAGGACTCGGCCGTGTATCTCTGTGCCAGCAAAGAGGCGCGAAGCACAGATACGCAGTATTTTGGCCCA	CASKEARSTDTQYF	1
CTACACACCCTGCAGCCAGAAGACTCGGCCCTGTATCTCTGCGCCAGCAGCCAAGGAAGGGGGGGGAGGGAGCAGTACTTCGGGCCG	CASSQGRGGREQYF	1
ACCAGTGCCCATCCTGAAGACAGCAGCTTCTACATCTGCAGTGCTAGTTTAGCGCTTATCTCCTACAATGAGCAGTTCTTCGGGCCA	CSASLALISYNEQFF	1
CTGGAGTCTGCCAGGCCCTCACATACCTCTCAGTACCTCTGTGCCAGCAGTGAGCCAGGAATCCAAGAGACCCAGTACTTCGGGCCA	CASSEPGIQETQYF	1
TCGGCTGCTCCCTCCCAGACATCTGTGTACTTCTGTGCCAGCACATACAGTATTTCGGACAGGGTCTACGAGCAGTACTTCGGGCCG	CASTYSISDRVYEQYF	1
CTGCAGCCAGAAGACTCAGCCCTGTATCTCTGCGCCAGCAGCCAAGGTGAGGGACTAGCGGCCTACAATGAGCAGTTCTTCGGGCCA	CASSQGEGLAAYNEQFF	1
CTGCTGTCGGCTGCTCCCTCCCAGACATCTGTGTACTTCTGTGCCAGCAGTTTTTACGGATATAATGAAAAACTGTTTTTTGGCAGT	CASSFYGYNEKLFF	1
AAGATCCAGCCTGCAAAGCTTGAGGACTCGGCCGTGTATCTCTGTGCCAGCAGCACTCCTAGGAGAAGCGAGCAGTACTTCGGGCCG	CASSTPRRSEQYF	1
AGGATCCAGCAGGTAGTGCGAGGAGATTCGGCAGCTTATTTCTGTGCCAGCTCAGGACAGGCGACCTACGAGCAGTACTTCGGGCCA	CASSGQATYEQYF	1
TCGGCTGCTCCCTCCCAGACATCTGTGTACTTCTGTGCCAGCACCCTGAGGGGACAGGTAGGGAACTACGAGCAGTACTTCGGGCCG	CASTLRGQVGNYEQYF	1
CTGGAGTCCGCCAGCACCAACCAGACATCTATGTACCTCTGTGCCAGCAGACCCGGACAGGCTCCCTACGAGCAGTACTTCGGGCCG	CASRPGQAPYEQYF	1
TGGAGTCCGCCAGCACCAACCAGACATCTATGTACCTCTGTGCCAGCAGTTTAGGGACTAGCAGCAGATACGCAGTATTTTGGCCCA		1
GAGTCAGGGGACACAGCACTGTATTTCTGTGCCAGCAGCAAAGAGGGGCAGGGGTCGCCTTATTATCCCGAGCAGTACTTCGGGCCG	CASSKEGQGSPYYPEQYF	1
CCTGCTGGGGTTGGAGTCGGCTGCTCCCTCCCAAACATCTGTGTACTTCTGTGCCAGCAGACCATCAATGAGCAGTTCTTCGGGCCA		1
TTGTTGCTGGGGGACTCGGCCCTCTATCTCTGTGCCAGCAGCACGCTAAAGACAGGGTGGTTTGGAAACACCATATATTTTGGAGAG	CASSTLKTGWFGNTIYF	2
CAAAAGAACCCGACAGCTTTCTATCTCTGTGCCAGTAGTATATGGCCTAGCGGGAGGCCCAGGAGAGATACGCAGTATTTTGGCCCA	CASSIWPSGRPRRDTQYF	1
TCTGCTGTACCCTCTCAGACATCTGTGTACTTCTGTGCCAGCAGTGACGATTCTAGCGGGAGCGCCGGGGAGCTGTTTTTTGGAGAA	CASSDDSSGSAGELFF	1
GAGATCCAGCGCACAGAGCAGGGGGACTCGGCCATGTATCTCTGTGCCAGCAGCTTTGACCGCAATCAGCCCCAGCATTTTGGTGAT	CASSFDRNQPQHF	2
ATCCAGCAGGTAGTGCGAGGAGATTCGGCAGCTTATTTCTGTGCCAGCTCACCTAGCGGACAGTGGAACGAGCAGTACTTCGGGCCA	CASSPSGQWNEQYF	1
CAGCCTGCAAAGCTTGAGGACTCGGCCGTGTATCTCTGTGCCAGCAGCTCCCCGACAGAAACTAATGAAAAACTGTTTTTTGGCAGT	CASSSPTETNEKLFF	5
CTTGGAGCTGGGGGACTCGGCCCTTTATCTTTGCGCCAGCAGACCCGTCCAGGGCATAGGGGCAATCAGCCCCAGCATTTTGGTGAT		3
CTGGAGTCTGCCAGGCCCTCACATACCTCTCAGTACCTCTGTGCCAGCAGTGCCCCTTCTTATAATTCACCCCTCCACTTTGGGAAC	CASSAPSYNSPLHF	1
AAGATCCGGTCCACAAAGCTGGAGGACTCAGCCATGTACTTCTGTGCCAGCAGGGGGGCAGATGTGAATACGCAGTATTTTGGCCCA	CASRGADVNTQYF	3
AATTCCCTGGAGCTTGGTGACTCTGCTGTGTATTTCTGTGCCAGCAGCCAATACGGGACTAGCGGAGAGACCCAGTACTTCGGGCCA	CASSQYGTSGETQYF	1
GACAGTGACCAGTGCCCATCCTGAAGACAGCAGCTTCTACATCTGCAGTGCCTTTTGCGCCTCTTCCAGCCCCAGCATTTTGGTGAT		3
TCTCTGGAGCTGGGGGACTCAGCTTTGTATTTCTGTGCCAGCAGCGTAGGGGGGGGTATCTCCTACAATGAGCAGTTCTTCGGGCCA	CASSVGGGISYNEQFF	1
ATCCAGCCCTCAGAACCCAGGGACTCAGCTGTGTACTTCTGTGCCAGCAGTTTAGCAGGTCCGAACTATGGCTACACCTTCGGTTCG	CASSLAGPNYGYTF	1
AAGATCCAGCGCACAGAGCGGGGGGACTCAGCCGTGTATCTCTGTGCCAGCAGCTTAAGGGGGTTAGATACGCAGTATTTTGGCCCA	CASSLRGLDTQYF	1
CCCTCACATACCTCTCAGTACCTCTGTGCCAGCAGTGCAACGGGGGGTACAGGGTCCCGTTACACCGGGGAGCTGTTTTTTGGAGAA	CASSATGGTGSRYTGELFF	1
CACGGAGTCAGGGGACACAGCACTGTATTTCTGTGCCAGCAGCAAAACCGGGGGACGGGGAGCTCCTACGAGCAGTACTTCGGGCCG		1
GTGACCAGTGCCCATCCTGAAGACAGCAGCTTCTACATCTGCAGTGCCAAAGCTGGACAGGGGGGCACTGAAGCTTTCTTTGGACAA	CSAKAGQGGTEAFF	1
ATCCGGTCCACAAAGCTGGAGGACTCAGCCATGTACTTCTGTGCCAGCGAGCGGAGGGCGAGCACAGATACGCAGTATTTTGGCCCA	CASERRASTDTQYF	1
ACCAGTGCCCATCCTGAAGACAGCAGCTTCTACATCTGCAGTGCTACCGGGACTAGCGCTTCCTACAATGAGCAGTTCTTCGGGCCA	CSATGTSASYNEQFF	1
CACACCCTGCAGCCAGAAGACTCGGCCCTGTATCTCTGCGCCAGCAGCCAAGATAGGACAGGGTACTACGAGCAGTACTTCGGGCCG	CASSQDRTGYYEQYF	1
CGCACAGAGCAGCGGGACTCGGCCATGTATCGCTGTGCCAGCAGCTTAGAAGCACTTAGGGTCCAAGAGACCCAGTACTTCGGGCCA	CASSLEALRVQETQYF	1
CTGAAGATCCAGCCCTCAGAACCCAGGGACTCAGCTGTGTATTTTTGTGCTAGTGGTTTGAACACAGATACGCAGTATTTTGGCCCA	CASGLNTDTQYF	1
ATCCGGTCCACAAAGCTGGAGGACTCAGCCATGTACTTCTGTGCCAGCAGGGGGGACAGCTTGGGGACTGAAGCTTTCTTTGGACAA	CASRGDSLGTEAFF	1
ATCCAGCCCTCAGAACCCAGGGACTCAGCTGTGTACTTCTGTGCCAGCAGTTTCGCTAGCGGGGTAGGGGAGCTGTTTTTTGGAGAA	CASSFASGVGELFF	1
ATCGGCCCAAAAGAACCCGACAGCTTTCTATCTCTGTGCCAGTAGTATTGATTGGACAGGACGCTCTACGAGCAGTACTTCGGGCCG		1
CTCACTGTGACATCGGCCCAAAAGAACCCGACAGCTTTCTATCTCTGTGCCAGTAGGGGCAGCTGGGACACCATATATTTTGGAGAG	CASRGSWDTIYF	1
ATCCAGCAGGTAGTGCGAGGAGATTCGGCAGCTTATTTCTGTGCCAGCTCACGTAGCGGCGAGGGACTCGAGCAGTACTTCGGGCCG	CASSRSGEGLEQYF	1
AGTGCCCATCCTGAAGACAGCAGCTTCTACATCTGCAGTGCTAGAGTTGGTAGCGGGATACGCACAGATACGCAGTATTTTGGCCCA	CSARVGSGIRTDTQYF	1
AGTGCCCATCCTGAAGACAGCAGCTTCTACATCTGCAGTGCTAGAGGAGAGGGGTCGGGGACCAACTATGGCTACACCTTCGGTTCG	CSARGEGSGTNYGYTF	1
TCGGCCCAAAAGAACCCGACAGCTTTCTATCTCTGTGCCAGTAGTATCTGAACTAGAAAAGTTACAGATACGCAGTATTTTGGCCCA	CASSI*TRKVTDTQYF	1
GTGAGCACCTTGGAGCTGGGGGACTCGGCCCTTTATCTTTGCGCCAGCAGCTTGGCAACCAGGGGGACTGAAGCTTTCTTTGGACAA	CASSLATRGTEAFF	1
GGCTGCTCCCTCCCAGACATCTGTGTACTTCTGTGCCAGCAGTTACCCGGGACAGACTAAGCCAAAAACATTCAGTACTTCGGCGCC		1
CTGCTGTCGGCTGCTCCCTCCCAGACATCTGTGTACTTCTGTGCCAGCAGTTACCGGGACAGGGGTTACGAGCAGTACTTCGGGCCG	CASSYRDRGYEQYF	1
CACACCCTGCAGCCAGAAGACTCGGCCCTGTATCTCTGTGCCAGCAGCCAAGATCTAGGGGGGTGGACTGAAGCTTTCTTTGGACAA	CASSQDLGGWTEAFF	1
CTGCTGCCTCCTCCCAGACATCTGTATATTTCTGCGCCAGCAGTGAATCCGACAGGGAGGTCTTCATATGGCTACACCTTCGGTTCG		1
TCCACGGAGTCAGGGGACACAGCACTGTATTTCTGTGCCAGCAGCAAAGATGCCCAGGGGGCGGCAGATACGCAGTATTTTGGCCCA	CASSKDAQGAADTQYF	1
CAGGCTGCTGTCGGCTGCTCCCTCCCAGACATCTGTGTACTTCTGTGCCAGCAGAACACAGGGGCGCTGGGCTACACCTTCGGTTCG		1
GTGAACGCCTTGTTGCTGGGGGACTCGGCCCTCTATCTCTGTGCCAGCAGCTTGGGGGGATACACCGGGGAGCTGTTTTTTGGAGAA	CASSLGGYTGELFF	1
ACTCTGGAGTCAGCTACCCGCTCCCAGACATCTGTGTATTTCTGCGCCAGTGGGGAGAGAGCTAACTATGGCTACACCTTCGGTTCG	CASGERANYGYTF	1
CCTGCAGAACTGGAGGATTCTGGAGTTTATTTCTGTGCCAGCAGCTACCTAGCGGGAGAGTACCAAGAGACCCAGTACTTCGGGCCA	CASSYLAGEYQETQYF	2
GAGTCGCCCAGCCCCAACCAGACCTCTCTGTACTTCTGTGCCAGCGGACGTCCACCAGGGGCGAACTATGGCTACACCTTCGGTTCG	CASGRPPGANYGYTF	1
AAGATCCAGCCTGCAAAGCTTGAGGACTCGGCCGTGTATCTCTGTGCCAGCAGCTTGGGGAGGGACTATGGCTACACCTTCGGTTCG	CASSLGRDYGYTF	1
ACTGTGAGCAACATGAGCCCTGAAGACAGCAGCATATATCTCTGCAGCGTTGAAAAACCCGGGCGCTATGGCTACACCTTCGGTTCG	CSVEKPGRYGYTF	2
ACAGAGCAGGGGGACTCGGCCATGTATCTCTGTGCCAGCACCCGTCGGGCGGGCGGAGGGCGGACCGGGGAGCTGTTTTTTGGAGAA	CASTRRAGGGRTGELFF	1
ACCTTGGAGCTGGGGGACTCGGCCCTTTATCTTTGCGCCAGCAGCTTAGGTTTCACTTCCGGCACAGATACGCAGTATTTTGGCCCA	CASSLGFTSGTDTQYF	2
CTGAGCTCTCTGGGGCTGGGGGACTCAGCTTTGTATTTCTGTGCCAGCAGCCGGACAGGGGGCGATGAAAAACTGTTTTTTGGCAGT	CASSRTGGDEKLFF	1
CTGAATGTGAACGCCTTGGAGCTGGAGGACTCGGCCCTGTATCTCTGTGCCAGCAGCTTGGACGCGTACGAGCAGTACTTCGGGCCG	CASSLDAYEQYF	1
CTGGAGTCGGCTGCTCCCTCCCAGACATCTGTGTACTTCTGTGCCACCGGACAGCCCCACGATTTGAGCGAGCAGTACTTCGGGCCG	CATGQPHDLSEQYF	1
GCCTTGTTGCTGGGGGACTCGGCCCTCTATCTCTGTGCCAGCAGCTCAGGGACTAGGGGGTCCTACAATGAGCAGTTCTTCGGGCCA	CASSSGTRGSYNEQFF	1
GTGAGCAACATGAGCCCTGAAGACAGCAGCATATATCTCTGCAGCGTTGGTCAACAGGGGTCCACCGGGGAGCTGTTTTTTGGAGAA	CSVGQQGSTGELFF	1
CATCTGTATATTTCTGCGCCAGCAGTGATGGTGTGGGGGTACGGGACTAGCATCATCGGAATCAGCTACGAGCAGTACTTCGGGCCG		2
GTGACATCGGCCCAAAAGAACCCGACAGCTTTCTATCTCTGTGCCAGTAGTATAACAGGGGGAAACACTGAAGCTTTCTTTGGACAA	CASSITGGNTEAFF	1
CTGAGCTCTCTGGAGCTGGGGGACTCAGCTTTGTATTTCTGTGCCAGCAGCGCCACAGGGGTTCTTGAGACCCAGTACTTCGGGCCA	CASSATGVLETQYF	4
CTGATTCTGGAGTCCGCCAGCACCAACCAGACATCTATGTACCTCTGTGCCAGCAGCGCGACAGGGAAGGGCTACACCTTCGGTTCG	CASSATGKGYTF	1
CTGAAGATCCAGCCCTCAGAACCCAGGGACTCAGCTGTGTACTTCTGTGCCAGCAGCCGATTCTCCTACGAGCAGTACTTCGGGCCG	CASSRFSYEQYF	1
CTACACGCCCTGCAGCCAGAAGACTCAGCCCTGTATCTCTGCGCCAGCAGCCAAGTCGGGGGGAACACTGAAGCTTTCTTTGGACAA	CASSQVGGNTEAFF	1
ACATCGGCCCAAAAGAACCCGACAGCTTTCTATCTCTGTGCCAGTAGTATCCCCAGGGCATCCACCGGGGAGCTGTTTTTTGGAGAA	CASSIPRASTGELFF	1
CAGAGCAGGGGGACTCGGCCGTGTATGTCTGTGCAAGTCGCTCTCGACAGGGAGTCCCCTGGGGCCAACGTCCTGACTTTCGGGGCC		2
GAGATCCAGTCCACGGAGTCAGGGGACACAGCACTGTATTTCTGTGCCAGCAGCAAAGAGTGGGGGAACATTCAGTACTTCGGCGCC	CASSKEWGNIQYF	2
AAGATCCGGTCCACAAAGCTGGAGGACTCAGCCATGTACTTCTGTGCCAGCAGGGCTAGCGGACTATACGAGCAGTACTTCGGGCCG	CASRASGLYEQYF	1
ACATCGGCCCAAAAGAACCCGACAGCTTTCTATCTCTGTGCCAGTAGTATGTGGGATCAGGGGGATCAGCCCCAGCATTTTGGTGAT	CASSMWDQGDQPQHF	1
GTGCAGCCTGCAGAACTGGAGGATTCTGGAGTTTATTTCTGTGCCAGCAGCCAAGATCCAGGGCCCTATGGCTACACCTTCGGTTCG	CASSQDPGPYGYTF	1
CTGGAGTCGGCTGCTCCCTCCCAGACATCTGTGTACTTCTGTGCCAGCGGGGACAGGGGGCTGAACTACGAGCAGTACTTCGGGCCG	CASGDRGLNYEQYF	1
ACCAGTGCCCATCCTGAAGACAGCAGCTTCTACATCTGCAGTGCTAGAGCGTTAGCGGGAGGGCCTAAGACCCAGTACTTCGGGCCA	CSARALAGGPKTQYF	1
TCCGCCAGCACCAACCAGACATCTATGTACCTCTGTGCCAGCAGTTTTGCTGGGAGGCCCTCCTACAATGAGCAGTTCTTCGGGCCA	CASSFAGRPSYNEQFF	1
ACATCGGCCCAAAAGAACCCGACAGCTTTCTATCTCTGTGCCAGTAGTATCTTGGACCCCTCGGATCGTCACTACACCTTCGGTTCG	CASSILDPSDRHYTF	1
ACATCGGCCCAAAAGAACCCGACAGCTTTCTATCTCTGTGCCAGTAGTGTTCTATACTCATCTGGAAACACCATATATTTTGGAGAG	CASSVLYSSGNTIYF	1
TCCAGCGCACAGAGCAAGGGCGACTCGGCTGTGTATCTCTGTGCCAGAAGCTTAGTAGGAGGTAATGAAAAACTGTTTTTTGGCAGT	CARSLVGGNEKLFF	2
GTAGTGCGAGGAGATTCGGCAGCTTATTTCTGTGCCAGCTCCGAGGGAACCCCGGGACAGGTACACTATGGCTACACCTTCGGTTCG	CASSEGTPGQVHYGYTF	1
AAGATCCAGCCCTCAGAACCCAGGGACTCAGCTGTGTACTTCTGTGCCACCGGGACCGCCCGGGGACAGCCCCAGCATTTTGGTGAT	CATGTARGQPQHF	1
GTGAACGCCTTGGAGCTGGACGACTCGGCCCTGTATCTCTGTGCCAGCAGCTTGAGGACTAGGGTAGGCGAGCAGTACTTCGGGCCG	CASSLRTRVGEQYF	1
ATCCGCTCACCAGGCCTGGGGGACGCAGCCATGTACCTGTGTGCCACCAGCAGAGCAAGGGGTATCGGGGAGCTGTTTTTTGGAGAA	CATSRARGIGELFF	1
GAGTCGGCTGCTCCCTCCCAAACATCTGTGTACTTCTGTGCCAGCAGCACTCCCAGGGGGTCGGGCTACGAGCAGTACTTCGGGCCA	CASSTPRGSGYEQYF	1
CAGCCTGCAGAACTGGAGGATTCTGGAGTTTATTTCTGTGCCAGCAGCCCGGGGGCGCGGGGCACAGATACGCAGTATTTTGGCCCA	CASSPGARGTDTQYF	1
GAGTCGCCCAGCCCCAACCAGACCTCTCTGTACTTCTGTGCCAGCAGTTCGTCGGACAGGGGTGACAATGAGCAGTTCTTCGGGCCA	CASSSSDRGDNEQFF	1
TCCCTGGAGCTTGGTGACTCTGCTGTGTATTTCTGTGCCAGCAGCAAGAGCGGGGGTCAGGGTCAGAATGGCTACACCTTCGGTTCG	CASSKSGGQGQNGYTF	2
CGCACACAGCAGGAGGACTCGGCCGTGTATCTCTGTGCCAGCAGCCCCATAGCGGGAGTCCCTTCTAGCGAGCAGTACTTCGGGCCG	CASSPIAGVPSSEQYF	1
ACCTTGGAGCTGGGGGACTCGGCCCTTTATCTTTGCGCCAGCAGCTTGGCCGGTCTAGCGGGAGGAATTGAGCAGTACTTCGGGCCG	CASSLAGLAGGIEQYF	1
AGCTCTCTGGAGCTGGGGGACTCAGCTTTGTATTTCTGTGCCAGCAGCGTCAGTAGCGGGGGGGGTTACGAGCAGTACTTCGGGCCG	CASSVSSGGGYEQYF	1
CGGTCCACAAAGCTGGAGGACTCAGCCATGTACTTCTGTGCCAGCAGTGAAGGGAAGGGATCTTATGAAAAACTGTTTTTTGGCAGT	CASSEGKGSYEKLFF	1
CTCAAGATCCAGCCTGCAAAGCTTGAGGACTCGGCCGTGTATCTCTGTGCCAGCAGCCTGGGACCTGCCGAGCAGTACTTCGGGCCA	CASSLGPAEQYF	1
AACGCCTTGGAGCTGGACGACTCGGCCCTGTATCTCTGTGCCAGCAGCTTGACGACCCTAAACACCGGGGAGCTGTTTTTTGGAGAA	CASSLTTLNTGELFF	3
CAGCGCACAGAGCAGCGGGACTCGGCCATGTATCGCTGTGCCAGCACTAATCGGGGGGATGGCACCGGGGAGCTGTTTTTTGGAGAA	CASTNRGDGTGELFF	2
TCCGCTACCAGCTCCCAGACATCTGTGTACTTCTGTGCCATCAGTGTAGCGGGAGGGCCTGATACAGATACGCAGTATTTTGGCCCA	CAISVAGGPDTDTQYF	1
CAGTGCCCATCCTGAAGACAGCAGCTTCTACATCTGCAGTGCTAGATCCGGACTAGCGGGAGTGTAGATACGCAGTATTTTGGCCCA		1
GTGACATCGGCCCAAAAGAACCCGACAGCTTTCTATCTCTGTGCCAGTAGTCCGACAATTCCGAACTATGGCTACACCTTCGGTTCG	CASSPTIPNYGYTF	1
CGCACAGAGCGGGGGGACTCAGCCGTGTATCTCTGTGCCAGCAGCTTTCACACCTCAGGGCCGAGGAGGGAGCTGTTTTTTGGAGAA	CASSFHTSGPRRELFF	1
TGGAGTCCGCTACCAGCTCCCAGACATCTGTGTACTTCTGTGCCATCAGAGACCGACTAGCGGCAAGAGACCCAGTACTTCGGGCCA		1
CCAGAAGACTCGGCCCTGTATCTCTGTGCCAGCAGCCAAGATGGGGGACTAGCGGGAGGGTTTGGCGAGACCCAGTACTTCGGGCCA	CASSQDGGLAGGFGETQYF	4
GTGAGCACCTTGGAGCTGGGGGACTCGGCCCTTTATCTTTGCGCCAGCAGCGCCAACAGTATACGGAATGAGCAGTTCTTCGGGCCA	CASSANSIRNEQFF	1
AGTGCCCATCCTGAAGACAGCAGCTTCTACATCTGCAGTGCTAGAGGTATCCCTACAGGGGAGGCGATTGAAGCTTTCTTTGGACAA	CSARGIPTGEAIEAFF	1
CGCACACAGCAGGAGGACTCCGCCGTGTATCTCTGTGCCAGCACCTATGACAGGGGGATCTCTGGAAACACCATATATTTTGGAGAG	CASTYDRGISGNTIYF	1
AGATCCAGTCCACGGAGTCAGGGGACACAGCACTGTATTTCTGTGCCAGCAGCACCTGACGGACCCTACGAGCAGTACTTCGGGCCG		1
TCGGCCCAAAAGAACCCGACAGCTTTCTATCTCTGTGCCAGTAGTCTCTGGTCCGGGGGGCACGTCGGCACGTACACCTTCGGTTCG	CASSLWSGGHVGTYTF	2
ACCAGTGCCCATCCTGAAGACAGCAGCTTCTACATCTGCAGTGCAACCGGGATCGCCAAGAACACCGGGGAGCTGTTTTTTGGAGAA	CSATGIAKNTGELFF	1
TCACATCAATTCCCTGGAGCTTGGTGACTCTGCTGTGTATTTCTGTGCCAGCAGCGCACAGGGTACGGGGAGCTGTTTTTTGGAGAA		1
TCAGCGCACAGAGCGGGGGGACTCAGCCGTGTATCTCTGTGCCAGCAGCTTATGCCGCGGGGACCCCACGGCTACACCTTCGGTTCG		1
AGCACCTTGGAGCTGGGGGACTCGGCCCTTTATCTTTGCGCCAGCAGCCCCACGGACAGGGACACCGGGGAGCTGTTTTTTGGAGAA	CASSPTDRDTGELFF	1
ACCCTGCAGCCAGAAGACTCGGCCCTGTATCTCTGTGCCAGCAGCCAAGGACTCACGGGGGGGCTATTCGAGCAGTACTTCGGGCCG	CASSQGLTGGLFEQYF	1
ATCCAGCGCACAGAGCAGGGGGACTCGGCCATGTATCTCTGTGCCAGCAGCTCACAGGGGGCGCACACTGAAGCTTTCTTTGGACAA	CASSSQGAHTEAFF	1
GAGCTGGGGGACTCAGCTTTGTATTTCTGTGCCAGCAGCGTCCCACGGGACAGGGGCTCTGGGGCCAACGTCCTGACTTTCGGGGCC	CASSVPRDRGSGANVLTF	1
GCCCATCCTGAAGACAGCAGCTTCTACATCTGCAGTGTAAACCAGATAAGACAGGCTACTAGCACAGATACGCAGTATTTTGGCCCA	CSVNQIRQATSTDTQYF	1
CTTGACATCCGCTCACCAGGCCTGGGGGACGCAGCCATGTACCTGTGTGCCACCAGCAGAGATGATCAGCCCCAGCATTTTGGTGAT	CATSRDDQPQHF	1
CTGTCGGCTGCTCCCTCCCAGACATCTGTGTACTTCTGTGCCAGCAGACCTCGGGACAGACCCAATCAGCCCCAGCATTTTGGTGAT	CASRPRDRPNQPQHF	1
AACGCCTTGGAGCTGGACGACTCGGCCCTGTATCTCTGTGCCAGCAGCTCGGGGACACCCGTGAACACTGAAGCTTTCTTTGGACAA	CASSSGTPVNTEAFF	1
ATCCAGCAGGTAGTGCGAGGAGATTCGGCAGCTTATTTCTGTGCCAGCTCACCACCGGGGGTAAAGCGTGGCTACACCTTCGGTTCG	CASSPPGVKRGYTF	2
CCTAGAGTCTGCCATCCCCAACCAGACAGCTCTTTACTTCTGTGCCACCAGTGATTTGATGGACTCCATGAGCAGTTCTTCGGGCCA		1
CGCCTTGGAGCTGGACGACTCGGCCCTGTATCTCTGTGCCAGCAGCTCCCTTAGCGGGGGGCCAGGAATGAGCAGTTCTTCGGGCCA		1
GTGACATCGGCCCAAAAGAACCCGACAGCTTTCTATCTCTGTGCCAGTAGTATCGGGTGGGAGTCCAATGAGCAGTTCTTCGGGCCA	CASSIGWESNEQFF	1
ACAGTGACCAGTGCCCATCCTGAAGACAGCAGCTTCTACATCTGCAGTGCTGGGAGGACTACAAACAATGAGCAGTTCTTCGGGCCA	CSAGRTTNNEQFF	1
GTGAGCACCTTGGAGCTGGGGGACTCGGCCCTTTATCTTTGCGCCAGCGCTGAAGTCGGGGGAACCGGGGAGCTGTTTTTTGGAGAA	CASAEVGGTGELFF	1
ACCCTGCAGCCAGAAGACTCGGCCCTGTATCTCTGCGCCAGCAGCCAAGGTAGCGGGACGCCGTCCTACGAGCAGTACTTCGGGCCG	CASSQGSGTPSYEQYF	2
CGGTCCACAAAGCTGGAGGACTCAGCCATGTACTTCTGTGCCAGCAGTGAATCGGATAGTGGGGCCAACGTCCTGACTTTCGGGGCC	CASSESDSGANVLTF	1
GGAGATCCAGTCCACGGAGTCAGGGGACACAGCACTGTATTTCTGTGCCAGCAGCAAAGTCACACCGGGGAGCTGTTTTTTGGAGAA		1
GCCTCCTCCCAGACATCTGTATATTTCTGCGCCAGGCGTGGGGTAGCGGGGGCGTAGCCGAACACCGGGGAGCTGTTTTTTGGAGAA	CARRGVAGA*PNTGELFF	2
CTGATTCTGGAGTCCGCCAGCACCAACCAGACATCTATGTACCTCTGTGCCACCAACGACCGGCTGGACGAGCAGTACTTCGGGCCG	CATNDRLDEQYF	1
ACTGTGACATCGGCCCAAAAGGACCCGACAGCTTTCTATCTCTGTGCCAGTGGAACTTTCGGGATCACTGAAGCTTTCTTTGGACAA	CASGTFGITEAFF	1
GAGTCTGCTGCCTCCTCCCAGACATCTGTATATTTCTGCGCCAGCACCCCGGGACAGGGAGGCCAAGAGACCCAGTACTTCGGGCCA	CASTPGQGGQETQYF	1
GGACACAGCACTGTATTTCTGTGCCAGCAGCGCAAATAAGAGGGGGAACGGGCCTACAGCAGTTATCAGCCCCAGCATTTTGGTGAT		1
CATCCTGAAGACAGCAGCTTCTACATCTGCAGTGCTAGAGAGCCGCTCGGCGGGAGGGCCGGGGGCGGGGAGCTGTTTTTTGGAGAA	CSAREPLGGRAGGGELFF	1
GCTGCTCCCTCCCAGACATCTGTGTACTTCTGTGCCAGCAGTTACCAGGACAGGTCCTCTGGGGCCAACGTCCTGACTTTCGGGGCC	CASSYQDRSSGANVLTF	1
ACAGTGACCAGTGCCCATCCTGAAGACAGCAGCTTCTACATCTGCAGTGCTCCTTCCGGGACAGGGGGCGTGCAGTACTTCGGGCCG	CSAPSGTGGVQYF	1
AGTGCCCATCCTGAAGACAGCAGCTTCTACATCTGCAGTGCTAGTAGGGGAGGGAGGGATGGCACAGATACGCAGTATTTTGGCCCA	CSASRGGRDGTDTQYF	1
ACCCTGGAGTCTGCCAGGCCCTCACATACCTCTCAGTACCTCTGTGCCAGCAGTGAAAATACGGACAATGAGCAGTTCTTCGGGCCA	CASSENTDNEQFF	1
TCGGCCCAAAAGAACCCGACAGCTTTCTATCTCTGTGCCAGTAGTAGTAGGGCGGGAGGGCCTTCCTACGAGCAGTACTTCGGGCCG	CASSSRAGGPSYEQYF	1
CTGATTCTGGAGTCCGCCAGCACCAACCAGACATCTATGTACCTCTGTGCCAGCAGGCTCAGGGACACTGAAGCTTTCTTTGGACAA	CASRLRDTEAFF	1
AACGCCTTGTTGCTGGGGGACTCGGCCCTCTATCTCTGTGCCAGCAGCTTTCGGGTTCTAGCCAAAAACATTCAGTACTTCGGCGCC	CASSFRVLAKNIQYF	1
CTGAATGTGAACGCCTTGTTGCTGGGGGACTCGGCCCTGTATCTCTGTGCCAGCAGTCTGGGTGACTATGGCTACACCTTCGGTTCG	CASSLGDYGYTF	1
CAGAGCAGGGGGACTCGGCCATGTATCTCTGTGCCAGCAGCTCTACTACTCCGACAACTAGCTAACTATGGCTACACCTTCGGTTCG		2
ACTCATCCTGTACCTTGGAGATCCAGTCCACGGAGTCAGGGGACACAGCACTGTATTTCTGTGCCAGCAAGGAGGAACTTCGGGCCA		1
CTGGAGCTGGGGGACTCAGCTTTGTATTTCTGTGCCAGCAGCGTAGGCCGGGACAGGGTGATTAATGAAAAACTGTTTTTTGGCAGT	CASSVGRDRVINEKLFF	1
GCACTGCAGCAAGAAGACTCAGCTGCGTATCTCTGCACCAGCAGCCAAGATAGGGACAGGGGGGTCGCTGAAGCTTTCTTTGGACAA	CTSSQDRDRGVAEAFF	2
CTGAAGATCCAGCGCACAGAGCAGGGGGACTCGGCCATGTATCTCTGTGCCAGCAGCTCAAGCTCCTACGAGCAGTACTTCGGGCCG	CASSSSSYEQYF	1
GTGAGCACCTTGGAGCTGGGGGACTCGGCCCTTTATCTTTGCGCCAGCAGCTTGAAGGCGGGATCCGGGGAGCTGTTTTTTGGAGAA	CASSLKAGSGELFF	1
CTGCTGTCGGCTGCTCCCTCCCAGACATCTGTGTACTTCTGTGCCAGCAGTTTGGGGACAGGGGGCTACGAGCAGTACTTCGGGCCG	CASSLGTGGYEQYF	1
GCAGCCTGCAGAACTGGAGGATTCTGGAGTTTATTTCTGTGCCAGCATAGGTGTCTTGAGGGGGCAGAGACCCAGTACTTCGGGCCA		1
GTGAGCACCTTGGAGCTGGGGGACTCGGCCCTTTATCTTTGCGCCAGCAGCTTGGAAGGGGGGTCTCAGCCCCAGCATTTTGGTGAT	CASSLEGGSQPQHF	1
AATCTGAAGATCCAGCCCTCAGAACCCAGGGACTCAGCTGTGTACTTCTGTGCCAGCAGTTTAGGGCTCGAGCAGTACTTCGGGCCG	CASSLGLEQYF	1
GTGCCCATCCTGAAGACAGCAGCTTCTACATCTGCAGTGCTCTTCCCCTTAGCGGAGAGCTCCTACAATGAGCAGTTCTTCGGGCCA		1
ACATCGGCCCAAAAGAACCCGACAGCTTTCTATCTCTGTGCCAGTAGATATTGGGACGAAGGGAATCAGCCCCAGCATTTTGGTGAT	CASRYWDEGNQPQHF	1
ACGATCCAGCGCACACAGCAGGAGGACTCGGCCGTGTATCTCTGTGCCAGCAGCTTTCTTTTTGTTAACGAGCAGTACTTCGGGCCG	CASSFLFVNEQYF	1
ATCCAGCGCACACAGCAGGAGGACTCCGCCGTGTATCTCTGTGCCAGCAGCTTACGGGCACATAATGAAAAACTGTTTTTTGGCAGT	CASSLRAHNEKLFF	1
CAGCCCTCAGAACCCAGGGACTCAGCTGTGTACTTCTGTGCCAGCAGGGCCGGGGGACAGGGCACCTACGAGCAGTACTTCGGGCCG	CASRAGGQGTYEQYF	1
GTGACCAGTGCCCATCCTGAAGACAGCAGCTTCTACATCTGCAGTGCTAGAAAATACAGGGATAATTCACCCCTCCACTTTGGGAAC	CSARKYRDNSPLHF	1
ATCCGGTCCACAAAGCTGGAGGACTCAGCCATGTACTTCTGTGCCAGCCGGGACAAGAACCTTCCCAATGAGCAGTTCTTCGGGCCA	CASRDKNLPNEQFF	1
CAGCCAGAAGACTCGGCCCTGTATCTCTGCGCCAGCAGCCAAGATGCAAGCGGGAGGTGGGGCACAGATACGCAGTATTTTGGCCCA	CASSQDASGRWGTDTQYF	1
AGCTCTCTGGAGCTGGGGGACTCAGCTTTGTATTTCTGTGCCAGCAATTCGGCCGGGGCGGTATTGGAGACCCAGTACTTCGGGCCA	CASNSAGAVLETQYF	1
ATCCCCAACCAGACAGCTCTTTACTTCTGTGCCACCAGTGATGGGGGACTAGATATTCGTCGCACAGATACGCAGTATTTTGGCCCA	CATSDGGLDIRRTDTQYF	1
GGCTGCTCCCTCCCAGACATCTGTGTACTTCTGTGCCAGCAGTTACTACCAAAAGGGGGAGAATACAATGAGCAGTTCTTCGGGCCA		1
ATCCAGCCCTCAGAACCCAGGGACTCAGCTGTGTACTTCTGTGCCAGCAGTCTTGGACAGGGAACCTACGAGCAGTACTTCGGGCCG	CASSLGQGTYEQYF	1
CAGCGCACAGAGCAGGGGGACTCGGCCATGTATCTCTGTGCCAGCAGCGAGGGAGGCGGGCCTAATGAAAAACTGTTTTTTGGCAGT	CASSEGGGPNEKLFF	1
AGCTCTCTGGAGCTGGGGGACTCAGCTTTGTATTTCTGTGCCAGCAGCGTAGATGTCGGGAGGATCAGTGAGCAGTTCTTCGGGCCA	CASSVDVGRISEQFF	1
CAGCGCACACAGCAGGAGGACTCGGCCGTGTATCTCTGTGCCAGCAGCCCGAGGACTAGCTCCTACAATGAGCAGTTCTTCGGGCCA	CASSPRTSSYNEQFF	1
CACCTACACGCCCTGCAGCCAGAAGACTCAGCCCTGTATCTCTGCGCCAGCAGCCAAGTTTTAGGCGAAAAACTGTTTTTTGGCAGT	CASSQVLGEKLFF	1
ATCCAGCGCACACAGCAGGAGGACTCGGCCGTGTATCTCTGTGCCAGCAGCTTAGGGACAGGGGGCTACGAGCAGTACTTCGGGCCG	CASSLGTGGYEQYF	6
CGGTCCACAAAGCTGGAGGACTCAGCCATGTACTTCTGTGCCAGCAGTGGGACCATCGGAAGAGGGGAAAAACTGTTTTTTGGCAGT	CASSGTIGRGEKLFF	1
CTGAAGGTGCAGCCTGCAGAACTGGAGGATTCTGGAGTTTATTTCTGTGCCAGCAGCCAAGGCCCCTACGAGCAGTACTTCGGGCCG	CASSQGPYEQYF	1
GAGTTGGCTGCTCCCTCCCAGACATCTGTGTACTTCTGTGCCAGCACCGACTCTGGACAGGGATCCTACGAGCAGTACTTCGGGCCG	CASTDSGQGSYEQYF	1
GTCCACGGAGTCAGGGGACACAGCACTGTATTTCTGTGCCGGCCCCTTAGTGCTGGGGAGGAAAGACAGCCCCAGCATTTTGGTGAT		2
TCCGCTACCAGCTCCCAGACATCTGTGTACTTCTGTGCCATCAGTGGGCTTGGCTTGGGTGGCACAGATACGCAGTATTTTGGCCCA	CAISGLGLGGTDTQYF	1
ACCTTGGAGCTGGGGGACTCGGCCCTTTATCTTTGCGCCAGCAGCTTGGAGCTGGGCCCAGGGGCAGATACGCAGTATTTTGGCCCA	CASSLELGPGADTQYF	1
CTACACACCCTGCAGCCAGAAGACTCGGCCCTGTATCTCTGCGCCAGCAGCCAAGAAGGCAGGGTAAGCGAGCAGTACTTCGGGCCG	CASSQEGRVSEQYF	1
GTGAACGCCTTGTTGCTGGGGGACTCGGCCCTCTATCTCTGTGCCAGCAGTTTTATCAATCCCCCAGATACGCAGTATTTTGGCCCA	CASSFINPPDTQYF	1
CTGACGATCCAGCGCACACAGCAGGAGGACTCGGCCGTGTATCTCTGTGCCAGCAGCCCGGCGGCAGAGGGAGCTTTCTTTGGACAA	CASSPAAEGAFF	6
CAGCAGGAGGACTCCGCCGTGTATCTCTGTGCCAGCAGCTTAAGGGGGACAGGGGATCTTACTAACTATGGCTACACCTTCGGTTCG	CASSLRGTGDLTNYGYTF	1
CTTGGAGCTGGGGGACTCGGCCCTTTATCTTTGCGCCAGCAGCAACGTAGCGGGGTCCGGTACGTCAATGAGCAGTTCTTCGGGCCA		2
CTCAGGCTGGAGTTGGCTGCTCCCTCCCAGACATCTGTGTACTTCTGTGCCAGCAACGACAGATTCACTGAAGCTTTCTTTGGACAA	CASNDRFTEAFF	1
ACAGTGACCAGTGCCCATCCTGAAGACAGCAGCTTCTACATCTGCAGTGCCGCCCCAGGGGGTAACACTGAAGCTTTCTTTGGACAA	CSAAPGGNTEAFF	5
AATGTGAACGCCTTGTTGCTGGGGGACTCGGCCCTGTATCTCTGTGCCAGCAGCTTGGTTACAGGGGACGGCTACACCTTCGGTTCG	CASSLVTGDGYTF	1
TCAGAACCCAGGGACTCAGCTGTGTACTTCTGTGCCAGCACTCCACTCGGGACAGGGCCACGGGACACTGAAGCTTTCTTTGGACAA	CASTPLGTGPRDTEAFF	1
ATCCAGCAGGTAGTGCGAGGAGATTCGGCAGCTTATTTCTGTGCCAGCTCGCCCCTAGACAGGGGTTCCGAGCAGTACTTCGGGCCG	CASSPLDRGSEQYF	1
CTGACTGTGAGCAACATGAGCCCTGAAGACAGCAGCATATATCTCTGCAGCGCCGACCACATGGACACTGAAGCTTTCTTTGGACAA	CSADHMDTEAFF	1
CTGTCGGCTGCTCCCTCCCAGACATCTGTGTACTTCTGTGCCAGCAGTTACAGGAGGGGAAGGGCTGAAGGCTACACCTTCGGTTCG	CASSYRRGRAEGYTF	1
TCTGCCATCCCCAACCAGACAGCTCTTTACTTCTGTGCCACCAGTGATTCCCGAGCGGGCCGCCCCGGGGCCCAGTACTTCGGGCCA	CATSDSRAGRPGAQYF	1
CGCACAGAGCAGGGGGACTCGGCCATGTATCTCTGTGCCAGCAGCTTCAGAGGGGCTGCTAGCACAGATACGCAGTATTTTGGCCCA	CASSFRGAASTDTQYF	1
GAGCTGGGGGACTCGGCCCTTTATCTTTGCGCCAGCAGCTTGAAGAGCCCTGACAGAGTCACTGGAAACACCATATATTTTGGAGAG	CASSLKSPDRVTGNTIYF	1
CACAGAGCGGGGGGACTCAGCCGTGTATCTCTGTGCCAGCAGCTTACGGCGGACAGGGGGCTATCCTACGAGCAGTACTTCGGGCCG		1
GTGACCAGTGCCCATCCTGAAGACAGCAGCTTCTACATCTGCAGTGCTAGGATTGGCGGGAGCGCAGATACGCAGTATTTTGGCCCA	CSARIGGSADTQYF	1
ATCCAGCGCACAGAGCAGGGGGACTCGGCCATGTATCTCTGTGCCAGCAGCTTAGAAGGAGGGAACACTGAAGCTTTCTTTGGACAA	CASSLEGGNTEAFF	1
GAAGGTGCAGCCTGCAGAACTGGAGGATTCTGGAGTTTATTTCTGTGCCAGCAGCCAAGCGAAGGGGCCGAGCAGTACTTCGGGCCG		1
CAGCGCACAGAGCAGGGGGACTCGGCCATGTATCTCTGTGCCAGCAGCTTAGCGTCGGGGGGTCCAGATACGCAGTATTTTGGCCCA	CASSLASGGPDTQYF	1
GTGACCAGTGCCCATCCTGAAGACAGCAGCTTCTACATCTGCAGTGCTACCCGTTCGGGCGGGGATTACGAGCAGTACTTCGGGCCG	CSATRSGGDYEQYF	1
GTCCCTAGAGTCTGCCATCCCCAACCAGACAGCTCTTTACTTCTGTGCCCTTGACACCGAAGGGAGGAGACCCAGTACTTCGGGCCA		4
ACAGTGACCAGTGCCCATCCTGAAGACAGCAGCTTCTACACCTGCAGTGCTAGAGTTGAACTAAACTATGGCTACACCTTCGGTTCG	CSARVELNYGYTF	1
CACATCAATTCCCTGGAGCTTGGTGACTCTGCTGTGTATTTCTGTGCCAGCAGCCAAGATGAAGGCCGTAGGCAGTACTTCGGGCCG	CASSQDEGRRQYF	1
CTGGAGTCGGCTGCTCCCTCCCAGACATCTGTGTACTTCTGTGCCAGCAGTAGCACGACAAGAAACTACGAGCAGTACTTCGGGCCG	CASSSTTRNYEQYF	1
CTGCTGTCGGCTGCTCCCTCCCAGACATCTGTGTACTTCTGTGCCAGCAGTTCCGGACACAGAAACACTGAAGCTTTCTTTGGACAA	CASSSGHRNTEAFF	1
CACACCCTGCAGCCAGAAGACTCGGCCCTGTATCTCTGTGCCAGCAGCCCTATTTCTGGGCAGACCTATGGCTACACCTTCGGTTCG	CASSPISGQTYGYTF	3
GAGTCGCCCAGCCCCAACCAGACCTCTCTGTACTTCTGTGCCAGCAGTTCCCTAGCGCCGGCCTACAATGAGCAGTTCTTCGGGCCA	CASSSLAPAYNEQFF	1
GGGACTCAGCTGTGTATTTTTGTGCTAGTGGTTTGGTCCCCTTATGGATAGAAGGCGATGTGATACAATGAGCAGTTCTTCGGGCCA		1
TCCCAGACATCTGTGTACTTCTGTGCCAGCAGTTAAGACCCGGACAGGGTTCGCCACCCGGGCACCGGGGAGCTGTTTTTTGGAGAA	CASS*DPDRVRHPGTGELFF	1
GTCCACGGAGTCAGGGGACACAGCACTGTATTTCTGTGCCAGCAGCAATACAGTCTCCCCCCCTAGGAAAAACTGTTTTTTGGCAGT		1
TTGCTGGGGGACTCGGCCCTCTATCTCTGTGCCAGCAGCTTAAGAGAGCGGGGGTCTTCTGGGGCCAACGTCCTGACTTTCGGGGCC	CASSLRERGSSGANVLTF	2
CTGCTGTCGGCTGCTCCCTCCCAGACATCTGTGTACTTCTGTGCCAGCACCCACAGGGGGCCGGGCTATGGCTACACCTTCGGTTCG	CASTHRGPGYGYTF	1
ATCCGGTCCACAAAGCTGGAGGACTCAGCCATGTACTTCTGTGCCAGCAGGGGGGACAGTTCGCTTGCCCCCCTCCACTTTGGGAAC	CASRGDSSLAPLHF	1
ACCAGTGCCCATCCTGAAGACAGCAGCTTCTACATCTGCAGTGCACGGAATGGCTTCGAGGGCACAGATACGCAGTATTTTGGCCCA	CSARNGFEGTDTQYF	1
AGCACCTTGGAGCTGGGGGACTCGGCCCTTTATCTTTGCGCCAGCAGCTTGGGACGTGCAACTAATGAAAAACTGTTTTTTGGCAGT	CASSLGRATNEKLFF	4
TGTACCCTCTCAGACATCTGTGTACTTCTGTGCCAGCAGGGGGTATATCTAGCGGGAGGGGAGACCGGGGAGCTGTTTTTTGGAGAA		1
CAGCCTGCAGAACTGGAGGATTCTGGAGTTTATTTCTGTGCCAGCAGCCAAGATGATACAGGTTCCTCTGGCTACACCTTCGGTTCG	CASSQDDTGSSGYTF	2
ACAGAGCAGGGGGACTCGGCCATGTATCTCTGTGCCAGCAGCCCAGAGGCCAGCGAAAGCTACACAGATACGCAGTATTTTGGCCCA	CASSPEASESYTDTQYF	1
CCCTCCCAAACATCTGTGTACTTCTGTGCCAGCAGTCCTCCGGCCGGGACTAGCGGGAGGCGAGGCGGGGAGCTGTTTTTTGGAGAA	CASSPPAGTSGRRGGELFF	1
CACCTACACACCCTGCAGCCAGAAGACTCGGCCCTGTATCTCTGCGCCAGCAGCCAAGAAGGGAGAGGGGGTTTGTTTTTTGGCAGT	CASSQEGRGGLFF	7
CAGCCAGAAGACTCAGCCCTGTATCTCTGCGCCAGCAGCCAAGGCGTGACAGGGAAAGGGACCAAAAACATTCAGTACTTCGGCGCC	CASSQGVTGKGTKNIQYF	1
ATCCAGCCCTCAGAACCCAGGGACTCAGCTGTGTACTTCTGTGCCAGCAGCCGGGACAGGTCTTACAATGAGCAGTTCTTCGGGCCA	CASSRDRSYNEQFF	1
ATCCGGTCCACAAAGCTGGAGGACTCAGCCATGTACTTCTGTGCCAGCAGTATCCGGGACAGGGCCTTCGTCCTGACTTTCGGGGCC	CASSIRDRAFVLTF	1
ATGGAACCCAGGGACTTGGGCCTATATTTCTGTGCCAGCAGCTTTGGGACTAGCGGGAATTTAGGGTACGAGCAGTACTTCGGGCCG	CASSFGTSGNLGYEQYF	1
TCCCTGGAGCTTGGTGACTCTGCTGTGTATTTCTGTGCCAGCAGCCAAAAGAGGAGCGTTGGCACCGGGGAGCTGTTTTTTGGAGAA	CASSQKRSVGTGELFF	2
CTAAGAAGCTCCTCCTCAGTGACTCTGGCTTCTATCTCTGTGCCTAAGACAGGCGGGGGGCCCTCCTACGAGCAGTACTTCGGGCCG		3
CAGCCTGCAAAGCTTGAGGACTCGGCCGTGTATCTCTGTGCCAGCAGCTTAAACCCAGGTACCTCTGTTGAAGCTTTCTTTGGACAA	CASSLNPGTSVEAFF	1
AAGATCCAGCGCACACAGCAGGAGGACTCCGCCGTGTATCTCTGTGCCAGCAGCTTTCAGGGCAACACTGAAGCTTTCTTTGGACAA	CASSFQGNTEAFF	2
GCCAGCACCAACCAGACATCTATGTACCTCTGTGCCAGCAGTTTCCTTTCGGGACAGGGCCTCTACAATGAGCAGTTCTTCGGGCCA	CASSFLSGQGLYNEQFF	1
GATCCAGCGCACACAGCAGGAGGACTCCGCCGTGTATCTCTGTGCCACCTCGAAGGGACAGGTAATGAAAAACTGTTTTTTGGCAGT		1
CTGACAGTGACCAGTGCCCATCCTGAAGACAGCAGCTTCTACATCTGCAGTGCTAGTTATAGCACAGATACGCAGTATTTTGGCCCA	CSASYSTDTQYF	4
GTTGGAGTCGGCTGCTCCCTCCCAAACATCTGTGTACTTCTGTGCCAGCAGCCCCCGGGGAGGTCCACTGAAGCTTTCTTTGGACAA		1
TCAGAACCCAGGGACTCAGCTGTGTACTTCTGTGCCAGCAGTACCGACTCATTACAGGGGATGCGCTATGGCTACACCTTCGGTTCG	CASSTDSLQGMRYGYTF	1
CTACACACCCTGCAGCCAGAAGACTCGGCCCTGTATCTCTGTGCCAGCAGCCAAGAATGGGGCTCCGGGGAGCTGTTTTTTGGAGAA	CASSQEWGSGELFF	1
ACATCGGCCCAAAAGAACCCGACAGCTTTCTATCTCTGTGCCAGTAGTACACCACAGGGGGCACAATCTGGCTACACCTTCGGTTCG	CASSTPQGAQSGYTF	1
GAACCCAGGGACTCAGCTGTGTACTTCTGTGCCAGCAGTACTACCACCTCGACAGGACGGGGGTACAATGAGCAGTTCTTCGGGCCA	CASSTTTSTGRGYNEQFF	2
CTGCTGTCGGCTGCTCCCTCCCAGACATCTGTGTACTTCTGTGCCAGCAGTGAAATGCGGGGTAATCAGCCCCAGCATTTTGGTGAT	CASSEMRGNQPQHF	1
TCCCGCTCAGGCTGGAGTTGGCTGCTCCCTCCCAGACATCTGTGTACTTCTGTGCCAGTCTGACGGGTAGGGCAGTACTTCGGGCCG		1
ATCAATTCCCTGGAGCTTGGTGACTCTGCTGTGTATTTCTGTGCCAGCAGCCGACAAGGGCAAGGTTACGAGCAGTACTTCGGGCCG	CASSRQGQGYEQYF	1
CGGTCCACAAAGCTGGAGGACTCAGCCATGTACTTCTGTGCCAGCAGTGAGACCAGGGCGAGCAAAAACATTCAGTACTTCGGCGCC	CASSETRASKNIQYF	1
CGCTCACCAGGCCTGGGGGACGCAGCCATGTACCTGTGTGCCACCAGCAGATCAAAGGGACTAGCGGATGAGCAGTTCTTCGGGCCA	CATSRSKGLADEQFF	1
GAGTCCGCCAGCACCAACCAGACATCTATGTACCTCTGTGCCAGCAGCCCGGACTTTGGGAAAACAGATACGCAGTATTTTGGCCCA	CASSPDFGKTDTQYF	1
AAATCTTCACATCAATTCCCTGGAGCTTGGTGACTCTGCTGTGTATTTCTGTGCCAGCAGTCCCATATAGAGCAGTTCTTCGGGCCA		1
ATCCCCAACCAGACAGCTCTTTACTTCTGTGCCACCAGTGATGGGGGTAGCGGGGTTCGGGGCACAGATACGCAGTATTTTGGCCCA	CATSDGGSGVRGTDTQYF	1
CTGAGCTCTCTGGAGCTGGGGGACTCAGCTTTGTATTTCTGTGCCAGCAGCGTAGGTATGTCGAACACTGAAGCTTTCTTTGGACAA	CASSVGMSNTEAFF	1
ACTCTGACGATCCAGCGCACACAGCAGGAGGACTCGGCCGTGTATCTCTGTGCCAGCAGGACAGGAGAGGAGCAGTACTTCGGGCCG	CASRTGEEQYF	1
GAAGATCCAGCGCACACAGCAGGAGGACTCCGCCGTGTATCTCTGTGCCAGTGGAGGCAGAGGCCACTCGGCTACACCTTCGGTTCG		1
GAGTCGCCCAGCCCCAACCAGACCTCTCTGTACTTCTGTGCCAGCAGTTTTAGGGGTGTTGAGGGCGGGGAGCTGTTTTTTGGAGAA	CASSFRGVEGGELFF	2
TCTAAGAAGCTCCTTCTCAGTGACTCTGGCTTCTATCTCTGTGCCTGGAGTGTCGACTAGCCACGACGCCCTGGGTACTTCGGGCCA	CAWSVD*PRRPGYF	1
AATTCCCTGGAGCTTGGTGACTCTGCTGTGTATTTCTGTGCCAGCAGCCAAGATGGACAGGCCTACTATGGCTACACCTTCGGTTCG	CASSQDGQAYYGYTF	1
ACCTTGGAGCTGGGGGACTCGGCCCTTTATCTTTGCGCCAGCAGCTTGGAGGGTCACAGGGCATCTGAAAAACTGTTTTTTGGCAGT	CASSLEGHRASEKLFF	1
GACGATCCAGCGCACACAGCAGGAGGACTCGGCCGTGTATCTCTGTGCCAGCAGCTCGGACGGATACAGCCCCAGCATTTTGGTGAT		1
CGGTCCACAAAGCTGGAGGACTCAGCCATGTACTTCTGTGCCAGCAGTGAATCGGAGAGCTCCTACAATGAGCAGTTCTTCGGGCCA	CASSESESSYNEQFF	2
TCTCTGGAGCTGGGGGACTCAGCTTTGTATTTCTGTGCCAGCAGCGTAGAGGGACAGGGTATCACAGATACGCAGTATTTTGGCCCA	CASSVEGQGITDTQYF	1
ACAGTGACCAGTGCCCATCCTGAAGACAGCAGCTTCTACATCTGCAGTCCGAAACCGGGACAGGGCTATGGCTACACCTTCGGTTCG	CSPKPGQGYGYTF	2
AGCAACATGAGCCCTGAAGACAGCAGCATATATCTCTGCAGCGTTAGTGGGGACCTCTCGTACCAAGAGACCCAGTACTTCGGGCCA	CSVSGDLSYQETQYF	1
CTGCTGGGGTTGGAGTCGGCTGCTCCCTCCCAAACATCTGTGTACTTCTGTGCCAGCAGCACTCAGAATGAGCAGTTCTTCGGGCCA	CASSTQNEQFF	1
ATCCAGCGCACAGAGCAGGGGGACTCGGCCATGTATCTCTGTGCCAGCAGCTTACAGGGGGCCGGCACTGAAGCTTTCTTTGGACAA	CASSLQGAGTEAFF	1
CGCACAGAGCAGCGGGACTCGGCCATGTATCGCTGTGCCAGCAGCCATCCCGGACTAGCGCGAATCAATGAGCAGTTCTTCGGGCCA	CASSHPGLARINEQFF	1
CGCACACAGCAGGAGGACTCGGCCGTGTATCTCTGTGCCAGCAGCTATATGCCGGGACTGCCTTACAATGAGCAGTTCTTCGGGCCA	CASSYMPGLPYNEQFF	1
ACCCTGGAGTCTGCCAGGCCCTCACATACCTCTCAGTACCTCTGTGCCAGCACCGGACAGACCTCCTACGAGCAGTACTTCGGGCCG	CASTGQTSYEQYF	1
CGCACACAGCAGGAGGACTCGGCCGTGTATCTCTGTGCCAGCAGCTTGAAAACGAGGACGACCCCAGATACGCAGTATTTTGGCCCA	CASSLKTRTTPDTQYF	1
AGTGCCCATCCTGAAGACAGCAGCTTCTACATCTGCAGTGCTAGAGTGCGACTAGCGGGAGGCGGAGAGACCCAGTACTTCGGGCCA	CSARVRLAGGGETQYF	1
CACTCTGAAGATCCAGCCCTCAGAACCCAGGGACTCAGCTGTGTACTTCTGTGCCAGCAGCCGGGGGGGGTCCAGCATTTTGGTGAT		1
ATCAATTCCCTGGAGCTTGGTGACTCTGCTGTGTATTTCTGTGCCAGCAGCCATAGCGAAATCCCCTACGAGCAGTACTTCGGGCCG	CASSHSEIPYEQYF	1
ATACTTCTGTGCCAGCAGTTACCCCCAACGGTCTTGGGGGAGGAAAAGGACTAGCGGGGGAGCACAGATACGCAGTATTTTGGCCCA		1
GGCAATCCTGTCCTCAGAACCGGGAGACACGGCACTGTATCTCTGCGCCAGAGGGAAGCGGGATCAGATACGCAGTATTTTGGCCCA		1
CAGCAGGAGGACTCCGCCGTGTATCTCTGTGCCAGCAGCTTAGGGTCGGAGACAGGGGAAATCCCCTACGAGCAGTACTTCGGGCCA	CASSLGSETGEIPYEQYF	1
ACTGTGACATCGGCCCAAAAGAACCCGACAGCTTTCTATCTCTGTGCCAGTAGTATAGTAGGGTCTACTGAAGCTTTCTTTGGACAA	CASSIVGSTEAFF	2
CAGGTAGTGCGAGGAGATTCGGCAGCTTATTTCTGTGCCAGCTCACCACCTACGCCAGGCCTTAACTATGGCTACACCTTCGGTTCG	CASSPPTPGLNYGYTF	1
CTGGAGTCGCCCAGCCCCAACCAGACCTCTCTGTACTTCTGTGCCAGCAGGGTGGGACAGGGGTCCGGGGAGCTGTTTTTTGGAGAA	CASRVGQGSGELFF	1
GCCCATCCTGAAGACAGCAGCTTCTACATCTGCAGTGCTAGAGATCTGACAGGGAGCGCAACTAATGAAAAACTGTTTTTTGGCAGT	CSARDLTGSATNEKLFF	2
GCAGAGCTTGGGGACTCGGCCGTGTATCTCTGTGCCAGCAGCACCAGACCGGGACTAGGAAAGGGCAATGAGCAGTTCTTCGGGCCA	CASSTRPGLGKGNEQFF	1
CTGCTGTCGGCTGCTCCCTCCCAGACATCTGTGTACTTCTGTGCCAGCAGTTACTCAGGGGCAGGGCGCGAGCAGTACTTCGGGCCG	CASSYSGAGREQYF	1
GAGTCGGCTGCTCCCTCCCAGACATCTGTGTACTTCTGTGCCAGCAGAGAGGGACCGCTGGGTCAGTACGAGCAGTACTTCGGGCCG	CASREGPLGQYEQYF	1
GCGCACAGAGCGGGGGGACTCAGCCGTGTATCTCTGTGCCAGCACCTCCTTTGGACAGGGACTAACTATGGCTACACCTTCGGTTCG		1
TGTCCACTCTGACAGTGACCAGTGCCCATCCTGAAGACAGCAGCTTCTACATCCTTCGGTACCTCCTACGAGCAGTACTTCGGGCCG		1
CCCCTGACCCTGGAGTCTGCCAGGCCCTCACATACCTCTCAGTACCTCTGTGCCAGTGGGGCCTACTATGGCTACACCTTCGGTTCG	CASGAYYGYTF	1
CTAAACCTGAGCTCTCTGGAGCTGGGGGACTCAGCTTTGTATTTCTGTGCCAGCAGCGTAGAGGGGAACACCATATATTTTGGAGAG	CASSVEGNTIYF	1
GAAGACTCGGCCCTGTATCTCTGTGCCAGCAGCCAAGATCAGGCGGGGACAAGTGCGGCAATTGGTGGTGGCTACACCTTCGGTTCG	CASSQDQAGTSAAIGGGYTF	1
ATGAATGTGAGCACCTTGGAGCTGGGGGACTCGGCCCTTTATCTTTGCGCCAGCAGCTTGCCTTCAGAGACCCAGTACTTCGGGCCA	CASSLPSETQYF	2
TTGTTGCTGGGGGACTCGGCCCTCTATCTCTGTGCCAGCAGCCCGGACGGCAGGGCGGGGGTTAATTCACCCCTCCACTTTGGGAAC	CASSPDGRAGVNSPLHF	1
TGAGTGCCTTGGAGCTGGGGGACTCGGCCCTGTATCTCTGTGCCAGAAGCTTGGGGGGCAGGGGAACTGGCCCCCCACTTTGGGAAC		1
GCCCTCAGAACCCAGGGACTCAGCTGTGTACTTCTGTGCCAGCAATAGGTAGGGACTTGTGGGCCGAATGGCTACACCTTCGGTTCG		1
ACATCGGCCCAAAAGAACCCGACAGCTTTCTATCTCTGTGCCAGTAGTATAGGTGGGTCAACACTACAGCCCCAGCATTTTGGTGAT	CASSIGGSTLQPQHF	1
CGCACAGAGCAGCGGGACTCAGCCATGTATCGCTGTGCTAGCAGCCCCCGGACGGATTTTAGCACAGATACGCAGTATTTTGGCCCA	CASSPRTDFSTDTQYF	1
CCAGTCCACGGAGTCAGGGGACACAGCACTGTATTTCTGTGCCAGCAGCATGTATGGACAGAGCAAGAGACCCAGTACTTCGGGCCA		1
GTGCAGCCTGCAGAACTGGAGGATTCTGGAGTTTATTTCTGTGCCAGCAGCCACACCGGGACCCTCACTGAAGCTTTCTTTGGACAA	CASSHTGTLTEAFF	2
CAGCCCCCAGAACCCAGGGACTCAGCTGTGTACTTCTGTGCCAGCAGCCCGGGACAGGGGTTCTCCTACGAGCAGTACTTCGGGCCG	CASSPGQGFSYEQYF	1
AAGATCCAGCGCACAGAGCGGGGGGACTCAGCCGTGTATCTCTGTGCCAGCAGCTTCGACAGAAAAGAGACCCAGTACTTCGGGCCA	CASSFDRKETQYF	2
CATCGGCCCAAAAGAACCCGACAGCTTTCTATCTCTGTGCCAGTAGTAACTAATAGCGGAGAATTCTACGAGCAGTACTTCGGGCCG		1
AGGATCCAGCAGGTAGTGCGAGGAGATTCGGCAGCTTATTTCTGTGCCAGCTCACCAGGGACAGACTATGGCTACACCTTCGGTTCG	CASSPGTDYGYTF	1
CACCTTGGAGCTGGGGGACTCGGCCCTTTATCTTTGCGCCAGCAGCTGGGGCTCAGGGAACTCGATCAGCCCCAGCATTTTGGTGAT		1
CCAGTGCCCATCCTGAAGACAGCAGCTTCTACATCTGCAGTGCTAGGAGGGACTACACCACCAACCTACGAGCAGTACTTCGGGCCG		1
ATCCAGCGCACAGAGCGGGGGGACTCAGCCGTGTATCTCTGTGCCAGCAGCAAAGACAGGGGGCCCGGGGAGCTGTTTTTTGGAGAA	CASSKDRGPGELFF	1
TCGCCCAGCCCCAACCAGACCTCTCTGTACTTCTGTGCCAGCAGTTTATCGGGACAGCTACGCTCCTACGAGCAGTACTTCGGGCCG	CASSLSGQLRSYEQYF	1
ACAGTGACCAGTGCCCATCCTGAAGACAGCAGCTTCTACATCTGCAGTGCTGTTAGACTAGCGGGAAATGAGCAGTTCTTCGGGCCA	CSAVRLAGNEQFF	1
ATCCAGCCTGCAAAGCTTGAGGACTCGGCCGTGTATCTCTGTGCCAGCAGCTTAGGACAGGGTACCTACGAGCAGTACTTCGGGCCG	CASSLGQGTYEQYF	2
AATTCCCTGGAGCTTGGTGACTCTGCTGTGTATTTCTGTGCCAGCAGCCAACAAGCGTATAGCAATCAGCCCCAGCATTTTGGTGAT	CASSQQAYSNQPQHF	1
GGAGATCCAGTCCACGGAGTCAGGGGACACAGCACTGTATTTCTGTGCGAACGGGACAGGGTACCCTACGAGCAGTACTTCGGGCCA		1
ACCAGTGCCCATCCTGAAGACAGCAGCTTCTACATCTGCAGTGCTAGGCCGGGACTGGGGGGGAATCAGCCCCAGCATTTTGGTGAT	CSARPGLGGNQPQHF	1
CTGACAGTGACCAGTGCCCATCCTGAAGACAGCAGCTTCTACATCTGCAGTGCCACCCGGGGGGGGTGGGAGCAGTACTTCGGGCCG	CSATRGGWEQYF	1
GAGATCCAGCGCACAGAGCAGGGGGACTCGGCCATGTATCTCTGTGCCAGCAGTCCAGCGGCTAACTATGGCTACACCTTCGGTTCG	CASSPAANYGYTF	1
CAGCGCACAGAGCAGGGGGACTCGGCCATGTATCTCTGTGCCAGCAGCCTCCTAGCGGGAGTGGAAAATGAGCAGTTCTTCGGGCCA	CASSLLAGVENEQFF	1
AGTGCCCATCCTGAAGACAGCAGCTTCTACATCTGCAGTGCTAGACCGAAACTAGCGGGAGTAACAGATGAGCAGTTCTTCGGGCCA	CSARPKLAGVTDEQFF	1
GAGTCGGCTGCTCCCTCCCAGACATCTGTGTACTTCTGTGCCAGCAGTGGATTAGCGGGGGGCATCGATGAGCAGTTCTTCGGGCCA	CASSGLAGGIDEQFF	1
TTGCTGGGGGACTCGGCCCTCTATCTCTGTGCCAGCAGCCGTTAAAAAGGGACAGGGCTAACAAATCAGCCCCAGCATTTTGGTGAT	CASSR*KGTGLTNQPQHF	1
GCCCTGCAGCCAGAAGACTCAGCCCTGTATCTCTGCGCCAGCAGCCAAGATGGGATAGCGGGAGCCGATACGCAGTATTTTGGCCCA	CASSQDGIAGADTQYF	1
ACTCTGGAGTCCGCTACCAGCTCCCAGACATCTGTGTACTTCTGTGCCATCAGTGCCCGGGACAGATATGGCTACACCTTCGGTTCG	CAISARDRYGYTF	1
ACCAGTGCCCATCCTGAAGACAGCAGCTTCTACATCTGCAGTGCTAACAGGCGGGGGGCATATCAAGAGACCCAGTACTTCGGGCCA	CSANRRGAYQETQYF	4
ATTCCCTGGAGCTTGGTGACTCTGCTGTGTATTTCTGTGCCAGCAGCCAGTCTAGCGGGAGGGACCGGGGAGCTGTTTTTTGGAGAA		1
TGGAGTCAGCTACCCGCTCCCAGACATCTGTGTATTTCTGCGCCAGCAGTGAGTCGAAGGACAGGGGCTGAAGCTTTCTTTGGACAA		1
CTGACAGTGACCAGTGCCCATCCTGAAGACAGCAGCTTCTACATCTGCAGTGCTAGTGCTGGCCAAGAGACCCAGTACTTCGGGCCA	CSASAGQETQYF	1
CTAGAGTCTGCCATCCCCAACCAGACAGCTCTTTACTTCTGTGCCACTACCCGGACTAGATCGGCCCACGAGCAGTACTTCGGGCCG	CATTRTRSAHEQYF	1
ACCAGTGCCCATCCTGAAGACAGCAGCTTCTACATCTGCAGTGCTAAAAGGCAGGGGGAGATTAGTCAGCCCCAGCATTTTGGTGAT	CSAKRQGEISQPQHF	1
TTGGAGCTGGGGGACTCGGCCCTTTATCTTTGCGCCAGCAGCTTGAAGTCAGACAGTGTGATGAACACTGAAGCTTTCTTTGGACAA	CASSLKSDSVMNTEAFF	1
TCCGCCAGCACCAACCAGACATCTATGTACCTCTGTGCCAGCAGTTTATGGCAAGCCACGCTCACAGATACGCAGTATTTTGGCCCA	CASSLWQATLTDTQYF	1
CTGGAGTCCGCCAGCACCAACCAGACATCTATGTACCTCTGTGCCAGCAGTCTCCGGGAGGGCCGGGGTGAGCAGTACTTCGGGCCG	CASSLREGRGEQYF	1
CCCAGCCCCAACCAGACCTCTCTGTACTTCTGTGCCAGCAGTTTAGACAGTTTCTTCTATACGGCCAATGAGCAGTTCTTCGGGCCA	CASSLDSFFYTANEQFF	1
TCTCTGGAGCTGGGGGACTCAGCTTTGTATTTCTGTGCCAGCAGCGGGCTAGCGGGAGTTGGGGCAGATACGCAGTATTTTGGCCCA	CASSGLAGVGADTQYF	1
AAGATCCAGCGCACACAGCAGGAGGACTCCGCCGTGTATCTCTGTGCCAGCAGCTTGGGACAGTCCTACGAGCAGTACTTCGGGCCG	CASSLGQSYEQYF	1
TGTACCCTCTCAGACATCTGTGTACTTCTGTGCCAGCAGTGACACCAGACAGGTTAGGTAGTGTCCTACGAGCAGTACTTCGGGCCG		1
CTGGAGCTGGGGGACTCAGCTTTGTATTTCTGTGCCAGCAGCGTATCCCCTCGGGGAACGAACACCGGGGAGCTGTTTTTTGGAGAA	CASSVSPRGTNTGELFF	1
TGACCCTGGAGTCTGCCAGGCCCTCACATACCTCTCAGTACCTCTGTGCCAGCACCAGGCCCAAACACTGAAGCTTTCTTTGGACAA		1
CACCTACACACCCTGCAGCCAGAAGACTCGGCCCTGTATCTCTGCGCCAGCAGCCCGGGGGTGGTCAATGAGCAGTTCTTCGGGCCA	CASSPGVVNEQFF	1
AGCCCCAACCAGACCTCTCTGTACTTCTGTGCCAGCAGTTTGGGACAGGGTGGGGGACTAGCGTACAATGAGCAGTTCTTCGGGCCA	CASSLGQGGGLAYNEQFF	1
GAGTCGGCTGCTCCCTCCCAGACATCTGTGTACTTCTGTGCCAGCAGAGCCCCGGCAGGACAGGGGGAAGGCTACACCTTCGGTTCG	CASRAPAGQGEGYTF	1
CTGGAGTCGGCTGCTCCCTCCCAGACATCTGTGTACTTCTGTGCCAGCAGTTACTCGCCGGGAGGCACTGAAGCTTTCTTTGGACAA	CASSYSPGGTEAFF	1
ACAGAGCAGGGGGACTCGGCCATGTATCTCTGTGCCAGCAGCCCCCCGGGGACAGGCGGTCTTCTAAACATTCAGTACTTCGGCGCC	CASSPPGTGGLLNIQYF	1
ATCAATTCCCTGGAGCTTGGTGACCCTGCTGTGTATTTCTGTGCCAGCAGCCAGGGGGACAGGGCCGGGACCCAGTACTTCGGGCCA	CASSQGDRAGTQYF	13
GCCTTGTTGCTGGGGGACTCGGCCCTCTATCTCTGTGCCAGCAGCCCAAACCTACAGGGGTGGGAAGAGACCCAGTACTTCGGGCCA	CASSPNLQGWEETQYF	1
CCCAGCCCCAACCAGACCTCTCTGTACTTCTGTGCCAGCAGTTTAAGAGGTGGGTACGGGGTGAACACTGAAGCTTTCTTTGGACAA	CASSLRGGYGVNTEAFF	1
TCACCTACACGCCCTGCAGCCAGAAGACTCAGCCCTGTATCTCTGCGCCAGCAGCCAAGATCTTACCACGAGCAGTACTTCGGGCCG		1
TTGGAGCTGGGGGACTCGGCCCTTTATCTTTGCGCCAGCAGCTTCACCGGACTAGCGGGAGTATACAATGAGCAGTTCTTCGGGCCA	CASSFTGLAGVYNEQFF	1
GTGACATCGGCCCAAAAGAACCCGACAGCTTTCTATCTCTGTGCCAGTAGGGGGCAGCACAGCTCCTACGAGCAGTACTTCGGGCCG	CASRGQHSSYEQYF	1
AAGATCCAGCCCTCAGAACCCAGGGACTCAGCTGTGTACTTCTGTGCCAGCAGGGGGACAGGTTCCTACGAGCAGTACTTCGGGCCG	CASRGTGSYEQYF	1
CTGAAGATCCAGCCCTCAGAACCCAGGGACTCAGCTGTGTACTTCTGTGCCAGCAGTTTAACCACCGGGGAGCTGTTTTTTGGAGAA	CASSLTTGELFF	1
ACCTTGGAGCTGGGGGACTCGGCCCTTTATCTTTGCGCCAGCAGCCTACAGGGGTCCCCGGGTAGCACTGAAGCTTTCTTTGGACAA	CASSLQGSPGSTEAFF	1
ACCAGTGCCCATCCTGAAGACAGCAGCTTCTACATCTGCAGTGCTACCTTGACAGGGCTAGGCAATTCACCCCTCCACTTTGGGAAC	CSATLTGLGNSPLHF	1
CTCAAGATCCAGCCTGCAAAGCTTGAGGACTCGGCCGTGTATCTCTGTGCCAGCAGCTTCATAGCTGGCGAGCAGTACTTCGGGCCG	CASSFIAGEQYF	1
GAGTCAGCTACCCGCTCCCAGACATCTGTGTATTTCTGCGCCAGCAGTGAGTCGGGCAGAACGAACACTGAAGCTTTCTTTGGACAA	CASSESGRTNTEAFF	1
ACTCTGAAGATCCAGCCCTCAGAACCCAGGGACTCAGCTGTGTACTTCTGTGCCAGCAGCATACAACGAGAGCAGTTCTTCGGGCCA	CASSIQREQFF	1
ATCAATTCCCTGGAGCTTGGTGACTCTGCTGTGTATTTCTGTGCCAGTTCTCCCGGTACTTCCACAGATACGCAGTATTTTGGCCCA	CASSPGTSTDTQYF	1
ACGCCTTGTTGCTAGGGGACTCGGCCCTCTATCTCTGTGCCAGCAGCTTCCAGGGGAAGAAGCTCCTACGAGCAGTACTTCGGGCCG		1
CAGCAGGTAGTGCGAGGAGATTCGGCAGCTTATTTCTGTGCCAGCTCATCCGATATCACGGGGACCGGGGAGCTGTTTTTTGGAGAA	CASSSDITGTGELFF	1
GAGTCGGCTGCTCCCTCCCAAACATCTGTGTACTTCTGTGCCAGCAGGTCGGGACAGGGAGGAGTCTATGGCTACACCTTCGGTTCG	CASRSGQGGVYGYTF	1
CTGTCGGCTGCTCCCTCCCAGACATCTGTGTACTTCTGTGCCAGCAGTTACTCCCAAGACAGGGAATACGAGCAGTACTTCGGGCCG	CASSYSQDREYEQYF	2
ACCTGAGCTCTCTGGAGCTGGGGGACTCAGCTTTGTATTTCTGTGCCAGCAGAGGACGGAAACAGCTATGGCTACACCTTCGGTTCG		1
GTCGGCTGCTCCCTCCCAGACATCTGTGTACTTCTGTGCCATCCTTAGGGGGGAAGTGGGATCTATCAGCCCCAGCATTTTGGTGAT		2
CTGCTGTCGGCTGCTCCCTCCCAGACATCTGTGTACTTCTGTGCCAGCAGTTCCGGCTTTTTGGTAAATGAGCAGTTCTTCGGGCCA	CASSSGFLVNEQFF	1
GTGACATCGGCCCAAAAGAACCCGACAGCTTTCTATCTCTGTGCCAGTCAAAGACTAGCCGTTAACAATGAGCAGTTCTTCGGGCCA	CASQRLAVNNEQFF	1
AAGATCCAGCGCACAGAGCGGGGGGACTCAGCCGTGTATCTCTGTGCCAGCAGCCATGGGGGGGGACGAGGCTACACCTTCGGTTCG	CASSHGGGRGYTF	1
CTGATTCTGGAGTCCGCCAGCACCAACCAGACATCTATGTACCTCTGTGCCAGCAGAGAGAGTACCGGGGAGCTGTTTTTTGGAGAA	CASRESTGELFF	1
AGCTCTCTGGAGCTGGGGGACTCAGCTTTGTATTTCTGTGCCAGCAGCGTTTCGGGGGGGAACACCGGGGAGCTGTTTTTTGGAGAA	CASSVSGGNTGELFF	1
CAGCCTGCAAAGCTTGAGGACTCGGCCGTGTATCTCTGTGCCAGCAGGGTCCAGGGTAGCCTAGGGCTCGAGCAGTACTTCGGGCCG	CASRVQGSLGLEQYF	1
AGGCTGCTGTCGGCTGCTCCCTCCCAGACATCTGTGTACTTCTGTGCCAGCAGTTACGTCCTAGGCTACGAGCAGTACTTCGGGCCG	CASSYVLGYEQYF	1
AGTGCCCATCCTGAAGACAGCAGCTTCTACATCTGCAGTGCTTTTTTTGCCCTAGCGGGTCTCCACAATGAGCAGTTCTTCGGGCCA	CSAFFALAGLHNEQFF	1
CTTGGTGACTCTGCTGTGTATTTCTGTGCCAGCAGCCAAGGCCTAGCGGGAGGGTAAACTAGCACAGATACGCAGTATTTTGGCCCA	CASSQGLAGG*TSTDTQYF	1
TCTAAGAAGCTCCTTCTCAGTGACTCTGGCTTCTATCTCTGTGCCTGGAGTGCAGGGAGGGTTGGTGAAAAACTGTTTTTTGGCAGT	CAWSAGRVGEKLFF	1
TCGGCTGCTCCCTCCCAGACATCTGTGTACTTCTGTGCCAGCAGTTACTCTCTAGCGGGGGATAATGATGAGCAGTTCTTCGGGCCA	CASSYSLAGDNDEQFF	1
AAGATCCAGCCCTCAGAACCCAGGGACTCAGCTGTGTACTTCTGTGCCAGCAGTTTAAGTGGTTTCGGGGAGCTGTTTTTTGGAGAA	CASSLSGFGELFF	1
CGCACACAGCAGGAGGACTCCGCCGTGTATCTCTGTGCCAGCAGCTTAGACAGGGTGAACTCTGGAAACACCATATATTTTGGAGAG	CASSLDRVNSGNTIYF	1
AGGCCCTCACATACCTCTCAGTACCTCTGTGCCAGCAGCGGCGATTGGACTAGCGGGGGCCGCACAGATACGCAGTATTTTGGCCCA	CASSGDWTSGGRTDTQYF	1
CTGCTGTCGGCTGCTCCCTCCCAGACATCTGTGTACTTCTGTGCCAGCAGTTACAGGCGGACAGGGGGGGGCTACACCTTCGGTTCG	CASSYRRTGGGYTF	2
AGTGCCCATCCTGAAGACAGCAGCTTCTACATCTGCAGTGCTAGAGGGGAGCTAGCGGGGCCTTACAATGAGCAGTTCTTCGGGCCA	CSARGELAGPYNEQFF	2
GTGCAGCCTGCAGAACTGGAGGATTCTGGAGTTTATTTCTGTGCCAGCAGCCAAGTTCCCGGGACCGGGGAGCTGTTTTTTGGAGAA	CASSQVPGTGELFF	1
ACAGTGACCAGTGCCCATCCTGAAGACAGCAGCTTCTACATCTGCAGTGCCCTAGCGGAGCACTACAATGAGCAGTTCTTCGGGCCA	CSALAEHYNEQFF	1
TGTGAGCACCTTGGAGCTGGGGGACTCGGCCCTTTATCTTTGCGCCAGCAGCTTGGCGGGCTGTTATATGGCTACACCTTCGGTTCG		1
TCGGCCCAAAAGAACCCGACAGCTTTCTATCTCTGTGCCAGTAGTATAGATGGGACAGGGGAGAACACTGAAGCTTTCTTTGGACAA	CASSIDGTGENTEAFF	3
AGCACCTTGGAGCTGGGGGACTCGGCCCTTTATCTTTGCGCCAGCAGCTTCAGTCAGGGGAGGACAGATACGCAGTATTTTGGCCCA	CASSFSQGRTDTQYF	1
TCTAAGAAGCTCCTTCTCAGTGACTCTGGCTTCTATCTCTGTGCCTGGAGTGTGTCCCGATGGGGTGAAAAACTGTTTTTTGGCAGT	CAWSVSRWGEKLFF	2
GTGAGCACCTTGGAGCTGGGGGACTCGGCCCTTTATCTTTGCGCCAGCAGCCTAGCCGGGACTAGCTTTGAGCAGTACTTCGGGCCG	CASSLAGTSFEQYF	1
CTGTCGGCTGCTCCCTCCCAGACATCTGTGTACTTCTGTGCCAGCAGTTACTCCTCCCAGGGGCTGGAAAAACTGTTTTTTGGCAGT	CASSYSSQGLEKLFF	2
CACGCCCTGCAGCCAGAAGACTCAGCCCTGTATCTCTGCGCCAGCAGCCAAGATTCGGGGGGGGCCTACGAGCAGTACTTCGGGCCG	CASSQDSGGAYEQYF	2
CGGAGTCAGGGGACACAGCACTGTATTTCTGTGCCAGCAGCCCTGACGCCGTGCGTTCCTAGCACAGATACGCAGTATTTTGGCCCA		2
CTGGAGCTGGGGGACTCAGCTTTGTATTTCTGTGCCAGCAGCGTAGAGGCTAGCGGAGATAGCACAGATACGCAGTATTTTGGCCCA	CASSVEASGDSTDTQYF	1
ATCCAGCGCACAGAGCGGGGGGACTCAGCCGTGTATCTCTGTGCCAGCAGCCCCCAACCGAGCTCCTACGAGCAGTACTTCGGGCCG	CASSPQPSSYEQYF	1
ACTCTGACTGTGAGCAACATGAGCCCTGAAGACAGCAGCATATATCTCTGCAGCGTTGTGATTAGCACTGAAGCTTTCTTTGGACAA	CSVVISTEAFF	2
CCTCTCACTGTGACATCGGCCCAAAAGAACCCGACAGCTTTCTATCTCTGTGCCAGTAGTATCTCAGATACGCAGTATTTTGGCCCA	CASSISDTQYF	1
ACAGTGACCAGTGCCCATCCTGAAGACAGCAGCTTCTACATCTGCAGTGCTAGCCAAGATAGCAATCAGCCCCAGCATTTTGGTGAT	CSASQDSNQPQHF	1
CCCCTGATCCTGGAGTCGCCCAGCCCCAACCAGACCTCTCTGTACTTCTGTGCCAGCAGTTTATACTACGAGCAGTACTTCGGGCCG	CASSLYYEQYF	2
ATCCAGTCCACGGAGTCAGGGGACACAGCACTGTATTTCTGTGCCAGCTACTCCGGGACAGACAATCAGCCCCAGCATTTTGGTGAT	CASYSGTDNQPQHF	3
CACATCAATTCCCTGGAGCTTGGTGACTCTGCTGTGTATTTCTGTGCCAGCAGCCCCGCCGGCACAGATACGCAGTATTTTGGCCCA	CASSPAGTDTQYF	1
TCTAAGAAGCTCCTTCTCAGTGACTCTGGCTTCTATCTCTGTGCCGGAAGAAGAAATACTGGGGCCAACGTCCTGACTTTCGGGGCC	CAGRRNTGANVLTF	4
ACTCTGGAGTCCGCTACCAGCTCCCAGACATCTGTGTACTTCTGTGCCATGAAACAGGGGGCGGGAGAGACCCAGTACTTCGGGCCA	CAMKQGAGETQYF	1
CCTCTCACTGTGACATCGGCCCAAAAGAACCCGACAGCTTTCTATCTCTGTGCCGGGACAGGGGGCAATGAGCAGTTCTTCGGGCCA	CAGTGGNEQFF	1
CTGCTGTCGGCTGCTCCCTCCCAGACATCTGTGTACTTCTGTGCCAGCAGTTACGGGGGGCGCGGTCAGCCCCAGCATTTTGGTGAT	CASSYGGRGQPQHF	1
CTCAGGCTGGAGTTGGCTGCTCCCTCCCAGACATCTGTGTACTTCTGTGCCAGCAGTATCGTGGGGCCTGAAGCTTTCTTTGGACAA	CASSIVGPEAFF	1
GAGTCGGCTGCTCCCTCCCAAACATCTGTGTACTTCTGTGCCAGCAGTCAACCGGGACTAGGGGTGGATGAGCAGTTCTTCGGGCCA	CASSQPGLGVDEQFF	2
ACATCGGCCCAAAAGAACCCGACAGCTTTCTATCTCTGTGCCAGTAGTATGGGGACTGTACTGTACAATGAGCAGTTCTTCGGGCCA	CASSMGTVLYNEQFF	1
TGCCATCCCCAACCAGACAGCTCTTTACTTCTGTGCCACCATCGCAGGGACTAGCGGGAGTAACCCTACGAGCAGTACTTCGGGCCG		1
CCTGAAGACAGCAGCTTCTACATCTGCAGTGCTAGAGTGGGGGGACTAGCGGGTGACAGCTCCTACAATGAGCAGTTCTTCGGGCCA	CSARVGGLAGDSSYNEQFF	1
GCGCACACAGCAGGAGGACTCGGCCGTGTATCTCTGTGCCAGCAGCAGGGGGGGGGACAGGGCACAGATACGCAGTATTTTGGCCCA		1
ACGGAGTCAGGGGACACAGCACTGTATTTCTGTGCCAGCACCGGATAACTAGCGGGAGCCCTCTCCTACGAGCAGTACTTCGGGCCG	CASTG*LAGALSYEQYF	1
CTCAGCCCTGTATCTCTGCGCCAGCAGCCAAGCGCGGGCCAGATTTTACGGGGGACTCTGCTACCCTACGAGCAGTACTTCGGGCCG		1
CTGGAGTCCGCCAGCACCAACCAGACATCTATGTACCTCTGTGCCAGCAGTTTCCGAGAATACACCGGGGAGCTGTTTTTTGGAGAA	CASSFREYTGELFF	12
ACTCTGAAGATCCAGCGCACACAGCAGGAGGACTCCGCCGTGTATCTCTGTGCCAGCAGCCTGATGGGACCCCAGTACTTCGGGCCA	CASSLMGPQYF	1
CACACCCTGCAGCCAGAAGACTCGGCCCTGTATCTCTGTGCCAGCAGCCAAGGGGGGGCCGGATCAGCGCAGCAGTTCTTCGGGCCA	CASSQGGAGSAQQFF	1
CAGCCCCAACCAGACCTCTCTGTACTTCTGTGCCAGCACCCCCCCTTGGGTGTAGCGGGAGAGTCCTACGAGCAGTACTTCGGGCCG		1
GAGTTGGCTGCTCCCTCCCAGACATCTGTGTACTTCTGTGCCAGCAGTTACGGTCAGGTCAGCTCCTACGAGCAGTACTTCGGGCCG	CASSYGQVSSYEQYF	1
TGCAGAGCTTGGGGACTCGGCCATGTATCTCTGTGCCAGCAGCTCCAACTAACTAGCGGGACGACCTACGAGCAGTACTTCGGGCCG		1
CGGTCCACAAAGCTGGAGGACTCAGCCATGTACTTCTGTGCCAGCCTTTCCGGGACTAGGTCACCCAATGAGCAGTTCTTCGGGCCA	CASLSGTRSPNEQFF	1
AACGCCTTGTTGCTGGGGGACTCGGCCCTGTATCTCTGTGCCAGCAGCCCAACCGAGCGGACAGGGGGTGGCTACACCTTCGGTTCG	CASSPTERTGGGYTF	1
CGTCTGCTGTACCCTCTCAGACATCTGTGTACTTCTGTGCCAGCAGTGGCCTTCGTGGCGGCGAACACTGAAGCTTTCTTTGGACAA		1
ACCCTGCAGCCAGAAGACTCGGCCCTGTATCTCTGTGCCAGCAGCCAAGAAGGGCCGGTTCTTGGCGGGGAGCTGTTTTTTGGAGAA	CASSQEGPVLGGELFF	1
CTTGAGGACTCGGCCGTGTATCTCTGTGCCAGCAGCTTACGCGCGGGAGTTGGGGTCTTAGAGGGAGAGACCCAGTACTTCGGGCCA	CASSLRAGVGVLEGETQYF	1
ACGGAGTCAGGGGACACAGCACTGTATTTCTGTGCCAGCAGCAAAGGTCTATTGCCCACACACACAGATACGCAGTATTTTGGCCCA	CASSKGLLPTHTDTQYF	1
AATGTGAGCACCTTGGAGCTGGGGGACTCGGCCCTTTATCTTTGCGCCAGCAGCTTTCAATTTACAGATACGCAGTATTTTGGCCCA	CASSFQFTDTQYF	5
CAGCCTGCAGAACTGGAGGATTCTGGAGTTTATTTCTGTGCCAGCAGCCAATGGGACAGGGACAATTCACCCCTCCACTTTGGGAAC	CASSQWDRDNSPLHF	3
GAGTCCGCCAGCACCAACCAGACATCTATGTACCTCTGTGCCAGCAGTTTATCTCCGGGAACTGGAAACACCATATATTTTGGAGAG	CASSLSPGTGNTIYF	1
GCTGGAGTCGGCTGCTCCCTCCCAGACATCTGTGTACTTCTGTGCCAGCACCTACAGGGTCAAAATTCACCCCTCCACTTTGGGAAC		2
CCAGCCCCAACCAGACCTCTCTGTACTTCTGTGCCAGCAGTCTATTTACAACAGCGGGACACCACATACGAGCAGTACTTCGGGCCG		1
CTGTCGGCTGCTCCCTCCCAGACATCTGTGTACTTCTGTGCCAGCAGTTCCTTGGGAGGTAGCTCCTACGAGCAGTACTTCGGGCCG	CASSSLGGSSYEQYF	1
CAGCGCACACAGCAGGAGGACTCGGCCGTGTATCTCTGTGCCAGCAGCCCAGGGTGGAGGGCCGAGGGTGAGCAGTTCTTCGGGCCA	CASSPGWRAEGEQFF	1
TCCACGGAGTCAGGGGACACAGCACTGTATTTCTGTGCCAGCAGCAAAGGGGGGGGCCCCAGCTCCTACGAGCAGTACTTCGGGCCG	CASSKGGGPSSYEQYF	1
CTACACACCCTGCAGCCAGAAGACTCGGCCCTGTATCTCTGCGCCAGCAGCCGGACAGCCAGTAACTATGGCTACACCTTCGGTTCG	CASSRTASNYGYTF	1
GTGAGCACCTTGGAGCTGGGGGACTCGGCCCTTTATCTTTGCGCCAGCAGCCTAACGACGACAGGGGGTAAACAGTACTTCGGGCCG	CASSLTTTGGKQYF	2
CTGCTGTCGGCTGCTCCCTCCCAGACATCTGTGTACTTCTGTGCCACCAGGACTAGCGGGAGGCAAGAGACCCAGTACTTCGGGCCA	CATRTSGRQETQYF	14
CCTGCAAAGCTTGAGGACTCGGCCGTGTATCTCTGTGCCAGCAGCTTAGATGGGCAGGGTTTGAACACTGAAGCTTTCTTTGGACAA	CASSLDGQGLNTEAFF	1
TGGAGCTGGGGGACTCGGCCCTTTATCTTTGCGCCAGCAGCTTGGACCTGGGGGCAGGGCACTAATGAAAAACTGTTTTTTGGCAGT		1
AATTCCCTGGAGCTTGGTGACTCTGCTGTGTATTTCTGTGCCAGCAGCCGCCCCGGGACAGGGGGGAACAAGCAGTACTTCGGGCCA	CASSRPGTGGNKQYF	1
CAGCGCACAGAGCAGGGGGACTCGGCCATGTATCTCTGTGCCAGCAGCCCCCTAGGGACTAGCTACAATGAGCAGTTCTTCGGGCCA	CASSPLGTSYNEQFF	1
CTGCTGTCGGCTGCTCCCTCCCAGACATCTGTGTACTTCTGTGCCAGCAGTAGGGACAGGGGCTACAATGAGCAGTTCTTCGGGCCA	CASSRDRGYNEQFF	1
