nucleotide	aminoAcid	estimatedNumberGenomes
CCCCTGATCCTGGAGTCGCCCAGCCCCAACCAGACCTCTCTGTACTTCTGTGCCAGCCGGGGCCACTACGAGCAGTACTTCGGGCCG	CASRGHYEQYF	2
ATTCTGGAGTCCGCCAGCACCAACCAGACATCTATGTACCTCTGTGCCAGCAGACAACTAGCTCCCGGGGAGCTGTTTTTTGGAGAA	CASRQLAPGELFF	1
ATCCAGCGCACAGAGCAGGGGGACTCGGCCATGTATCTCTGTGCCAGCAGTCCGGGACTAGCCTCCTACGAGCAGTACTTCGGGCCG	CASSPGLASYEQYF	1
GAGTCGCCCAGCCCCAACCAGACCTCTCTGTACTTCTGTGCCAGCAGTTTTCAGGGTTGGGGCTCCTACGAGCAGTACTTCGGGCCG	CASSFQGWGSYEQYF	1
GTCTGCTGTACCCTCTCAGACATCTGTGTACTTCTGTGCCAGCAGTGTTCGACACCTAGACAGTGAGGCGGCTACACCTTCGGTTCG		1
CTGCTGTCGGCTGCTCCCTCCCAGACATCTGTGTACTTCTGTGCCAGCAGATACACCGACGCCTCCTACGAGCAGTACTTCGGGCCG	CASRYTDASYEQYF	1
CGGTCCACAAAGCTGGAGGACTCAGCCATGTACTTCTGTGCCAGCGGGGCAACTAGCGGGGGGTCCAATGAGCAGTTCTTCGGGCCA	CASGATSGGSNEQFF	1
GCCTTGGAGCTGGACGACTCGGCCCTGTATCTCTGTGCCAGCAGCTTGGGTTCGGGAGGCCACTCCTACGAGCAGTACTTCGGGCCG	CASSLGSGGHSYEQYF	2
ATCCAGCGCACAGAGCAGGGGGACTCGGCCATGTATCTCTGTGCCAGCAGCTTTGGGACAGGGCAATACGAGCAGTACTTCGGGCCG	CASSFGTGQYEQYF	1
AAGATCCAGCCTGCAAAGCTTGAGGACTCGGCCGTGTATCTCTGTGCCAGCAGCCCGGCGGGGGGCTATGGCTACACCTTCGGTTCG	CASSPAGGYGYTF	2
TGGAGCTTGGTGACTCTGCTGTGTATTTCTGTGCCAGCAGCCTGTCTTATAGCGGGAGGGGGTGGAGAGACCCAGTACTTCGGGCCA		1
TCCCCCTCAAGCTGGAGTCAGCTGCTCCCTCTCAGACTTCTGTTTACTTCTGTGCCAGGTCCCATCGGGGGCTACACCTTCGGTTCG		2
AGGCTGCTGTCGGCTGCTCCCTCCCAGACATCTGTGTACTTCTGTGCCAGCAGTTGGTACCGGTAGGTGACCCAGTACTTCGGGCCA	CASSWYR*VTQYF	2
GTGAGCACCTTGGAGCTGGGGGACTCGGCCCTTTATCTTTGCGCCAGCAGCGATCTGTCGTACCAAGAGACCCAGTACTTCGGGCCA	CASSDLSYQETQYF	1
TCGGCTGCTCCCTCCCAGACATCTGTGTACTTCTGTGCCAGCAGTCCTTCATGGGGGCGAGAATATCAGCCCCAGCATTTTGGTGAT	CASSPSWGREYQPQHF	1
CAGCAGGTAGTGCGAGGAGATTCGGCAGCTTATTTCTGTGCCAGCTCCCAACGCGGGGGGCCCACCGGGGAGCTGTTTTTTGGAGAA	CASSQRGGPTGELFF	1
ATCCGGTCCACAAAGCTGGAGGACTCAGCCATGTACTTCTGTGCCAGCACCCGGGATTCCTCCTACAATGAGCAGTTCTTCGGGCCA	CASTRDSSYNEQFF	5
CTGGAGTCGCCCAGCCCCAACCAGACCTCTCTGTACTTCTGTGCCAGCACTCCGAGGGGTAGCTCCTACGAGCAGTACTTCGGGCCA	CASTPRGSSYEQYF	1
ATCCAGCGCACAGAGCGGGGGGACTCAGCCGTGTATCTCTGTGCCAGCAGCTTAGGGACTAGCTATAATGAGCAGTTCTTCGGGCCA	CASSLGTSYNEQFF	1
GAGTTGGCTGCTCCCTCCCAGACATCTGTGTACTTCTGTGCCAGCAGTTACGGCGGGTGGGCCCAAGAGACCCAGTACTTCGGGCCA	CASSYGGWAQETQYF	1
GAACGCCTTGGAGCTGGACGACTCGGCCCTGTATCTCTGTGCCAGCAGCACTCGGACCAGAGCACAGATACGCAGTATTTTGGCCCA		1
TTGGAGTCGGCTGCTCCCTCCCAAACATCTGTGTACTTCTGTGCCAGCAGTTACAGGGTCTACACCAGGGAGCTGTTTTTTGGAGAA	CASSYRVYTRELFF	1
CTGACTGTGAGCAACATGAGCCCTGAAGACAGCAGCATATATCTCTGCAGCGTTGGACAGGGAAATGGTAATCAGTACTTCGGCGCC	CSVGQGNGNQYF	1
GTGAGCAACATGAGCCCTGAAGACAGCAGCATATATCTCTGCAGCGTTGAGGTCCGGGAGAGAGGGTACGAGCAGTACTTCGGGCCG	CSVEVRERGYEQYF	1
CAGCCCTCAGAACCCAGGGACTCAGCTGTGTACTTCTGTGCCAGCAGGCAAGGACAGGCAATGGCCGGGGAGCTGTTTTTTGGAGAA	CASRQGQAMAGELFF	1
AGCTCCTTGGAGCTGGGGGACTCAGCCCTGTACTTCTGTGCCAGCAGCTCCTCCGAGGGCGAGCGGGCCATTCAGTACTTCGGCGCC	CASSSSEGERAIQYF	1
ATCCGGTCCACAAAGCTGGAGGACTCAGCCATGTACTTCTGTGCCACGGACCCGGCCACGGGGTGACAGCCCCAGCATTTTGGTGAT	CATDPATG*QPQHF	2
CAGCGCACAGAGCAGGGGGACTCGGCCATGTATCTCTGTGCCAGCAGCTCGGGTCCGGGTATGTACAATGAGCAGTTCTTCGGGCCA	CASSSGPGMYNEQFF	1
TCACGTTGGCGTCTGCTGTACCCTCTCAGACATCTGTGTACTTCTGTGCCAGCAGGAGTCTTTCCCTACGAGCAGTACTTCGGGCCG		1
AACGCCTTGTTGCTGGGGGACTCGGCCCTCTATCTCTGTGCCAGCAGCTCTCCACTTTACCCCGACTATGGCTACACCTTCGGTTCG	CASSSPLYPDYGYTF	1
CAAAGCTGGAGGACTCAGCCATGTACTTCTGTGCCAGCAGTTACCGGGACAGGGGAAAATTAAAACTATGGCTACACCTTCGGTTCG		2
GCCAGCACCAACCAGACATCTATGTACCTCTGTGCCAGCAGTTCAGGGACAGGGCGACTCTTAGGAAATGGCTACACCTTCGGTTCG	CASSSGTGRLLGNGYTF	1
GCTCCCTCCCAGACATCTGTATACTTCTGTGCCAGCAGTTACAATCCGACAGGGAAAGGGACTAACTATGGCTACACCTTCGGTTCG	CASSYNPTGKGTNYGYTF	1
CTGCTGTCGGCTGCTCCCTCCCAGACATCTGTGTACTTCTGTGCCAGCAAAGCAGGGGCGACGAACACTGAAGCTTTCTTTGGACAA	CASKAGATNTEAFF	1
TCGCCCAGCCCCAACCAGACCTCTCTGTACTTCTGTGCTAGCAGTTTGACTAGCGGGAGGGCCACGCGAGAGCAGTACTTCGGGCCG	CASSLTSGRATREQYF	1
GTCCACGGAGTCAGGGGACACAGCACTGTATTTCTGTGCCAGCTTCCTCGCGGGAGAGGAACCTACAATGAGCAGTTCTTCGGGCCA		1
ACATCGGCCCAAAAGAACCCGACAGCTTTCTATCTCTGTGCCAGTAAAAACCCGGAGGGGACCAATCAGCCCCAGCATTTTGGTGAT	CASKNPEGTNQPQHF	1
GAGTCCGCTACCAGCTCCCAGACATCTGTGTACTTCTGTGCCATCAGTAGGACAGTAGTAGCTGCAGATACGCAGTATTTTGGCCCA	CAISRTVVAADTQYF	1
GTGAGCACCTTGGAGCTGGGGGACTCGGCCCTTTATCTTTGCGCCAGCAGCTTGGAACAGGGGGATCAGCCCCAGCATTTTGGTGAT	CASSLEQGDQPQHF	1
ACGTTGGCGTCTGCTGTACCCTCTCAGACATCTGTGTACTTCTGTGCCAGCAGTCGACAGGGCGCCGGGGAGCTGTTTTTTGGAGAA	CASSRQGAGELFF	1
TCAGCTACCCGCTCCCAGACATCTGTGTATTTCTGCGCCAGCAGTGAGCTACTACTCAGGGGTGGCACTGAAGCTTTCTTTGGACAA	CASSELLLRGGTEAFF	1
CTGAAGATCCAGCCCTCAGAACCCAGGGACTCAGCTGTGTACTTCTGTGCCAGCAGTTTAAGCGGGGACACGCAGTATTTTGGCCCA	CASSLSGDTQYF	1
AAGATCCAGCCCTCAGAACCCAGGGACTCAGCTGTGTACTTCTGTGCCAGCAGTTTTCGACGGGATCAGCCCCAGCATTTTGGTGAT	CASSFRRDQPQHF	1
GCCCATCCTGAAGACAGCAGCTTCTACATCTGCAGTGCTAGAGTCCGGGGTTCCGGGACCCCGGGGGAGACCCAGTACTTCGGGCCA	CSARVRGSGTPGETQYF	1
GCTCAGGCTGGAGTCGGCTGCTCCCTCCCAGACATCTGTGTACTTCTGTGCCAGGCCGGGACAGTCTATGGCTACACCTTCGGTTCG		1
ACTGTGACATCGGCCCAAAAGAACCCGACAGCTTTCTATCTCTGTGCCAGTAGTATACAGGGGTATCAGCCCCAGCATTTTGGTGAT	CASSIQGYQPQHF	1
CGCACACAGCAGGAGGACTCGGCCGTGTATCTCTGTGCCAGCAGCCCCTCTCGTTTGGGGGCTTTTGAGGAGCAGTACTTCGGGCCG	CASSPSRLGAFEEQYF	1
ATCCAGCAGGTAGTGCGAGGAGATTCGGCAGCTTATTTCTGTGCCAGCTCATCCCACGGACAGCCGGACGAGCAGTTCTTCGGGCCA	CASSSHGQPDEQFF	1
GTGACATCGGCCCAAAAGAACCCGACAGCTTTCTATCTCTGTGCCAGTAGTACGGCAGATCGGGGAAACACCATATATTTTGGAGAG	CASSTADRGNTIYF	1
TTGGAGCTGGGGGACTCGGCCCTTTATCTTTGCGCCAGCAGCCCAGGGAATCTAGCGGGGTTCCAAGAGACCCAGTACTTCGGGCCA	CASSPGNLAGFQETQYF	1
TCCCTGGAGCTTGGTGACTCTGCTGTGTATTTCTGTGCCAGCAGCCAAGGACAGGGTTTGAATCGCTATGGCTACACCTTCGGTTCG	CASSQGQGLNRYGYTF	1
ACAGTGACCAGTGCCCATCCTGAAGACAGCAGCTTCTACATCTGCAGTGCCCGAGACCTGATAGCCGGGGAGCTGTTTTTTGGAGAA	CSARDLIAGELFF	1
TTGGCGTCTGCTGTACCCTCTCAGACATCTGTGTACTTCTGTGCCAGCAGTGAGCGGGGGGGCACAGATACGCAGTATTTTGGCCCA	CASSERGGTDTQYF	3
CACATCAATTCCCTGGAGCTTGGTGACTCTGCTGTGTATTTCTGTGCCAGCAGCCAAGATTCCGGAAACACCATATATTTTGGAGAG	CASSQDSGNTIYF	1
CTGAGCTCTCTGGAGCTGGGGGACTCAGCTTTGTATTTCTGTGCCAGCAGCCCAGAGGTTTACAGTCCTGGCTACACCTTCGGTTCG	CASSPEVYSPGYTF	1
GTGACCAGTGCCCATCCTGAAGACAGCAGCTTCTACATCTGCAGTGCTAGGGAGGACTAGCGATCCTACGAGCAGTACTTCGGGCCG	CSARED*RSYEQYF	1
TTGGAGTCGGCTGCTCCCTCCCAAACATCTGTGTACTTCTGTGCCAGCAGTTACTTCTCGGACCGGTATGGCTACACCTTCGGTTCG	CASSYFSDRYGYTF	1
TGCTGCCTCCTCCCAGACATCTGTATATTTCTGCGCCAGCAGTGGTCTGCTTGCGGGGTACCCACAGATACGCAGTATTTTGGCCCA		1
ACGATCCAGCGCACACAGCAGGAGGACTCGGCCGTGTATCTCTGTGCCAGCAGCTTCGGTCGCTCAGATACGCAGTATTTTGGCCCA	CASSFGRSDTQYF	1
AGCTCTCTGGAGCTGGGGGACTCAGCTTTGTATTTCTGTGCCAGCAGCGTAGGGACAGCGAACACCGGGGAGCTGTTTTTTGGAGAA	CASSVGTANTGELFF	1
AGCAACATGAGCCCTGAAGACAGCAGCATATATCTCTGCAGCGGAAGTAGGGGGTTCCTCTCCTACAATGAGCAGTTCTTCGGGCCA	CSGSRGFLSYNEQFF	1
ATCCGCTCACCAGGCCTGGGGGACGCAGCCATGTACCTGTGTGCCACCAGCAGAGAACTGGGGGGCCACGAGCAGTACTTCGGGCCG	CATSRELGGHEQYF	1
CGCACAGAGCAGCGGGACTCGGCCATGTATCGCTGTGCCAGCAGCCCCCGGACTAGCGGGGGGGTAGAGACCCAGTACTTCGGGCCA	CASSPRTSGGVETQYF	1
CTGGAGTTGGCTGCTCCCTCCCAGACATCTGTGTACTTCTGTGCCAGCAGTTACGCGGGAGGGCCAACCGAGCAGTACTTCGGGCCG	CASSYAGGPTEQYF	1
CTGGAGTCGCCCAGCCCCAACCAGACCTCTCTGTACTTCTGTGCCAGCAGGGTCGACAGGGGCCCCTACGAGCAGTACTTCGGGCCG	CASRVDRGPYEQYF	1
AGCACCTTGGAGCTGGGGGACTCGGCCCTTTATCTTTGCGCCAGCAGCTTTAGCGGGGGGGACACAGATACGCAGTATTTTGGCCCA	CASSFSGGDTDTQYF	1
TCGGCCCAAAAGAACCCGACAGCTTTCTATCTCTGTGCCAGTACTCCCCGGGCGGGAGTGATAAGCGGGGAGCTGTTTTTTGGAGAA	CASTPRAGVISGELFF	1
CCATCCTGAAGACAGCAGCTTCTACATCTGCAGTGCTAGAGATCACGGGACAGGGGGGAAACTAATGAAAAACTGTTTTTTGGCAGT		1
AGCTCTCTGGAGCTGGGGGACTCAGCTTTGTATTTCTGTGCCAGCAGCGTAGCCCCGGGTTCTGGAAACACCATATATTTTGGAGAG	CASSVAPGSGNTIYF	1
AATGTGAGCACCTTGGAGCTGGGGGACTCGGCCCTTTATCTTTGCGCCAGCAGGGAAGGCGTCTCAGGGTCCCAGCATTTTGGTGAT	CASREGVSGSQHF	1
TCAGAACCCAGGGACTCAGCTGTGTACTTCTGTGCCAGCAGTGCAGGAAAGGGGGGCCCCAACACAGATACGCAGTATTTTGGCCCA	CASSAGKGGPNTDTQYF	1
AGTGACCAGTGCCCATCCTGAAGACAGCAGCTTCTACATCTGCAGTGCTAGAGTAGGGCTACGAACACTGAAGCTTTCTTTGGACAA		1
ACGCCTTGGAGCTGGACGACTCGGCCCTGTATCTCTGTGCCAGCAGCCTGGACTAGCGGGGGCACAGATACGCAGTATTTTGGCCCA		1
AGAACTGGAGGATTCTGGAGTTTATTTCTGTGCCAGCAGCCATCGCGCCCAGGGGGGAAGCACCAAGAGACCCAGTACTTCGGGCCA		1
AGGCTGCTGTCGGCTGCTCCCTCCCAGACATCTGTGTACTTCTGTGCCAGCAGCCGGGACCACAATCAGCCCCAGCATTTTGGTGAT	CASSRDHNQPQHF	1
GTGCCCATCCTGAAGACAGCAGCTTCTACATCTGCAGTGCTAGGTCCTTCTAGCGGGGGGGACACAGATACGCAGTATTTTGGCCCA		1
GCCCTGCAGCCAGAAGACTCAGCCCTGTATCTCTGCGCCAGCAGCCAAGGTGTGAGAGACGGCAATCAGCCCCAGCATTTTGGTGAT	CASSQGVRDGNQPQHF	1
TCTCTGGAGCTGGGGGACTCAGCTTTGTATTTCTGTGCCAGCAGCCCTAGGACAGGGGCCCCAGCGGGGGAGCAGTTCTTCGGGCCA	CASSPRTGAPAGEQFF	1
ATCCAGCCTGCAAAGCTTGAGGACTCGGCCGTGTATCTCTGTGCCAGCAGCTACGCCCGGACGGGCTACGAGCAGTACTTCGGGCCG	CASSYARTGYEQYF	1
TCCACAAAGCTGGAGGACTCAGCCATGTACTTCTGTGCCAGCAGTGATAGGGCCTCTAACCCGACGGGTGGCTACACCTTCGGTTCG	CASSDRASNPTGGYTF	1
AGGCTGCTGTCGGCTGCTCCCTCCCAGACATCTGTGTACTTCTGTGCCAGTGGCTTCCGGGACAGGGGAGAGCAGTACTTCGGGCCG	CASGFRDRGEQYF	1
AGTGCCCATCCTGAAGACAGCAGCTTCTACATCTGCAGTGCTAGGGACGGACAGATGATGAACACCGGGGAGCTGTTTTTTGGAGAA	CSARDGQMMNTGELFF	1
GCCCTGCAGCCAGAAGACTCAGCCCTGTATCTCTGCGCCAGCAGCCAAGAGGCTAGCGGGAGTAGAGATGAGCAGTTCTTCGGGCCA	CASSQEASGSRDEQFF	15
GATCCAGCGCACAGAGCGGGGGGACTCAGCCGTGTATCTCTGTGCCAGCAGCTTAGCTCCCTTCTGTATGGCTACACCTTCGGTTCG		1
CTGCAGCCAGAAGACTCGGCCCTGTATCTCTGTGCCAGCAGCCAAGATTTTTTGGACAGGAAGTCGAGTGGCTACACCTTCGGTTCG	CASSQDFLDRKSSGYTF	1
AACGCCTTGGAGCTGGACGACTCGGCCCTGTATCTCTGTGCCAGCAGCTTGTCTCGGGGAACGAACACTGAAGCTTTCTTTGGACAA	CASSLSRGTNTEAFF	1
GTGACCAGTGCCCATCCTGAAGACAGCAGCTTCTACATCTGCAGTGCTAGAGCCTGGCTAGCGGGAGAGACCCAGTACTTCGGGCCA	CSARAWLAGETQYF	1
AGCTCTCTGGAGCTGGGGGACTCAGCTTTGTATTTCTGTGCCAGCAGCAGGTCGACAGGGGAGGGAGAGACCCAGTACTTCGGGCCA	CASSRSTGEGETQYF	1
GAGTCTGCCATCCCCAACCAGACAGCTCTTTACTTCTGTGCCACCAGTCCGGGACAGGGGACCCAAGAGACCCAGTACTTCGGGCCA	CATSPGQGTQETQYF	1
ACAGTGACCAGTGCCCATCCTGAAGACAGCAGCTTCTACATCTGCAGTGCTAGACGGAGGAGCACAGATACGCAGTATTTTGGCCCA	CSARRRSTDTQYF	1
ATCAATTCCCTGGAGCTTGGTGACTCTGCTGTGTATTTCTGTGCCAGCAGGATGGGGGGAGTAAACACTGAAGCTTTCTTTGGACAA	CASRMGGVNTEAFF	2
GAGTCGGCTGCTCCCTCCCAAACATCTGTGTACTTCTGTGCCAGCAGTTACCGAGCTTTCGGGTCGGGCGAGCAGTACTTCGGGCCG	CASSYRAFGSGEQYF	28
TCCCTGATTCTGGAGTCCGCCAGCACCAACCAGACATCTATGTACCTCTGTGCCAGCAGTCTGACAGATACGCAGTATTTTGGCCCA	CASSLTDTQYF	1
CACACAGCAGGAGGACTCGGCCGTGTATCTCTGTGCCAGACCCAGGGGGAGGGAGCCTATTCCTACAATGAGCAGTTCTTCGGGCCA		1
AGCTCTCTGGAGCTGGGGGACTCAGCTTTGTATTTCTGTGCCAGCAGCCTATCTCATGGCGGAAACACTGAAGCCTTCTTTGGACAA	CASSLSHGGNTEAFF	1
ACATGAGCCCTGAAGACAGCAGCATATATCTCTGCAGCGTTCGGGACAGGGGGCTTACAAAAATACTACGAGCAGTACTTCGGGCCG		1
CGCTCAGGCTGGAGTCGGCTGCTCCCTCCCAGACATCTGTGTACTTCTGTGCCATACCCCCCATTCTAACCCCAGCATTTTGGTGAT		1
AAGATCCAGCCTGCAGAGCTTGGGGACTCGGCCATGTATCTCTGTGCCAGCAGAGTGGCTATATGTAAGACCCAGTACTTCGGGCCA	CASRVAICKTQYF	1
ATCCAGCGCACACAGCAGGAGGACTCGGCCGCGTATCTCTGTGCCAGCAGCTTCTCTGGTTTCTCCTACGAGCAGTACTTCGGGCCG	CASSFSGFSYEQYF	3
ACCAGTGCCCATCCTGAAGACAGCAGCTTCTACATCTGCAGTGCTAGAGGGCCCGGGACAGGGGGTGACGAGCAGTACTTCGGGCCA	CSARGPGTGGDEQYF	2
AGATCCAGTCCACGGAGTCAGGGGACACAGCACTGTATTTCTGTGCCAGCAGCTCCGGACAGTGGCTATGGCTACACCTTCGGTTCG		1
TTGTTGCTGGGGGACTCGGCCCTCTATCTCTGTGCCAGCAGCCCGAACCCGGGGTGGGGAGACACAGATACGCAGTATTTTGGCCCA	CASSPNPGWGDTDTQYF	45
AACGCCTTGTTGCTGGGGGACTCGGCCCTCTATCTCTGTGCCAGCAGCTTTTCCGGGACAGGGGGTTTGACCCAGTACTTCGGGCCA	CASSFSGTGGLTQYF	1
GTGACATCGGCCCAAAAGAACCCGACAGCTTTCTATCTCTGTGCCAGTAGGGTGGCAGGGGGTTACTACGAGCAGTACTTCGGGCCG	CASRVAGGYYEQYF	1
TTGGAGATCCAGCGCACAGAGCAGGGGGACTCGGCCATGTATCTCTGTGCCAGCAGCTTAGGTTCCACTGAAGCTTTCTTTGGACAA	CASSLGSTEAFF	1
CCCTCAGAACCCAGGGACTCAGCTGTGTATTTTTGTGCTAGTGGTTGGGCCGGGACAGGGGGCCGCAATGAGCAGTTCTTCGGGCCA	CASGWAGTGGRNEQFF	1
ACAGAGCAGGGGGACTCGGCCATGTATCTCTGTGCCAGCAGCTTAGGCCTCGGACAGAGTGGCAATCAGCCCCAGCATTTTGGTGAT	CASSLGLGQSGNQPQHF	1
ATCCAGCGCACACAGCAGGAGGACTCGGCCGTGTATCTCTGTGCCAGCTCCGTAGAGGGGTATAATGAAAAACTGTTTTTTGGCAGT	CASSVEGYNEKLFF	2
AACGCCTTGTTGCTGGGGGACTCGGCCCTCTATCTCTGTGCCAGCAGCGTAGGGGGAGGGGGGCCCTATGGCTACACCTTCGGTTCG	CASSVGGGGPYGYTF	1
ACTCTGACAGTGACCAGTGCCCATCCTGAAGACAGCAGCTTCTACATCTGCAGTGCTTGGCAGGGTATGGAGCAGTACTTCGGGCCG	CSAWQGMEQYF	1
CTAGAGTCTGCCATCCCCAACCAGACAGCTCTTTACTTCTGTGCCACCAGTGATTCCGGACGGATAAATGAGCAGTTCTTCGGGCCA	CATSDSGRINEQFF	1
ACTCGGCCCTGTATCTCTGTGCCAGAAGCTTGATCGGCCCGGACTAGCGGGGGGGTAGGGTCCTACAATGAGCAGTTCTTCGGGCCA		1
ATTCAGCGCACAGAGCAGCGGGACTCAGCCATGTATCGCTGTGCTAGCAGCAAGGGGTTATCCTACAATGAGCAGTTCTTCGGGCCA	CASSKGLSYNEQFF	2
CTTGGAGCTGGGGGACTCGGCCCTTTATCTTTGCGCCAGCAGCAGGGACAGGCCAGCTCGGAGGACTATGGCTACACCTTCGGTTCG		1
ATCCAGCGCACACAGCAGGAGGACTCGGCCGTGTATCTCTGTGCCAGCAGCCAGTTGGGCGGAAACACTGAAGCTTTCTTTGGACAA	CASSQLGGNTEAFF	1
GAGTCGCCCAGCCCCAACCAGACCTCTCTGTACTTCTGTGCCAGCAGTGTTAGCGGGAGGGCCACCGGGGAGCTGTTTTTTGGAGAA	CASSVSGRATGELFF	1
GAGTCTGCTGCCTCCTCCCAGACATCTGTATATTTCTGCGCCAGCAGTGAGCGGGACAGGGGCACAGATACGCAGTATTTTGGCCCA	CASSERDRGTDTQYF	1
AACATGAGCCCTGAAGACAGCAGCATATATCTCTGCAGCGTCCGACTTGCGATGGAAGGGAAGGGCGAAAAACTGTTTTTTGGCAGT	CSVRLAMEGKGEKLFF	2
TTGGAGCTGGGGGACTCAGCCCTGTACTTCTGTGCCAGCAGCGCCCGAGGACAGGGGAGGATCAGTGAAAAACTGTTTTTTGGCAGT	CASSARGQGRISEKLFF	1
ATCCTGGAGTCGCCCAGCCCCAACCAGACCTCTCTGTACTTCTGTGCCACCTCTCTGGACAGACTCCATGGCTACACCTTCGGTTCG	CATSLDRLHGYTF	2
CCCTCAGAACCCAGGGACTCAGCTGTGTACTTCTGTGCCAGCAGTTCAGGGTCCTCTCGTCTTGGAAACACCATATATTTTGGAGAG	CASSSGSSRLGNTIYF	1
GTGACCAGTGCCCATCCTGAAGACAGCAGCTTCTACATCTGCAGTGCTAGAGATCCTCTATTCGGGAGTGAGCAGTTCTTCGGGCCA	CSARDPLFGSEQFF	8
CTGCTGTCGGCTGCTCCCTCCCAGACATCTGTGTACTTCTGTGCCAGCAGTTACTCGGGACTATTATACGAGCAGTACTTCGGGCCG	CASSYSGLLYEQYF	1
TCCGCTACCAGCTCCCAGACATCTGTGTACTTCTGTGCCATCAGTGAGTCGGGAGCAGACTACTCAGATACGCAGTATTTTGGCCCA	CAISESGADYSDTQYF	1
TCGGCTGCTCCCTCCCAGACATCTGTGTACTTCTGTGCCAGCAGTCGTACCACCGGGACAGGGTTCAATGAGCAGTTCTTCGGGCCA	CASSRTTGTGFNEQFF	1
CACACCCTGCAGCCAGAAGACTCGGCCCTGTATCTCTGCGCCAGCAGCCTCGGGACTAGCGGGCACAATGAGCAGTTCTTCGGGCCA	CASSLGTSGHNEQFF	1
ACTCTGACAGTGACCAGTGCCCATCCTGAAGACAGCAGCTTCTACATCTGCAGTGCCGTACGGGGCTATGGCTACACCTTCGGTTCG	CSAVRGYGYTF	1
CTGAAGATCCGGTCCACAAAGCTGGAGGACTCAGCCATGTACTTCTGTGCCAGCAGTGAAGACCTCTACGAGCAGTACTTCGGGCCG	CASSEDLYEQYF	1
ATCAATTCCCTGGAGCTTGGTGACTCTGCTGTGTATTTCTGTGCCAGCGGCCAAGATCTACGGAGCTATGGCTACACCTTCGGTTCG	CASGQDLRSYGYTF	1
GTACCCTCTCAGACATCTGTGTACTTCTGTGCCAGCAGTGACTCGTACCCCTGGGACGGTCGGCTATACGAGCAGTACTTCGGGCCG	CASSDSYPWDGRLYEQYF	1
ACCAGTGCCCATCCTGAAGACAGCAGCTTCTACATCTGCAGTGCTAGGGCCCCGGGGGGGGAATACAATGAGCAGTTCTTCGGGCCA	CSARAPGGEYNEQFF	1
AACCCGACAGCTTTCTATCTCTGTGCCAGTAGTATTGATAGTGGGTGGACAGGAATATTTAGCAATCAGCCCCAGCATTTTGGTGAT	CASSIDSGWTGIFSNQPQHF	7
AGCACCTTGGAGCTGGGGGACTCGGCCCTTTATCTTTGCGCCAGCAGCCCCCTAGGACAGGGAACGCCTGAAGCTTTCTTTGGACAA	CASSPLGQGTPEAFF	1
ATCCTGGAGTCGCCCAGCCCCAACCAGACCTCTCTGTACTTCTGTGCCAGCAGCCTATGGGGGGGGCGGGAGCAGTACTTCGGGCCG	CASSLWGGREQYF	1
AGGGGACACAGCACTGTATTTCTGTGCCAGCAGCCTTCTCCCCAGCGGGGGGGCCCACAGGGCACAGATACGCAGTATTTTGGCCCA		1
TCCACGGAGTCAGGGGACACAGCACTGTATTTCTGTGCCAGCAGCAATAGAGAGCGGGGACCCTCCTACGAGCAGTACTTCGGGCCG	CASSNRERGPSYEQYF	1
GACAGTGACCAGTGCCCATCCTGAAGACAGCAGCTTCTACATCTGCAGCCCTACTAGCGGGAGCCTCGGGAGCTGTTTTTTGGAGAA		7
TCGGCTGCTCCCTCCCAGACATCTGTGTACTTCTGTGCCAGCAGTTCGACCTTGACAGGCCCCTCCTACGAGCAGTACTTCGGGCCG	CASSSTLTGPSYEQYF	1
TCCACAAAGCTGGAGGACTCAGCCATGTACTTCTGTGCCAGCGTACTCTCTGCGGCCAGCTCCTACAATGAGCAGTTCTTCGGGCCA	CASVLSAASSYNEQFF	1
CGCCTTGGAGCTGGAGGACTCGGCCCTGTATCTCTGTGCCAGCAGCTTCGAAGAAGCGGGAAGCAGTACGAGCAGTACTTCGGGCCG		1
TCCACAAAGCTGGAGGACTCAGCCATGTACTTCTGTGCCAGCAGCGTTACCGGGACAGGGAACACCGGGGAGCTGTTTTTTGGAGAA	CASSVTGTGNTGELFF	3
CTTGGAGATCCAGTCCACGGAGTCAGGGGACACAGCACTGTATTTCTGTGCCACAGGGACAGGGGCTACGAGCAGTACTTCGGGCCG		6
CTGCAGAACTGGAGGATTCTGGAGTTTATTTCTGTGCCAGCAGCCAAGGCTAGCGGGAGGATCCAAGAGACCCAGTACTTCGGGCCA		1
AGCTCTCTGGAGCTGGGGGACTCAGCTTTGTATTTCTGTGCCAGCAGCGTATCATCTGGGAACACCGGGGAGCTGTTTTTTGGAGAA	CASSVSSGNTGELFF	1
GAAGATCCAGCCCTCAGAACCCAGGGACTCAGCTGTGTACTTCTGTGCCAGCAGCTTTGGAGGGGGGGGACCCAGTACTTCGGGCCA		1
CTCAAGATCCAGCCTGCAGAGCTTGGGGACTCGGCCGTGTATCTCTGTGCCAGCAGCTTAGGCAATCAGCCCCAGCATTTTGGTGAT	CASSLGNQPQHF	1
CAGGTAGTGCGAGGAGATTCGGCAGCTTATTTCTGTGCCAGCTCACCAGCGGGGCAGAGGGTCGATTCACCCCTCCACTTTGGGAAC	CASSPAGQRVDSPLHF	1
AGCACCTTGGAGCTGGGGGACTCGGCCCTTTATCTTTGCGCCAGCAGCAGAGACCGGGACAGCAGTGAAAAACTGTTTTTTGGCAGT	CASSRDRDSSEKLFF	1
CTGAAGATCCAGCCCTCAGAACCCAGGGACTCAGCTGTGTACTTCTGTGCCAGCAGTACAGGGGGAAGTGAAGCTTTCTTTGGACAA	CASSTGGSEAFF	1
CGCCTTGGAGCTGGACGACTCGGCCCTGTATCTCTGTGCCAGCAGCTTAGGACAGGAGAAGTGGACTATGGCTACACCTTCGGTTCG		1
GGCTGCTCCCTCCCAGACATCTGTGTACTTCTGTGCCAGCAGTTCCTCCCTCGGGACAGGGGGTATAATGAGCAGTTCTTCGGGCCA		1
ACAGTGACCAGTGCCCATCCTGAAGACAGCAGCTTCTACATCTGCAGTGCCAGCCAGGGGGCAAAACAGCCCCAGCATTTTGGTGAT	CSASQGAKQPQHF	1
ATCCTGGAGTCGCCCAGCCCCAACCAGACCTCTCTGTACTTCTGTGCCAGCAGCACAGGTTTCAATCAGCCCCAGCATTTTGGTGAT	CASSTGFNQPQHF	1
AGCTCTCTGGAGCTGGGGGACTCAGCTTTGTATTTCTGTGCCAGCAGCCCTTCTAGCGGGGGGGACAATGAGCAGTTCTTCGGGCCA	CASSPSSGGDNEQFF	1
GCGTCTGCTGTACCCTCTCAGACATCTGTGTACTTCTGTGCCAGCAGTGTTGAGGGAGGCTCGTACAATGAGCAGTTCTTCGGGCCA	CASSVEGGSYNEQFF	1
CTGAATGTGAACGCCTTGTTGCTGGGGGACTCGGCCCTCTATCTCTGTGCCAGCAGCTTGGTGGCGGAGACCCAGTACTTCGGGCCA	CASSLVAETQYF	1
ATCCTGGAGTCGCCCAGCCCCAACCAGACCTCTCTGTACTTCTGTGCCAGCGGGCGGCTGCGCGCCGGGGAGCTGTTTTTTGGAGAA	CASGRLRAGELFF	1
CCACGGAGTCAGGGGACACAGCACTGTATTTCTGTGCCAGCAGATGTATTCTAGCTCAGAAAGACCTATGGCTACACCTTCGGTTCG		1
GCCCAAAAGAACCCGACAGCTTTCTATCTCTGTGCCAGTAGCATACCGGGACTAGCGGGATCGGGAGATACGCAGTATTTTGGCCCA	CASSIPGLAGSGDTQYF	1
CAGCGCACAGAGCAGCGGGACTCGGCCATGTATCGCTGTGCCAGCAGCCAGGGGCAGCGGCTTACAGATACGCAGTATTTTGGCCCA	CASSQGQRLTDTQYF	1
ACATCGGCCCAAAAGAACCCGACAGCTTTCTATCTCTGTGCCAGTAGTCCAGAGGCCGTAATCAGCCACGAGCAGTACTTCGGGCCG	CASSPEAVISHEQYF	1
CGGGAGTTCTCGCTCAGGCTGGAGTCGGCTGCTCCCTCCCAGACATCTGTGTACTTCTGTGCCAGCGATGGCTACACCTTCGGTTCG	CASDGYTF	1
AATTCCCTGGAGCTTGGTGACTCTGCTGTGTATTTCTGTGCCAGCAGCCCTATCGCGGGGGGGCCTCATGAGCAGTTCTTCGGGCCA	CASSPIAGGPHEQFF	2
GACATCCGCTCACCAGGCCTGGGGGACGCAGCCATGTACCTGTGTGCCACCAGCAGGTTCGGGGAGACTGAAGCTTTCTTTGGACAA	CATSRFGETEAFF	1
TCGGCTGCTCCCTCCCAGACATCTGTGTACTTCTGTGCCAGCAGTTACACTCAGGGGACCTCTGGAAACACCATATATTTTGGAGAG	CASSYTQGTSGNTIYF	1
AGTGCCCATCCTGAAGACAGCAGCTTCTACATCTGCAGTGCTAGGAGGCAGGTAGCAGACAGAGGCTACGAGCAGTACTTCGGGCCA	CSARRQVADRGYEQYF	1
ACATCGGCCCAAAAGAACCCGACAGCTTTCTATCTCTGTGCCAGCACGGGACAGAGACTTAGCAATCAGCCCCAGCATTTTGGTGAT	CASTGQRLSNQPQHF	1
TCTAAGAAGCTCCTTCTCAGTGACTCTGGCTTCTATCTCTGTGCCTGGGGTCCCGGCCTCGGGTCGGGCGAGCAGTACTTCGGGCCG	CAWGPGLGSGEQYF	1
GTGACATCGGCCCAAAAGAACCCGACAGCTTTCTATCTCTGTGCCAGTAGTCTAGCGGGAGGGCGTCACGAGCAGTACTTCGGGCCG	CASSLAGGRHEQYF	1
GCCCATCCTGAAGACAGCAGCTTCTACATCTGCAGTGCTAGAGGCGGACAGGGGGGTCTTTTCTACAATGAGCAGTTCTTCGGGCCA	CSARGGQGGLFYNEQFF	1
AACCTGAGCTCTCTGGAGCTGGGGGACTCAGCTTTGTATTTCTGTGCCAGCAGCGTAACCGAGGCGGGGGAGCAGTACTTCGGGCCG	CASSVTEAGEQYF	1
ATCCGCTCACCAGGCCTGGGGGACGCAGCCATGTACCTGTGTGCCACCAGCAGAGAAGGAAGTGGCACTGAAGCTTTCTTTGGACAA	CATSREGSGTEAFF	1
TCGCCCAGCCCCAACCAGACCTCTCTGTACTTCTGTGCCAGCAGTTCCCCGGGGACGGAGGTGAACACTGAAGCTTTCTTTGGACAA	CASSSPGTEVNTEAFF	2
ACTGTGACATCGGCCCAAAAGAACCCGACAGCTTTCTATCTCTGTGCCAGTCGGCTCCTAAACACCGGGGAGCTGTTTTTTGGAGAA	CASRLLNTGELFF	1
GCTGCCTCCTCCCAGACATCTGTATATTTCTGCGCCAGCAGTGTCGGTTTTGGATGGGGGTTAGGAAACACCATATATTTTGGAGAG	CASSVGFGWGLGNTIYF	1
CAGCCTGCAAAGCTTGAGGACTCGGCCGTGTATCTCTGTGCCAGCAGCTTACCCAGCGTTACGAACACTGAAGCTTTCTTTGGACAA	CASSLPSVTNTEAFF	1
GAGCGGGGGGACTCAGCCGTGTATCTCTGTGCCAGCAGCTTAAATGGAGGCCACTGGACGACTATCTACGAGCAGTACTTCGGGCCG	CASSLNGGHWTTIYEQYF	1
AAGATCCAGCCTGCAGAGCTTGGGGACTCGGCCGTGTATCTCTGTGCCAGCAGCTTAGGGTCTCCCTCCACGCAGTATTTTGGCCCA	CASSLGSPSTQYF	1
CTGAATGTGAACGCCTTGGAGCTGGACGACTCGGCCCTGTATCTCTGTGCCATCTCCAGGGACAACTACGAGCAGTACTTCGGGCCG	CAISRDNYEQYF	1
GTGAACGCCTTGTTGCTGGGGGACTCGGCCCTCTATCTCTGTGCCAGCCTCGACGCAGGGCTAAATTCACCCCTCCACTTTGGGAAC	CASLDAGLNSPLHF	1
ATCCGGTCCACAAAGCTGGAGGACTCAGCCATGTACTTCTGTGCCAGCGTCCCGGGGACAAGACGCTACGAGCAGTACTTCGGGCCG	CASVPGTRRYEQYF	1
ATCCAGCCTGCAAAGCTTGAGGACTCGGCCGTGTATCTCTGTGCCAGCAGCTTTGGCGGGGGGGCTAATGAGCAGTTCTTCGGGCCA	CASSFGGGANEQFF	1
GTGACCAGTGCCCATCCTGAAGACAGCAGCTTCTACATCTGCAGTGCCCGTCGACTAGCGTTGGTTGAGACCCAGTACTTCGGGCCA	CSARRLALVETQYF	1
GTCCCTAGAGTCTGCCATCCCCAACCAGACAGCTCTTTACTTCTGTGCCACCAGTGCCGGACTAATTCACCCCTCCACTTTGGGAAC		2
CAGCCCTCAGAACCCAGGGACTCAGCTGTGTACTTCTGTGCCAGCAGTTTTAGACCGACAGGGGGAACTGAAGCTTTCTTTGGACAA	CASSFRPTGGTEAFF	1
ACGCCTTGGAGCTGGACGACTCGGCCCTGTATCTCTGTGCCAGCAGCTTGAATTGAAGCTCGGAGCGGGGAGCTGTTTTTTGGAGAA		1
TCCACAAAGCTGGAGGACTCAGCCATGTACTTCTGTGCCAGCAGTGAATCTTGGGGGCTGTTGAATTCACCCCTCCACTTTGGGAAC	CASSESWGLLNSPLHF	1
ATCCGGTCCACAAAGCTGGAGGACTCAGCCATGTACTTCTGTGCCAGCAGTGAAGGGACAGGGTTCTATGGCTACACCTTCGGTTCG	CASSEGTGFYGYTF	1
ACAGTGACCAGTGCCCATCCTGAAGACAGCAGCTTCTACATCTGCAGTGCTCCCCCGGCGGGGGGCTATGGCTACACCTTCGGTTCG	CSAPPAGGYGYTF	1
TTGGAGCTGGGGGACTCGGCCCTTTATCTTTGCGCCAGCAGCTTGGTCCTAGCGGGAGAGGTCACCGGGGAGCTGTTTTTTGGAGAA	CASSLVLAGEVTGELFF	1
CTGAGTTCTAAGAAGCTCCTTCTCAGTGACTCTGGCTTCTATCTCTGTGCCTGGAGTACGGTCGGCTATGGCTACACCTTCGGTTCG	CAWSTVGYGYTF	1
ACATCGGCCCAAAAGAACCCGACAGCTTTCTATCTCTGTGCCAGTAGTACCCTCCGGGACGGGCAAGAGGCCCAGTACTTCGGGCCA	CASSTLRDGQEAQYF	1
AAGATCCAGCGCACAGAGCGGGGGGACTCAGCCGTGTATCTCTGTGCCAGCAGCAGGGCGACGAACACTGAAGCTTTCTTTGGACAA	CASSRATNTEAFF	1
ACTCTGAAGATCCGGTCCACAAAGCTGGAGGACTCAGCCATGTACTTCTGTGCCAGCAGTGAAGGGACTGAGCAGTTCTTCGGGCCA	CASSEGTEQFF	1
GACTCAGCTTTGTATTTCTGTGCCAGCAGCGTAGAGTAGGACCATCAGCGGGAGAGGGGGGTTAAATATGAGCAGTACTTCGGGCCG	CASSVE*DHQRERGVKYEQYF	1
GTGACCAGTGCCCATCCTGAAGACAGCAGCTTCTACATCTGCAGTGCTCCCCCCGGGGGGAACACAGATACGCAGTATTTTGGCCCA	CSAPPGGNTDTQYF	1
GTCTGCCATCCCCAACCAGACAGCTCTTTACTTCTGTGCCGCCAAGCTGGGACCGTAATTTCCTACTACGAGCAGTACTTCGGGCCG		1
CTGAGTTCTAAGAAGCTCCTTCTCAGTGACTCTGGCTTCTATCTCTGTGCCTGGAGTGGGTCTAATCAGCCCCAGCATTTTGGTGAT	CAWSGSNQPQHF	1
CTGACGATCCAGCGCACACAGCAGGAGGACTCGGCCGTGTATCTCTGTGCCAGCAGCTTTGGGGGGCGCGAGCAGTACTTCGGGCCG	CASSFGGREQYF	1
GTGAACGCCTTGGAGCTGGACGACTCGGCCCTGTATCTCTGTGCCAGCAGCCCAAGGACGGTGAACACTGAAGCTTTCTTTGGACAA	CASSPRTVNTEAFF	1
AACGCCTTGGAGCTGGACGACTCGGCCCTGTATCTCTGTGCCAGCAGCTTGGGAGGGACAGGGTTGGATGGCTACACCTTCGGTTCG	CASSLGGTGLDGYTF	1
ACTGTGACATCGGCCCAAAAGAACCCGACAGCTTTCTATCTCTGTGCCACCCAGTCGGGCAGATCCTACGAGCAGTACTTCGGGCCG	CATQSGRSYEQYF	1
ATCCAGCCTGCAGAGCTTGGGGACTCGGCCGTGTATCTCTGTGCCAGCAGCTCAAGCCGACAGGTAGGGGGCTACACCTTCGGTTCG	CASSSSRQVGGYTF	1
AATGTGAGCACCTTGGAGCTGGGGGACTCGGCCCTTTATCTTTGCGCCACCCGCCCCACAGGTCACACTGAAGCTTTCTTTGGACAA	CATRPTGHTEAFF	1
CTGGGGGACTCGGCCCTCTATCTCTGTGCCAGCAGCCCGGTAGGGAGGCACTCCAAGACTAGACCTCCCGAGCAGTACTTCGGGCCG	CASSPVGRHSKTRPPEQYF	1
ACATCGGCCCAAAAGAACCCGACAGCTTTCTATCTCTGTGCCAGTAGTCTCTCCGGGACAGGGAAAGAGACCCAGTACTTCGGGCCA	CASSLSGTGKETQYF	1
CTGTCGGCTGCTCCCTCCCAGACATCTGTGTACTTCTGTGCCAGCAGTTACGGGCAGGGGGCGCTGGATACGCAGTATTTTGGCCCA	CASSYGQGALDTQYF	1
AGCACCTTGGAGCTGGGGGACTCGGCCCTTTATCTTTGCGCCAGCACCTTGGGGGGGGATAAACGCAATGAGCAGTTCTTCGGGCCA	CASTLGGDKRNEQFF	1
ACAGTGACCAGTGCCCATCCTGAAGACAGCAGCTTCTACATCTGCAGTGCTGGAAAAAGCGGAGTTGATACGCAGTATTTTGGCCCA	CSAGKSGVDTQYF	1
ATCAATTCCCTGGAGCTTGGTGACTCTGCTGTGTATTTCTGTGCCAGCAGCCAAGGGGACAAGAATCAGCCCCAGCATTTTGGTGAT	CASSQGDKNQPQHF	4
TGGCTGCTCCCTCCCAGACATCTGTGTACTTCTGTGCCAGCAGTTACTCGGACATCCAGCTCTGGAAACACCATATATTTTGGAGAG		1
CTGGGGTTGGAGTCGGCTGCTCCCTCCCAAACATCTGTGTACTTCTGTGCCAGCAGTTACAGGATTTATGGCTACACCTTCGGTTCG	CASSYRIYGYTF	1
GGAGTCGCCCAGCCCCAACCAGACCTCTCTGTACTTCTGTGCCAGCCCGCCCGACAGGGCCCGAACACTGAAGCTTTCTTTGGACAA		1
ATCCGGTCCACAAAGCTGGAGGACTCAGCCATGTACTTCTGTGCCAGCAACGTTCAGGGGGCGGGTGAAAAACTGTTTTTTGGCAGT	CASNVQGAGEKLFF	2
CTGCTGTCGGCTGCTCCCTCCCAGACATCTGTGTACTTCTGTGCCAGCAGTAAGACTAGGAGTTCCGAGACCCAGTACTTCGGGCCA	CASSKTRSSETQYF	1
CTGTCGGCTGCTCCCTCCCAGACATCTGTGTACTTCTGTGCCATCAGTGATCAGCGGAAACCCTCCTACGAGCAGTACTTCGGGCCG	CAISDQRKPSYEQYF	1
AAGATCCGGTCCACAAAGCTGGAGGACTCAGCCATGTACTTCTGTGCCAGCAGTGAACTAGCCCCCGGGGAGCTGTTTTTTGGAGAA	CASSELAPGELFF	4
ACAGTGACCAGTGCCCATCCTGAAGACAGCAGCTTCTACATCTGCAGTGCTAGTGGGGTTGACACCGGGGAGCTGTTTTTTGGAGAA	CSASGVDTGELFF	1
GACAGCAGCTTCTACATCTGCAGTGCGAACCCGGGACTAGCGGGGGGGCCGGGGATAAGCTCCTACAATGAGCAGTTCTTCGGGCCA	CSANPGLAGGPGISSYNEQFF	2
CCGCTCAGGCTGGAGTTGGCTGCTCCCTCCCAGACATCTGTGTACTTCTGTGCCAGCAGTTTAGGGCAGCCCCAGCATTTTGGTGAT	CASSLGQPQHF	1
GGCCCAAAAGAACCCGACAGCTTTCTATCTCTGTGCCAGTAGTATTGAAGAGTAGCGGGGGGAAGGGGGCCCCAGTACTTCGGGCCA		1
ATGAGCTCCTTGGAGCTGGGGGACTCAGCCCTGTACTTCTGTGCCAGCAGCCTTCGGACTCTAAGGGAAAAACTGTTTTTTGGCAGT	CASSLRTLREKLFF	107
GAGATCCAGCGCACAGAGCAGGGGGACTCGGCCATGTATCTCTGTGCCAGCAGCTTGACAGGGTCTAATGAGCAGTTCTTCGGGCCA	CASSLTGSNEQFF	1
AGCTCTCTGGAGCTGGGGGACTCAGCTTTGTATTTCTGTGCCAGCAGCGTAGCTAGCGGGAGCTCCTACGAGCAGTACTTCGGGCCG	CASSVASGSSYEQYF	1
ACAGTGACCAGTGCCCATCCTGAAGACAGCAGCTTCTACATCTGCAGTGCTACGGTGGAGAGTACAGATACGCAGTATTTTGGCCCA	CSATVESTDTQYF	1
AGTCTGCCATCCCCAACCAGACAGCTCTTTACTTCTGTGCCACCAGTGATTTTACGGGGGGTTAATCAGCCCCAGCATTTTGGTGAT		3
CTGAAGATCCGGTCCACAAAGCTGGAGGACTCAGCCATGTACTTCTGTGCCAGCGGGTCAGGTGGAAACACCATATATTTTGGAGAG	CASGSGGNTIYF	3
CTCACTCTGGAGTCCGCTACCAGCTCCCAGACATCTGTGTACTTCTGTGCCACGACAGTGGACACCGGGGAGCTGTTTTTTGGAGAA	CATTVDTGELFF	3
TAGTGCGAGGAGATTCGGCAGCTTATTTCTGTGCCAGCTCACCAAAAGGCACTTACTTATAGCAATCAGCCCCAGCATTTTGGTGAT		2
AGCACCTTGGAGCTGGGGGACTCGGCCCTTTATCTTTGCGCCAGCAGCTCTAGCGGGCCATCCTACAATGAGCAGTTCTTCGGGCCA	CASSSSGPSYNEQFF	1
CGGTCCACAAAGCTGGAGGACTCAGCCATGTACTTCTGTGCCAGCAATATCGGGAGGGCCCGAACCGGGGAGCTGTTTTTTGGAGAA	CASNIGRARTGELFF	1
CGCACAGAGCAGGGGGACTCGGCCATGTATCTCTGTGCCAGCAGCTCACCCACAGGGGGTGGCACAGATACGCAGTATTTTGGCCCA	CASSSPTGGGTDTQYF	1
GAGTCGGCTGCTCCCTCCCAAACATCTGTGTACTTCTGTGCCAGCACTTTACAGGGCTTCAGGGCCCACGAGCAGTACTTCGGGCCG	CASTLQGFRAHEQYF	1
AGTTCTAAGAAGCTCCTTCTCAGTGACTCTGGCTTCTATCTCTGTGCCTGGGAAGGGGGAGCTGGAAACACCATATATTTTGGAGAG	CAWEGGAGNTIYF	2
ACCTTGGAGCTGGGGGACTCGGCCCTTTATCTTTGCGCCAGCAGCTTGGGGGGTTCCCCCCGACAAGAGACCCAGTACTTCGGGCCA	CASSLGGSPRQETQYF	6
CTCAAGATCCAGCCTGCAGAGCTTGGGGACTCGGCCGTGTATCTCTGTGCCAGCAGTGAGAGCTACAATGAGCAGTTCTTCGGGCCA	CASSESYNEQFF	1
ACCAGTGCCCATCCTGAAGACAGCAGCTTCTACATCTGCAGTGCTCGACCTTCGGACGGAGAGAATGAAAAACTGTTTTTTGGCAGT	CSARPSDGENEKLFF	1
CTGCAGCCAGAAGACTCAGCCCTGTATCTCTGCGCCAGCAGCCAAGTTCTCCTAGCGGAAAACACCGGGGAGCTGTTTTTTGGAGAA	CASSQVLLAENTGELFF	1
GTGACCAGTGCCCATCCTGAAGACAGCAGCTTCTACATCTGCAGTGCGCCTCTTGCCGGGGGGGCATTTGAGCAGTTCTTCGGGCCA	CSAPLAGGAFEQFF	1
ACTGTGAGCAACATGAGCCCTGAAGACAGCAGCATATATCTCTGCAGCGTTCGGAATAGCCCGCAAGAGACCCAGTACTTCGGGCCA	CSVRNSPQETQYF	1
ACTCTGACTGTGAGCAACATGAGCCCTGAAGACAGCAGCATATATCTCTGCAGCGTAACAGGGGACACTGAAGCTTTCTTTGGACAA	CSVTGDTEAFF	1
CATCCTGAAGACAGCAGCTTCTACATCTGCAGTGCTAGAGATCCGAGTCCTGGGATAGCGAACACCGGGGAGCTGTTTTTTGGAGAA	CSARDPSPGIANTGELFF	1
ACTCTGAAGATCCGGTCCACAAAGCTGGAGGACTCAGCCATGTACTTCTGTGCCAGCAGTGGGGAGTTCGAGCAGTACTTCGGGCCG	CASSGEFEQYF	1
ATCCAGCGCACAGAGCAGGGGGACTCGGCCATGTATCTCTGTGCCAGCAGCTTGCTAGCGGGACCCTACGAGCAGTACTTCGGGCCG	CASSLLAGPYEQYF	1
CTCAGGCTGCTGTCGGCTGCTCCCTCCCAGACATCTGTGTACTTCTGTGCCAGCAGTGCGGTGGTCTACGAGCAGTACTTCGGGCCG	CASSAVVYEQYF	1
ACGGAGTCAGGGGACACAGCACTGTATTTCTGTGCCAGCAGCAGTCGCTAGCGGGAGATGTGGACAGATACGCAGTATTTTGGCCCA	CASSSR*REMWTDTQYF	1
CCTCTCACTGTGACATCGGCCCAAAAGAACCCGACAGCTTTCTATCTCTGTGCCACTAGTCTAGGAAGTGAGCAGTACTTCGGGCCG	CATSLGSEQYF	1
CCTGTCCTCAGAACCGGGAGACACGGCACTGTATCTCTGCGCCAGCAGTCTGAGGCCTATAGCAATCAGCCCCAGCATTTTGGTGAT		1
CTGTCGGCTGCTCCCTCCCAGACATCTGTGTACTTCTGTGCCAGCAGTTTAAGAGGACCTAGCTCCTACGAGCAGTACTTCGGGCCG	CASSLRGPSSYEQYF	1
TCCCTAGAGTCTGCCATCCCCAACCAGACAGCTCTTTACTTCTGTGCCACCAGTGATAGCCGGGGGGCCGAGCAGTACTTCGGGCCG	CATSDSRGAEQYF	1
TGTAGTCTGCTGCCTCCTCCCAGACATCTGTATATTTCTGCGCCAGCAGCACTCGGACAAGCACCCTACGAGCAGTACTTCGGGCCG		1
CCCTGGAGCTTGGTGACTCTGCTGTGTATTTCTGTGCCAGCAGCCGATTCAGCGGCCTCCACTCTCTACGAGCAGTACTTCGGGCCG		1
ATCCAGCGCACAGAGCAGGGGGACTCGGCCATGTATCTCTGTGCCAGCAGCTTAGCGGTAGCTGGTAGCGGCTACACCTTCGGTTCG	CASSLAVAGSGYTF	1
ACGATCCAGCGCACACAGCAGGAGGACTCGGCCGTGTATCTCTGTGCCAGCAGCTTAGGGCAGCATTACGAGCAGTACTTCGGGCCG	CASSLGQHYEQYF	1
CTGGAGTCGCCCAGCCCCAACCAGACCTCTCTGTACTTCTGTGCCAGCAGTCCGGACAGGGGAGGGACTGAAGCTTTCTTTGGACAA	CASSPDRGGTEAFF	1
GAGTCGGCTGCTCCCTCCCAAACATCTGTGTACTTCTGTGCCAGCAGTTTTTCCGACGACAGAAACTATGGCTACACCTTCGGTTCG	CASSFSDDRNYGYTF	1
TCCGCCAGCACCAACCAGACATCTATGTACCTCTGTGCCAGCAGTTTGGGGGGGGGCGCCGGCAATCAGCCCCAGCATTTTGGTGAT	CASSLGGGAGNQPQHF	4
GCCAGCACCAACCAGACATCTATGTACCTCTGTGCCAGCAGTTTCAGGGGGTACGGTGTCAATGGGGGGCCCCAGCATTTTGGTGAT	CASSFRGYGVNGGPQHF	1
GTCTCCACTCTGACGATCCAGCGCACACAGCAGGAGGACTCGGCCGTGTATCTCTGTGCCAGCAGCTTGACGCAGTATTTTGGCCCA	CASSLTQYF	1
TCACGTTGGCGTCTGCTGTACCCTCTCAGACATCTGTGTACTTCTGTGCCACTCTTAAGATTAAGGGAAAAACTGTTTTTTGGCAGT		4
ACAGAGGATTTCCTCCTCACTCTGGAGTCCGCTACCAGCTCCCAGACATCTGTGTACTTCTGTGCCATCAGTGGCCCCTTCGGGCCG	CAISGPF	3
GTGAGCACCTTGGAGCTGGGGGACTCGGCCCTTTATCTTTGCGCCAGCAGCCCCCAGGGGGCAGGGTCACCCCTCCACTTTGGGAAC	CASSPQGAGSPLHF	7
CACTGTGACATCGGCCCAAAAGAACCCGACAGCTTTCTATCTCTGTGCCAGTAGTATCCGGGAGACACACCCCTCCACTTTGGGAAC		1
ATCCTGTCCTCAGAACCGGGAGACACGGCACTGTATCTCTGCGCCAGCAGTCAATCTAGGGGGAAAGAGACCCAGTACTTCGGGCCA	CASSQSRGKETQYF	1
GAGTCGGCTGCTCCCTCCCAAACATCTGTGTACTTCTGTGCCAGCAGTTACCACCGGACAGGGGGCACTGAAGCTTTCTTTGGACAA	CASSYHRTGGTEAFF	2
CCATCCTGAAGACAGCAGCTTCTACATCTGCAGTGCTAACGGAGGATCTAGCGGGGGGCCACTACAGATACGCAGTATTTTGGCCCA		1
CACATCAATTCCCTGGAGCTTGGTGACTCTGCTGTGTATTTCTGTGCCAGCGCGGGACAGGCCTACAATGAGCAGTTCTTCGGGCCA	CASAGQAYNEQFF	1
CGGTCCACAAAGCTGGAGGACTCAGCCATGTACTTCTGTGCCAGCAGTGAACAAGCGGGAGGGGGAGAGACCCAGTACTTCGGGCCA	CASSEQAGGGETQYF	1
CAGTGCCCATCCTGAAGACAGCAGCTTCTACATCTGCAGTCCTAACGCGGGACACGAGGCATGAACACTGAAGCTTTCTTTGGACAA		3
TCCCTGGAGCTTGGTGACTCTGCTGTGTATTTCTGTGCCAGCAGCCAGGATATGGGGGAAATGAACACTGAAGCTTTCTTTGGACAA	CASSQDMGEMNTEAFF	69
CCCCTGACCCTGGAGTCTGCCAGGCCCTCACATACCTCTCAGTACCTCTGTGCCAGCAGTAACACAGGGGGCTGGTACTTCGGGCCG	CASSNTGGWYF	1
CGCACACAGCAGGAGGACTCGGCCGTGTATCTCTGTGCCAGCAGCTTAGCGGGAGAGGGGTATTACAATGAGCAGTTCTTCGGGCCA	CASSLAGEGYYNEQFF	1
AATGTGAACGCCTTGGAGCTGGACGACTCGGCCCTGTATCTCTGTGCCAGCAGCTTCGGGACGGACTACGAGCAGTACTTCGGGCCG	CASSFGTDYEQYF	1
ACCTTGGAGCTGGGGGACTCGGCCCTTTATCTTTGCGCCAGCAGTCCGGGGGCACTAGCGAGTCAAGAGACCCAGTACTTCGGGCCA	CASSPGALASQETQYF	1
GCTGCTCCCTCCCAGACATCTGTGTACTTCTGTGCCAGCAGACCAATCGACAGGGGGTCTTTTGGAAACACCATATATTTTGGAGAG	CASRPIDRGSFGNTIYF	2
TCCACGGAGTCAGGGGACACAGCACTGTATTTCTGTGCCAGCGGGTGACGGGGTGGTTAAGTGATCTACGAGCAGTACTTCGGGCCG	CASG*RGG*VIYEQYF	1
CTGGAGCTTGGTGACTCTGCTGTGTATTTCTGTGCCAGCAGCCAAGAGGGAGTAGCGGGGGGCACAGATACGCAGTATTTTGGCCCA	CASSQEGVAGGTDTQYF	1
CAGCCTGCAGAGCTTGGGGACTCGGCCGTGTATCTCTGTGCCAGCAGCCGTCATTCGGGAGGGCTGAATGAGCAGTTCTTCGGGCCA	CASSRHSGGLNEQFF	1
CGGTCCACAAAGCTGGAGGACTCAGCCATGTACTTCTGTGCCAGCAGAACCGGGACTAGCGGTGCGGGGACCCAGTACTTCGGGCCA	CASRTGTSGAGTQYF	1
CAGCGCACACAGCAGGAGGACTCCGCCGTGTATCTCTGTGCCAGCACCTCTTACGGGCAGGGAGCCGACGAGCAGTACTTCGGGCCG	CASTSYGQGADEQYF	1
CCATCCTGAAGACAGCAGCTTCTACATCTGCAGTGCTAGAGATCTCCGCCGACAGGGGTTGGAACAGTGTAGCAGTACTTCGGGCCG		2
GAAGATCCAGCCCTCAGAACCCAGGGACTCAGCTGTGTACTTCTGTGCCAGCAGTTTGGCGGGGCCTATGGCTACACCTTCGGTTCG		2
CTAGAGTCTGCCATCCCCAACCAGACAGCTCTTTACTTCTGTGCCACCTCGGGGGGGGGCACCACAGATACGCAGTATTTTGGCCCA	CATSGGGTTDTQYF	1
AGTCCACGGAGTCAGGGGACACAGCACTGTATTTCTGTGCCAGCAGCAAAGGCCGTACATAGAGGGTATGGCTACACCTTCGGTTCG		1
ATCCGGTCCACAAAGCTGGAGGACTCAGCCATGTACTTCTGTGCCAGCAGGATGGGACGGGGAAACTATGGCTACACCTTCGGTTCG	CASRMGRGNYGYTF	1
ATGAATGTGAGCACCTTGGAGCTGGGGGACTCGGCCCTTTATCTTTGCGCCAGCAGCTCAACAGGGTACGAGCAGTACTTCGGGCCG	CASSSTGYEQYF	1
GCTGCTCCCTCCCAGACATCTGTGTACTTCTGTGCCAGCAGTTACGGTTTTTGGGACAGGGGAAATTCACCCCTCCACTTTGGGAAC	CASSYGFWDRGNSPLHF	1
ACAGTGACCAGTGCCCATCCTGAAGACAGCAGCTTCTACATCTGCAGTGCCCGGACAGACACGCCGGGGGGCTACACCTTCGGTTCG	CSARTDTPGGYTF	1
ATCCAGTCCACGGAGTCAGGGGACACAGCACTGTATTTCTGTGCCAGGTAATGACAGAGGCCTAACTATGGCTACACCTTCGGTTCG	CAR**QRPNYGYTF	2
CGCACAGAGCAGCGGGACTCAGCCATGTATCGCTGTGCTAGCAGCCCCTTTGGTAGCGGGGGGTACAATGAGCAGTTCTTCGGGCCA	CASSPFGSGGYNEQFF	1
AGTGCCCATCCTGAAGACAGCAGCTTCTACATCTGCAGTGCTTTGAGCGGGGGATCCCATAGGAACACTGAAGCTTTCTTTGGACAA	CSALSGGSHRNTEAFF	2
ACCAGTGCCCATCCTGAAGACAGCAGCTTCTACATCTGCAGTGCTAGATCCTACGTGGGGGTTCGAGGCGGCTACACCTTCGGTTCG	CSARSYVGVRGGYTF	1
GTGACCAGTGCCCATCCTGAAGACAGCAGCTTCTACATCTGCAGTGCCATAGCGGGGGGGAACACCGGGGAGCTGTTTTTTGGAGAA	CSAIAGGNTGELFF	1
CTGAGATGAATGTGAGCACCTTGGAGCTGGGGGACTCGGCCCTTTATCCCGCCGAGGGGTGGCAATCAGCCCCAGCATTTTGGTGAT		1
TGGAGTCCGCTACCAGCTCCCAGACATCTGTGTACTTCTGTGCCATCTGGAAATACAGGGTTCTGCGACGAGCAGTACTTCGGGCCG		1
AAGATCCAGCCCTCAGAACCCAGGGACTCAGCTGTGTACTTCTGTGCCAGCAGTTTAACGGGGGAGTTGGGGCAGTACTTCGGGCCG	CASSLTGELGQYF	1
GTGACCAGTGCCCATCCTGAAGACAGCAGCTTCTACATCTGCAGTGCTTACACCGGCAGGACAGGGGAAGGCTACACCTTCGGTTCG	CSAYTGRTGEGYTF	10
AGCCCCAACCAGACCTCTCTGTACTTCTGTGCCAGCAGTTTACTGGGACTAGCGGGAGGGGGCCAAGAGACCCAGTACTTCGGGCCA	CASSLLGLAGGGQETQYF	1
GTGAGCACCTTGGAGCTGGGGGACTCGGCCCTTTATCTTTGCGCCAGCAGCTTGGACAGTGGACCCTACGAGCAGTACTTCGGGCCG	CASSLDSGPYEQYF	6
ATCAATTCCCTGGAGCTTGGTGACTCTGCTGTGTATTTCTGTGCCAGCAGCCAAGATTTCTGGGCCAACGTCCTGACTTTCGGGGCC	CASSQDFWANVLTF	1
TCGGCCCAAAAGAACCCGACAGCTTTCTATCTCTGTGCCAGTAGTATCCCCACGCCCGTCAAGGCCGGGGAGCTGTTTTTTGGAGAA	CASSIPTPVKAGELFF	1
CTGACAGTGACCAGTGCCCATCCTGAAGACAGCAGCTTCTACATCTGCAGGATAAACAGGGGACCCTACGAGCAGTACTTCGGGCCG	CRINRGPYEQYF	1
CGGCTGCTCCCTCCCAGACATCTGTGTACTTCTGTGCCAGCAGTGGCCTTCTTGGGGACGGGCTCCCCTGGCTACACCTTCGGTTCG		1
CAGCGCACAGAGCGGGGGGACTCAGCCGTGTATCTCTGTGCCAGCAGCTTAACCTCCGTGTACCAAGAGACCCAGTACTTCGGGCCA	CASSLTSVYQETQYF	1
CTCTCGCTCTGAGATGAATGTGAGCACCTTGGAGCTGGGGGACTCGGCCCTTTATCTTTGCGCCAGCAGCTTCCTGGGCTCGGCGCC		1
GCCATCCCCAACCAGACAGCTCTTTACTTCTGTGCCACCAGTGAGCAGACCGGGACAGGGGGCCGGGAGACCCAGTACTTCGGGCCA	CATSEQTGTGGRETQYF	1
ACAGAGCAGGGGGACTCGGCCATGTATCTCTGTGCCAGCAGCCGAGGGGTGGGACTAACGAGCAATCAGCCCCAGCATTTTGGTGAT	CASSRGVGLTSNQPQHF	1
CACATCAATTCCCTGGAGCTTGGTGACTCTGCTGTGTATTTCTGTGCCAGCAGGTCACAGGGGTCCTATGGCTACACCTTCGGTTCG	CASRSQGSYGYTF	1
CACGCCCTGCAGCCAGAAGACTCAGCCCTGTATCTCTGCGCCAGCAGCCAAAGCTGGTTTAGGACCGGGGAGCTGTTTTTTGGAGAA	CASSQSWFRTGELFF	1
CCAGCCTGCAGAGCAGGGGGACTCGGCCGTGTATGTCTGTGCAAGTCGCTTAGTATCCCGTAGTGCAATGAGCAGTTCTTCGGGCCA		4
CTGGAGTCCGCCAGCACCAACCAGACATCTATGTACCTCTGTGCCAGCAGCCTCCCCCAGGGTGTGTATGGCTACACCTTCGGTTCG	CASSLPQGVYGYTF	1
TCCACAAAGCTGGAGGACTCAGCCATGTACTTCTGTGCCAGCAGTGAAAATCTGGGGGGCTTCTACAATGAGCAGTTCTTCGGGCCA	CASSENLGGFYNEQFF	1
TCCGCTACCAGCTCCCAGACATCTGTGTACTTCTGTGCCATCAGGGGGGCAGCTAGCGGGGGCCCCGATACGCAGTATTTTGGCCCA	CAIRGAASGGPDTQYF	1
ATCCAGCGCACAGAGCAGCGGGACTCGGCCATGTATCGCTGTGCCAGCAGCCCATGGGACAGGGTCAATGAGCAGTTCTTCGGGCCA	CASSPWDRVNEQFF	1
AAGAAGCTCCTTCTCAGTGACTCTGGCTTCTATCTCTGTGCCTGGAGTCGGGGGGTTGATAGCAATCAGCCCCAGCATTTTGGTGAT	CAWSRGVDSNQPQHF	1
AGAGCAGGGGGACTCGGCCGTGTATGTCTGTGCAAGTCGCTTTATTTCGGACAGGGCGGGCCCACAGATACGCAGTATTTTGGCCCA		1
AAGAAGCTCCTTCTCAGTGACTCTGGCTTCTATCTCTGTGCCTGGAGTGTGGGCGTCTGGGGCAATCAGCCCCAGCATTTTGGTGAT	CAWSVGVWGNQPQHF	1
ACATCGGCCCAAAAGAACCCGACAGCTTTCTATCTCTGTGCCAGTAGTTTGGCCGGGACAGTCAATCAGCCCCAGCATTTTGGTGAT	CASSLAGTVNQPQHF	2
CTGACAGTGACCAGTGCCCATCCTGAAGACAGCAGCTTCTACATCTGCAGTGCTGTCCAGGGGAACACTGAAGCTTTCTTTGGACAA	CSAVQGNTEAFF	1
ACGATCCAGCGCACACAGCAGGAGGACTCGGCCGTGTATCTCTGTGCCAGCAGCACTATACCCGCTACGGAGCAGTACTTCGGGCCG	CASSTIPATEQYF	1
CTGTCGGCTGCTCCCTCCCAGACATCTGTGTACTTCTGTGCCAGCAGATCGGACAGGAAGGGGGATTACGAGCAGTACTTCGGGCCG	CASRSDRKGDYEQYF	1
GAGTCTGCTGCCTCCTCCCAGACATCTGTATATTTCTGCGCCAGCAGTGAGTCCTATGGGGGGGCAGATACGCAGTATTTTGGCCCA	CASSESYGGADTQYF	1
TCCCTAGAGTCTGCCATCCCCAACCAGACAGCTCTTTACTTCTGTGCCACCAGTGACCCCGGCACAGATACGCAGTATTTTGGCCCA	CATSDPGTDTQYF	1
CACACCCTGCAGCCAGAAGACTCGGCCCTGTATCTCTGCGCCAGCAGCCTCGAATCTCCTCCAGGCTACGAGCAGTACTTCGGGCCG	CASSLESPPGYEQYF	3
ACATCGGCCCAAAAGAACCCGACAGCTTTCTATCTCTGTGCCAGTAGTATCCCTGGACAGGGTTACGGCGAGCAGTACTTCGGGCCG	CASSIPGQGYGEQYF	1
AGGATCCAGCAGGTAGTGCGAGGAGATTCGGCAGCTTATTTCTGTGCCAGCTCACCGAGCAGGAACACTGAAGCTTTCTTTGGACAA	CASSPSRNTEAFF	1
AGTTCTAAGAAGCTCCTTCTCAGTGACTCTGGCTTCTATCTCTGTGCCTGGAGTGTAGACATCAATCAGCCCCAGCATTTTGGTGAT	CAWSVDINQPQHF	1
TGAATGTGAGTGCCTTGGAGCTGGGGGACTCGGCCCTGTATCTCTGTGCCAGGGAGCGGGGGTTACAATGAGCAGTTCTTCGGGCCA		2
ATCCAGCAGGTAGTGCGAGGAGATTCGGCAGCTTATTTCTGTGCCAGCAGCCCGGCGGGTCACACAGATACGCAGTATTTTGGCCCA	CASSPAGHTDTQYF	1
CTGACTATGAGCAACATGAGCCCTGAAGACAGCAGCATATATCTCTGCAGCGTTGATTTGAACACCGGGGAGCTGTTTTTTGGAGAA	CSVDLNTGELFF	2
ACCCTGCAGCCAGAAGACTCGGCCCTGTATCTCTGTGCCAGCAGCCAAGATATCACTAGCGGGAGCTACGAGCAGTACTTCGGGCCG	CASSQDITSGSYEQYF	1
AGGCTGCTGTCGGCTGCTCCCTCCCAGACATCTGTGTACTTCTGTGCCAGCAGTTACTCTGGGAACTACGAGCAGTACTTCGGGCCG	CASSYSGNYEQYF	4
CTGGAGTCCGCCAGCACCAACCAGACATCTATGTACCTCTGTGCCAGCAGTCCCTCGGACAGGGCTGGAGGCTACACCTTCGGTTCG	CASSPSDRAGGYTF	3
GTGAGCACCTTGGAGCTGGGGGACTCGGCCCTTTATCTTTGCGCCAGCAGCTTGGCGGAATTATCCTACGAGCAGTACTTCGGGCCG	CASSLAELSYEQYF	1
ACCTTGGAGCTGGGGGACTCGGCCCTTTATCTTTGCGCCAGCAGCTTGGAACGGCCGAATGGACCAGATACGCAGTATTTTGGCCCA	CASSLERPNGPDTQYF	1
AGGCTGGAGTTGGCTGCTCCCTCCCAGACATCTGTGTACTTCTGTGCCAGCAGTTACGGACGGGCAGATACGCAGTATTTTGGCCCA	CASSYGRADTQYF	1
GCCTTGTTGCTGGGGGACTCGGCCCTCTATCTCTGTGCCAGCAGCGAGGACTTAGGTGGGTCTAACTATGGCTACACCTTCGGTTCG	CASSEDLGGSNYGYTF	1
CCCTCCCAAACATCTGTGTACTTCTGTGCCAGCAGTTTGAGGACTAGCGGGAGTAGAATAAACACCGGGGAGCTGTTTTTTGGAGAA	CASSLRTSGSRINTGELFF	5
AGATCCAGCCCTCAGAACCCAGGGACTCAGCTGTGTACTTCTGTGCCTGCGGGACAGGGCCTCCAAAACATTCAGTACTTCGGCGCC		1
CTGAAGATCCGGTCCACAAAGCTGGAGGACTCAGCCATGTACTTCTGTGCCAGCAACAGGAACACAGATACGCAGTATTTTGGCCCA	CASNRNTDTQYF	1
CTCCCAGACATCTGTGTACTTCTGTGCCAGCAGTGAAGGTCGGGGTAGACCGATGCACAGGGGCCCTACGAGCAGTACTTCGGGCCG		1
CAGGTAGTGCGAGGAGATTCGGCAGCTTATTTCTGTGCCAGCTCACCGGCCTCCCTCGCGAACACCGGGGAGCTGTTTTTTGGAGAA	CASSPASLANTGELFF	1
ACATCGGCCCAAAAGAACCCGACAGCTTTCTATCTCTGTGCCAGTAGCAGTTCTAGCGGGAGGATGTACGAGCAGTACTTCGGGCCG	CASSSSSGRMYEQYF	2
GAGTCTGCCAGGCCCTCACATACCTCTCAGTACCTCTGTGCCAGCAGTGCCTTAGGGGGGGCTGAGGACGAGCAGTACTTCGGGCCG	CASSALGGAEDEQYF	1
CTGAAGATCCAGCCCTCAGAACCCAGGGACTCAGCTGTGTATTTTTGTGCTAGTGGTTTGGTAACGGACGAGCAGTACTTCGGGCCG	CASGLVTDEQYF	3
GTGACATCGGCCCAAAAGAACCCGACAGCTTTCTATCTCTGTGCCAGTAGGGCGGACTCTGGGGCCAACGTCCTGACTTTCGGGGCC	CASRADSGANVLTF	1
GAGATCCAGCGCACAGAGCAGGGGGACTCGGCCATGTATCTCTGTGCCAGCACCCCTCTCGGCTCCTACGAGCAGTACTTCGGGCCG	CASTPLGSYEQYF	1
GAGTCCGCCAGCACCAACCAGACATCTATGTACCTCTGTGCCAGCAGTTTAGGGGACAGGGCTAATGAAAAACTGTTTTTTGGCAGT	CASSLGDRANEKLFF	1
GCTCCTTCTCAGTGACTCTGGCTTCTATCTCTGTGCCTGGAGTGGGGTAGCGGGAGGCCCCGTCAAGACGAGCAGTACTTCGGGCCG		6
GCCCATCCTGAAGACAGCAGCTTCTACATCTGCAGTGCTAGAGATTGGTCTGGCATACGCGGCACAGATACGCAGTATTTTGGCCCA	CSARDWSGIRGTDTQYF	2
ATCCTGGAGTCGCCCAGCCCCAACCAGACCTCTCTGTACTTCTGTGCCAGCAGTTTTTCACGGGGTTACGAACAGTTCTTCGGGCCA	CASSFSRGYEQFF	1
ACCAGTGCCCATCCTGAAGACAGCAGCTTCTACATCTGCAGTGCTAGAGATTACCAGAGGAGCAATCAGCCCCAGCATTTTGGTGAT	CSARDYQRSNQPQHF	2
AACGCCTTGTTGCTGGGGGACTCGGCCCTCTATCTCTGTGCCAGCAGCCCAGGGGGGGCTTGGGGTGAGACCCAGTACTTCGGGCCA	CASSPGGAWGETQYF	1
CTGGAGTCGCCCAGCCCCAACCAGACCTCTCTGTACTTCTGTGCCAGCAGTCTCGGATTCGGAGACAATGAGCAGTTCTTCGGGCCA	CASSLGFGDNEQFF	1
TTGGAGATCCAGCGCACAGAGCAGGGGGACTCGGCCATGTATCTCTGTGCCAGCAGTTTGGGGACAGTCGGCTACACCTTCGGTTCG	CASSLGTVGYTF	1
AATGTGAGCACCTTGGAGCTGGGGGACTCGGCCCTTTATCTTTGCGCCAGCAGCTTACAGGGGACAGATACGCAGTATTTTGGCCCA	CASSLQGTDTQYF	1
TCTAAGAAGCTCCTTCTCAGTGACTCTGGCTTCTATCTCTGTGCCTGGAGTGCGACAGAGTTCCAAGAGACCCAGTACTTCGGGCCA	CAWSATEFQETQYF	1
CTCTGTAGTCTGCTGCCTCCTCCCAGACATCTGTATATTTCTGCGCCAGCAGTGAGGGTTGAGGCCTACGAGCAGTACTTCGGGCCG		1
TCTAAGAAGCTCCTTCTCAGTGACTCTGGCTTCTATCTCTGTGCCTGGAATGGGGGACAGGGGGCCCACGAGCAGTACTTCGGGCCG	CAWNGGQGAHEQYF	1
GTTCTAAGAAGCTCCTCCTCAGTGACTCTGGCTTCTATCTCTGTGCCGTCCAGGGACAGACCCTACAATGAGCAGTTCTTCGGGCCA		1
TTGGAGTCGGCTGCTCCCTCCCAAACATCTGTGTACTTCTGTGCCAGCAGTTACGCGGGGTTCTACAATGAGCAGTTCTTCGGGCCA	CASSYAGFYNEQFF	1
CTGCCATCCCCAACCAGACAGCTCTTTACTTCTGTGCCACCAGTGATAACGACGGGAGGTGACCAAGAGACCCAGTACTTCGGGCCA		3
AGATCCAGCCTGCAGAGCTTGGGGACTCGGCCATGTATCTCTGTGCCAGCAGCTAGTGACCGAAACTATGGCTACACCTTCGGTTCG		4
CTGGAGTTGGCTGCTCCCTCCCAGACATCTGTGTACTTCTGTGCCAGCATGCCCCCTCTTTTTGTCTCTGAAGCTTTCTTTGGACAA	CASMPPLFVSEAFF	2
AGCACCTTGGAGCTGGGGGACTCGGCCCTTTATCTTTGCGCCAGCAGCTGGTCGGGGGGCGGGGTAGATACGCAGTATTTTGGCCCA	CASSWSGGGVDTQYF	1
TCAACTCTGACTGTGAGCAACATGAGCCCTGAAGACAGCAGCATATATCTCTGCAGCGCCGAGGACAGCGAACAGTTCTTCGGGCCA	CSAEDSEQFF	1
CAGCGCACACAGCAGGAGGACTCGGCCGTGTATCTCTGTGCCAGCAGCTTAGTAAGAGGGAGGGACACTGAAGCTTTCTTTGGACAA	CASSLVRGRDTEAFF	1
GTGACATCGGCCCAAAAGAACCCGACAGCTTTCTATCTCTGTGCCAGTAGTACACAGGGGTTAGGCACTGAAGCTTTCTTTGGACAA	CASSTQGLGTEAFF	1
CTGGGGTTGGAGTCGGCTGCTCCCTCCCAAACATCTGTGTACTTCTGTGCCAGCAGTCCCCTGGGGAACATTCAGTACTTCGGCGCC	CASSPLGNIQYF	1
CGGTCCACAAAGCTGGAGGACTCAGCCATGTACTTCTGTGCCAGCAGGCGACACTCTGCAACTAATGAAAAACTGTTTTTTGGCAGT	CASRRHSATNEKLFF	2
GAGTCGCCCAGCCCCAACCAGACCTCTCTGTACTTCTGTGCCAGCAGCGATAGGGGTGGGGGTGGCACTGAAGCTTTCTTTGGACAA	CASSDRGGGGTEAFF	27
CTGAGCTCTCTGGAGCTGGGGGACTCAGCTTTGTATTTCTGTGCCAGCAGCCGGGCCGGGGGGCTGGCTGAAGCTTTCTTTGGACAA	CASSRAGGLAEAFF	1
AGGCTGCTGTCGGCTGCTCCCTCCCAGACATCTGTGTACTTCTGTGCCAGCAGTTACGATACAGACACTGAAGCTTTCTTTGGACAA	CASSYDTDTEAFF	1
GAGATCCAGCGCACAGAGCAGGGGGACTCGGCCATGTATCTCTGTGCCAGCAGCTCTCCGGGTTACAATGAGCAGTTCTTCGGGCCA	CASSSPGYNEQFF	4
ATCCAGCGCACACGGCAGGAGGACTCCGCCGTGTATCTCTGTGCCAGCAGCGTTCAGGGGGTCCATCAGCCCCAGCATTTTGGTGAT	CASSVQGVHQPQHF	1
TCTGCCAGGCCCTCACATACCTCTCAGTACCTCTGTGCCACCATCCCCGGTCGGGCTAGCGGACGCTACGAGCAGTACTTCGGGCCG	CATIPGRASGRYEQYF	1
CTGCAGCCAGAAGACTCAGCCCTGTATCTCTGCGCCAGCAGCTCTCCTTCCGGGGGGAGGGAGGGAGAGACCCAGTACTTCGGGCCA	CASSSPSGGREGETQYF	1
CACACCCTGCAGCCAGAAGACTCGGCCCTGTATCTCTGCGCCAGCAGCGGACTAGCGGGAGGGCCTTACGAGCAGTACTTCGGGCCG	CASSGLAGGPYEQYF	1
CTGGAGTTGGCTGCTCCCTCCCAGACATCTGTGTACTTCTGTGCCAGCAGCCCGGACATAAACACCGGGGAGCTGTTTTTTGGAGAA	CASSPDINTGELFF	1
AAGATCCAGCCCTCAGAACCCAGGGACTCAGCTGTGTACTTCTGTGCCAGCAGTTTAATAGGGGTTAATGAGCAGTTCTTCGGGCCA	CASSLIGVNEQFF	1
ACTGTGAGCAACATGAGCCCTGAAGACAGCAGCATATATCTCTGCAGCGTAATACTAGCGGCCTACAATGAGCAGTTCTTCGGGCCA	CSVILAAYNEQFF	1
TTGGAGATCCAGCGCACAGAGCAGGGGGACTCGGCCATGTATCTCTGTGCCAGCAGGGCGCTAGCCAATACGCAGTATTTTGGCCCA	CASRALANTQYF	1
GCAGAGCTTGGGGACTCGGCCGTGTATCTCTGTGCCAGCAGCTTTCCCCTTGAGTGGTCGCCGACCTACGAGCAGTACTTCGGGCCG	CASSFPLEWSPTYEQYF	1
GAGTCGCCCAGCCCCAACCAGACCTCTCTGTACTTCTGTGCCAGCAGTTTATTGGGCGGGATCACAGATACGCAGTATTTTGGCCCA	CASSLLGGITDTQYF	1
CTAAACCTGAGCTCTCTGGAGCTGGGGGACTCAGCTTTGTATTTCTGTGCCAGCAGCAAGGGAGGTTCACCCCTCCACTTTGGGAAC	CASSKGGSPLHF	1
GTGCGAGGAGATTCGGCAGCTTATTTCTGTGCCAGCCCTCAACGCGCGGGGACTAGCGGGAGGGGTTACGAGCAGTACTTCGGGCCG	CASPQRAGTSGRGYEQYF	1
TCCCTGGAGCTTGGTGACTCTGCTGTGTATTTCTGTGCCAGCAGCCAAGACATTGGGACAGGGCTCACTGAAGCTTTCTTTGGACAA	CASSQDIGTGLTEAFF	6
CTGAAGATCCGGTCCACAAAGCTGGAGGACTCAGCCATGTACTTCTGTGCCAGCAGCGGGTACCAAGAGACCCAGTACTTCGGGCCA	CASSGYQETQYF	1
ACCAGTGCCCATCCTGAAGACAGCAGCTTCTACATCTGCAGTGCTAGTGACGGGGGTTACATGAACACTGAAGCTTTCTTTGGACAA	CSASDGGYMNTEAFF	1
GACAGTGACCAGTGCCCATCCTGAAGACAGCAGCTTCTACATCTGCAGTGCTGGGGGACAGGGGAATGAAAAACTGTTTTTGGCAGT		2
ATCCAGCGCACACAGCAGGAGGACTCGGCCGTGTATCTCTGTGCCAGCAGCCCCCGGACGGGACCCAGCGAGCAGTACTTCGGGCCG	CASSPRTGPSEQYF	1
CTGCAGCCAGAAGACTCGGCCCTGTATCTCTGCGCCAGCAGCCAAGCCCAACTAGCGGGAGCGGCAGATACGCAGTATTTTGGCCCA	CASSQAQLAGAADTQYF	1
TCGCCCAGCCCCAACCAGACCTCTCTGTACTTCTGTGCCAGCAGTTTAACCGGGACAGGGAGCTCCTACGAGCAGTACTTCGGGCCG	CASSLTGTGSSYEQYF	1
AAGACAGCAGCTTCTACATCTGCAGTGAAACCCCGGGACTAGCGGGGGGGCCTAAGTTCAGACACCGGGGAGCTGTTTTTTGGAGAA		2
AAGATCCGGTCCACAAAGCTGGAGGACTCAGCCATGTACTTCTGTGCCAGCAAGGCCGGGTCTAACTATGGCTACACCTTCGGTTCG	CASKAGSNYGYTF	1
CAGCAGGTAGTGCGAGGAGATTCGGCAGCTTATTTCTGTGCCAGCTCACCGGAGAATGGGAAGAACTACGAGCAGTACTTCGGGCCG	CASSPENGKNYEQYF	1
GCTCCCTCCCAGACATCTGTGTACTTCTGTGCCAGCAGTTACTCGACACAGGGGATATTAACTAATGAAAAACTGTTTTTTGGCAGT	CASSYSTQGILTNEKLFF	1
ACTCTGAAGATCCAGCCCTCAGAACCCAGGGACTCAGCTGTGTACTTCTGTGCCAGCAGTGCTAACTATGGCTACACCTTCGGTTCG	CASSANYGYTF	3
ATCCAGCGCACAGAGCAGGGGGACTCGGCCATGTATCTCTGTGCCAGCAGCTTACCGGGGGTACCGGCTGAAGCTTTCTTTGGACAA	CASSLPGVPAEAFF	1
GGGTTGGAGTCGGCTGCTCCCTCCCAAACATCTGTGTACTTCTGTGCCAGCCAGGGACACTACACCGGGGAGCTGTTTTTTGGAGAA	CASQGHYTGELFF	1
CCATCCCCAACCAGACAGCTCTTTACTTCTGTGCCACCAGTGATTTGCACGGCGTACTTGAGCTCCTACGAGCAGTACTTCGGGCCG		1
ACAGTGACCAGTGCCCATCCTGAAGACAGCAGCTTCTACATCTGCAGTGCTAGGCGGCTAGACCACTACGAGCAGTACTTCGGGCCG	CSARRLDHYEQYF	1
GTGACCAGTGCCCATCCTGAAGACAGCAGCTTCTACATCTGCAGTGCTAGACAGGGCCCGAACACCGGGGAGCTGTTTTTTGGAGAA	CSARQGPNTGELFF	1
CTGTCGGCTGCTCCCTCCCAAACATCTGTGTACTTCTGTGCCAGCAGTTACAGGACAGTAAACACCGGGGAGCTGTTTTTTGGAGAA	CASSYRTVNTGELFF	1
AGCTCTCTGGAGCTGGGGGACTCAGCTTTGTATTTCTGTGCCAGCAGCACAAGGACGGGACACACAGATACGCAGTATTTTGGCCCA	CASSTRTGHTDTQYF	4
GCCTTGGAGCTGGAGGACTCGGCCCTGTATCTCTGTGCCAGCAGCCGGGGACTAGCGGGACTCACAGATACGCAGTATTTTGGCCCA	CASSRGLAGLTDTQYF	1
ATCCAGTCCACGGAGTCAGGGGACACAGCACTGTATTTCTGTGCCAGCAGCAAGTCAACTCAGAACACTGAAGCTTTCTTTGGACAA	CASSKSTQNTEAFF	1
CAGCCTGCAAAGCTTGAGGACTCGGCCGTGTATCTCTGTGCCAGCAGGGACGTTAGGGGGCGTCCCTACGAGCAGTACTTCGGGCCG	CASRDVRGRPYEQYF	1
CTGATTCTGGAGTCCGCCAGCACCAACCAGACATCTATGTACCTCTGTGCCAGCAGTACAACAGCTAGTGGCTACACCTTCGGTTCG	CASSTTASGYTF	1
AGCACCTTGGAGCTGGGGGACTCGGCCCTTTATCTTTGCGCCAGCAGACCGGGGGACAGCCTGAACACTGAAGCTTTCTTTGGACAA	CASRPGDSLNTEAFF	1
AATGTGAGCACCTTGGAGCTGGGGGACTCGGCCCTTTATCTTTGCGCCAGCAGCTTCGGGGACAGATCACCCCTCCACTTTGGGAAC	CASSFGDRSPLHF	1
GTGACATCGGCCCAAAAGAACCCGACAGCTTTCTATCTCTGTGCCAGTAGTATTGGTCAGGGTAATCAGCCCCAGCATTTTGGTGAT	CASSIGQGNQPQHF	1
ATCCAGCCCTCAGAACCCAGGGACTCAGCTGTGTACTTCTGTGCCAGCAGCCACGGTCGGGGCACAGATACGCAGTATTTTGGCCCA	CASSHGRGTDTQYF	1
GGCTGGAGTCGGCTGCTCCCTCCCAGACATCTGTGTACTTCTGTGCCACAACGCGCCAGCGGGGGGAGAGGGCAGTTCTTCGGGCCA		1
GAGCTGAATGTGAACGCCTTGTTGCTGGGGGACTCGGCCCTCTATCTCTGTGCCAGCAGCGTTGCGGGTGAGCAGTTCTTCGGGCCA	CASSVAGEQFF	1
GAGTCCGCTACCAGCTCCCAGACATCTGTGTACTTCTGTGCCACCGCCCCGGGACTAGCGGGATACAATGAGCAGTTCTTCGGGCCA	CATAPGLAGYNEQFF	1
GAGTCGGCTGCTCCCTCCCAGACATCTGTGTACTTCTGTGCCAGCAGTGAATTCAGGCCTTCCACAGATACGCAGTATTTTGGCCCA	CASSEFRPSTDTQYF	3
ACGATCCAGCGCACACAGCAGGAGGACTCGGCCGTGTATCTCTGTGCCAGCAGCCCCTCGCCCAGGGGACGCTACACCTTCGGTTCG	CASSPSPRGRYTF	1
GCCTTGGAGCTGGACGACTCGGCCCTGTATCTCTGTGCCAGCAGCTTGGACTCTCGGGACTACGGCTTGGAGCAGTACTTCGGGCCG	CASSLDSRDYGLEQYF	1
GCGGGGGGACTCAGCCGTGTATCTCTGTGCCAGCAGCTCTAGGGTAGGGTAGCGGTCGCCGTGGACCATGAGCAGTTCTTCGGGCCA		1
CTCTCTGGAGCTGGGGGACTCAGCTTTGTATTTCTGTGCCAGCAGCGCGGCAAGCAGAAGCGCTACTACGAGCAGTACTTCGGGCCG		1
TTGGAGCTGGACGACTCGGCCCTGTATCTCTGTGCCAGCAGTCCCGGACTGGGTAGCGGGGGTCAAGAGACCCAGTACTTCGGGCCA	CASSPGLGSGGQETQYF	1
CTCTCAAGATCCAGCCTGCAGAGCTTGGGGACTCGGCCATGTATCTCTGTGCCGGGACGCAGTGATGAAAAACTGTTTTTTGGCAGT		1
GAGTCGCCCAGCCCCAACCAGACCTCTCTGTACTTCTGTGCCAGCAGCTTAGGGACAACCGAGGGGGAGACCCAGTACTTCGGGCCA	CASSLGTTEGETQYF	1
TCCCTGGAGCTTGGTGACTCTGCTGTGTATTTCTGTGCCAGCAGCTCACGGACAGGGGGAGGGAACACTGAAGCTTTCTTTGGACAA	CASSSRTGGGNTEAFF	1
GCGCACAGAGCGGGGGGACTCAGCCGTGTATCTCTGTGCCAGCAGCGGGCGGACAGAAGCTCCTACAATGAGCAGTTCTTCGGGCCA		1
TCTGCTGTACCCTCTCAGACATCTGTGTACTTCTGTGCCAGCACCGGGAGGCGGGGACGGTTTTTTCAGCCCCAGCATTTTGGTGAT	CASTGRRGRFFQPQHF	1
AGGCTGGAGTCGGCTGCTCCCTCCCAGACATCTGTGTACTTCTGTGCCAGCACGATAGGGGTCTACAATGAGCAGTTCTTCGGGCCA	CASTIGVYNEQFF	1
ACTCTGGAGTCTGCTGCCTCCTCCCAGACATCTGTATATTTCTGCGCCAGCAACGACAGGGCGAACACTGAAGCTTTCTTTGGACAA	CASNDRANTEAFF	1
CAAGATCCAGCCTGCAGAGCTTGGGGACTCGGCCGTGTATCTCTGTGCCAGCAGCCCTTGGACAACACTGAAGCTTTCTTTGGACAA		1
CCTGGAGCTTGGTGACTCTGCTGTGTATTTCTGTGCCAGCAGCCAACCAGGGGACCCACCATGAACACTGAAGCTTTCTTTGGACAA		1
CAGCGCACAGAGCAGGGGGACTCGGCCATGTATCTCTGTGCCAGCAGCCCTCGTTGGGGCGGCTTTTATGAACAGTTCTTCGGGCCA	CASSPRWGGFYEQFF	1
TGACTCTGCTGTGTATTTCTGTGCCACCGAGACCTATCCCCCCCCGGGACTAGCGGGGGGGGGCAAGAGACCCAGTACTTCGGGCCA		1
ACTCTGAAGATCCAGCCCTCAGAACCCAGGGACTCAGCTGTGTACTTCTGTGCCAGCAGTTTATACGAGACCCAGTACTTCGGGCCA	CASSLYETQYF	1
CTGAAGATCCGGTCCACAAAGCTGGAGGACTCAGCCATGTACTTCTGTGCCAGCAGTGAGGAGGGATATGAGCAGTTCTTCGGGCCA	CASSEEGYEQFF	1
GAGTCGCCCAGCCCCAACCAGACCTCTCTGTACTTCTGTGCCAGCAGTCAGGAGGCTAGCGTTCGCTACGAGCAGTACTTCGGGCCG	CASSQEASVRYEQYF	3
AAGATCCAGCCCTCAGAACCCAGGGACTCAGCTGTGTACTTCTGTGCCAGCAGTTCTTGGACTGAGCAGCCCCAGCATTTTGGTGAT	CASSSWTEQPQHF	1
CCCTCAGAACCCAGGGACTCAGCTGTGTACTTCTGTGCCAGCAGTACAACAGGAACCAAGAGCTCCTACGAGCAGTACTTCGGGCCA	CASSTTGTKSSYEQYF	1
AGGATCCAGCAGGTAGTGCGAGGAGATTCGGCAGCTTATTTCTGTGCCAGCTCACCACCGACTGTAGATACGCAGTATTTTGGCCCA	CASSPPTVDTQYF	1
AACGCCTTGTTGCTGGGGGACTCGGCCCTGTATCTCTGTGCCAGCAGGCCGGACAGGGCTTCCACAGATACGCAGTATTTTGGCCCA	CASRPDRASTDTQYF	1
ACAGTGACCAGTGCCCATCCTGAAGACAGCAGCTTCTACATCTGCAGCGCAAGGCGGGGGGTCCAAGAGACCCAGTACTTCGGGCCA	CSARRGVQETQYF	1
GAGCTGGACGACTCGGCCCTGTATCTCTGTGCCAGCAGCTTAGGCCCGGGACGGCCCTCTGGGGCCAACGTCCTGACTTTCGGGGCC	CASSLGPGRPSGANVLTF	1
TCTAAGAAGCTCCTTCTCAGTGACTCTGGCTTCTATCTCTGTGCCTGGAGTGTTGGGAGCGGGGCCTACGAGCAGTACTTCGGGCCG	CAWSVGSGAYEQYF	1
ATGAGCTCCTTGGAGCTGGGGGACTCAGCCCTGTACTTCTGTGCCAGCAGCCCGGGACGGGCCACAGATACGCAGTATTTTGGCCCA	CASSPGRATDTQYF	1
TGGAGCTGGGGGACTCAGCTTTGTATTTCTGTGCCAGCAGCGTACAGACTAGCGGGGGGGGCGCGAGATACGCAGTATTTTGGCCCA		1
GTGAGCACCTTGGAGCTGGGGGACTCGGCCCTTTATCTTTGCGCCAGCAGCGCAAAACAGGGAAATTCACCCCTCCACTTTGGGAAC	CASSAKQGNSPLHF	1
TCCCAGACATCTGTGTACTTCTGTGCCAGCAGTGAATATCTGGGACTAGCGGGCTTTGCGAACACCGGGGAGCTGTTTTTTGGAGAA	CASSEYLGLAGFANTGELFF	1
AACGCCTTGTTGCTGGGGGACTCGGCCCTCTATCTCTGTGCCAGCAGCTTAGGCGGGGGGGCCTCTTACGAGCAGTACTTCGGGCCG	CASSLGGGASYEQYF	1
CAGCGCACACAGCAGGAGGACTCGGCCGTGTATCTCTGTGCCAGCAGCCAGGTGGCGGACACCACCTACGAGCAGTACTTCGGGCCG	CASSQVADTTYEQYF	1
GACACGGCACTGTATCTCTGCGCCAGCAGTACCCCACCCAACGTTCCGGGACAGGGGGCGCTCTTTATGGAAGCTTTCTTTGGACAA	CASSTPPNVPGQGALFMEAFF	1
CCAGTGCCCATCCTGAAGACAGCAGCTTCTACATCTGCAGTGCTAGTAATAGTAGGGGGGAGCACAGATACGCAGTATTTTGGCCCA		1
AGGCTGGAGTTGGCTGCTCCCTCCCAGACATCTGTGTACTTCTGTGCCAGCAGTTACTCCCCGGATCAGCCCCAGCATTTTGGTGAT	CASSYSPDQPQHF	1
GAGTCGGCTGCTCCCTCCCAAACATCTGTGTACTTCTGTGCCAGCAGTTACTTGCGGAGCTCCTACAATGAGCAGTTCTTCGGGCCA	CASSYLRSSYNEQFF	1
CTCAGGCTGGAGTTGGCTGCTCCCTCCCAGACATCTGTGTACTTCTGTGCCAGCATGGGGCCCAATTCACCCCTCCACTTTGGGAAC	CASMGPNSPLHF	1
CAGCGCACAGAGCGGGGGGACTCAGCCGTGTATCTCTGTGCCAGCAGCCAAGGGACTAGCCGCTACAATGAGCAGTTCTTCGGGCCA	CASSQGTSRYNEQFF	1
CAGCGCACACAGCAGGAGGACTCGGCCGTGTATCTCTGTGCCAGCAGCTTGGCTAGCGGGAGGAACGACGAGCAGTACTTCGGGCCA	CASSLASGRNDEQYF	7
AGTGCCCATCCTGAAGACAGCAGCTTCTACATCTGCAGTGCTAGAGCGAGGGACAGGTGGAACACCGGGGAGCTGTTTTTTGGAGAA	CSARARDRWNTGELFF	7
ACACAGCAGGAGGACTCGGCCGTGTATCTCTGTGCCAGCAGCCCGGGGCCCAGGACCTCAACTAATGAAAAACTGTTTTTTGGCAGT	CASSPGPRTSTNEKLFF	1
ACATCGGCCCAAAAGAACCCGACAGCTTTCTATCTCTGTGCCAGTAGTATAGGTACTCAGGGAAACTATGGCTACACCTTCGGTTCG	CASSIGTQGNYGYTF	1
ACCTTGGAGCTGGGGGACTCGGCCCTTTATCTTTGCGCCAGCAGCTTGGGCCTGGATGGCAGTAACAATGAGCAGTTCTTCGGGCCA	CASSLGLDGSNNEQFF	6
AGTCTGCCATCCCCAACCAGACAGCTCTTTACTTCTGTGCCACCAGTGACCCCGGGACAGGGCCCCTACGAGCAGTACTTCGGGCCG		1
TCGGCTGCTCCCTCCCAGACATCTGTGTACTTCTGTGCCAGCAGTTGGGGAGGGAGGCCTAGCACAGATACGCAGTATTTTGGCCCA	CASSWGGRPSTDTQYF	1
CAGCGCACAGAGCAGGGGGACTCGGCCATGTATCTCTGTGCCAGCAGCTTACCCACCGGCTCCGTTGAGACCCAGTACTTCGGGCCA	CASSLPTGSVETQYF	1
ATCCGGTCCACAAAGCTGGAGGACTCAGCCATGTACTTCTGTGCCAGCAGGGAAAGGCTAGCCAAAAACATTCAGTACTTCGGCGCC	CASRERLAKNIQYF	1
ACGATCCAGCGCACACAGCAGGAGGACTCGGCCGTGTATCTCTGTGCCAGCAGCCCGAGACAGAACACTGAAGCTTTCTTTGGACAA	CASSPRQNTEAFF	1
AGGCTGCTGTCGGCTGCTCCCTCCCAGACATCTGTGTACTTCTGTGCCAGCAGTCGGGACAGGGAAAATGAGCAGTTCTTCGGGCCA	CASSRDRENEQFF	1
TGTGAACGCCTTGTTGCTGGGGGACTCGGCCCTGTATCTCTGTGCCAGCAGCTTGGCTGGAGTGGTAATGAGCAGTTCTTCGGGCCA		1
ACTGTGACATCGGCCCAAAAGAACCCGACAGCTTTCTATCTCTGTGCCAGTAGTAGGACAGGGGGCTACGAGCAGTACTTCGGGCCG	CASSRTGGYEQYF	2
AGGCTGGAGTCGGCTGCTCCCTCCCAGACATCTGTGTACTTCTGTGCCAGCAGTGAAGCAATTAGGGACAGAGAGTACTTCGGCGCC	CASSEAIRDREYF	1
ATCAATTCCCTGGAGCTTGGTGACTCTGCTGTGTATTTCTGTGCCAGCAGCCTCGGGTTTGGTACAGATACGCAGTATTTTGGCCCA	CASSLGFGTDTQYF	1
CACGCCCTGCAGCCAGAAGACTCAGCCCTGTATCTCTGCGCCAGCAGCCAAGGACTCCAGGGGGCGGTGGGGGCTTTCTTTGGACAA	CASSQGLQGAVGAFF	1
CTGGAGGACTCGGCCCTGTATCTCTGTGCCAGCAGCCAAATATTCGGACTAGCGGGGGGCCTACAAGAGACCCAGTACTTCGGGCCA	CASSQIFGLAGGLQETQYF	1
AGCACCTTGGAGCTGGGGGACTCGGCCCTTTATCTTTGCGCCAGCAGCGATAGCGGGAGTAACTCAGATACGCAGTATTTTGGCCCA	CASSDSGSNSDTQYF	5
CTGAGCTCTCTGGAGCTGGGGGACTCAGCTTTGTATTTCTGTGCCAGCACGAGAGGAGGGGTGGACACTGAAGCTTTCTTTGGACAA	CASTRGGVDTEAFF	1
AGTCCACGGAGTCAGGGGACACAGCACTGTATTTCTGTGCCAGCAGCACGGACAGGCTACATGAACACTGAAGCTTTCTTTGGACAA		1
ACAGTGACCAGTGCCCATCCTGAAGACAGCAGCTTCTACATCTGCAGTGCTGTCGGGACAGGGTCTGAAAAACTGTTTTTTGGCAGT	CSAVGTGSEKLFF	1
CCCTCCCAGACATCTGTGTACTTCTGTGCCAGCAGTTACTGTCGATTTTACCGGGACAGGGGGTGCCCACCCCAGCATTTTGGTGAT	CASSYCRFYRDRGCPPQHF	2
TGCTGTACCCTCTCAGACATCTGTGTACTTCTGTGCCAGCAGTGACCCGGAGCGGGAGCAAGCACAGATACGCAGTATTTTGGCCCA		2
AGCACCTTGGAGCTGGGGGACTCGGCCCTTTATCTTTGCGCCAGCAGCTCGGGACTTCCAGCTAGGGAGACCCAGTACTTCGGGCCA	CASSSGLPARETQYF	2
GCCCATCCTGAAGACAGCAGCTTCTACATCTGCAGTGCTGAACCTCCGGGACTAGCGGGAGTCTACAATGAGCAGTTCTTCGGGCCA	CSAEPPGLAGVYNEQFF	1
CGCACACAGCAGGAGGACTCGGCCGTGTATCTCTGTGCCAGCAGGGGACGACTAGCGGAGTACCAAGAGACCCAGTACTTCGGGCCA	CASRGRLAEYQETQYF	1
GAGTCTGCCAGGCCCTCACATACCTCTCAGTACCTCTGTGCCAGCAGTCCCCGGAGGGACATTTCCGACGAGCAGTACTTCGGGCCG	CASSPRRDISDEQYF	1
AGCAAGGGCGACTCGGCTGTGTATCTCTGTGCCAGAATAGGTCCGTGAAGTGGACAAGGTCGGGCCAACGTCCTGACTTTCGGGGCC	CARIGP*SGQGRANVLTF	1
GTGACCAGTGCCCATCCTGAAGACAGCAGCTTCTACATCTGCAGTGCCAGAATTAGCGGGAGGTACAATGAGCAGTTCTTCGGGCCA	CSARISGRYNEQFF	1
TCCGCTACCAGCTCCCAGACATCTGTGTACTTCTGTGCCATAAAGCCGGGACAGGGGGCCGGGGCCAACGTCCTGACTTTCGGGGCC	CAIKPGQGAGANVLTF	1
CTGTCGGCTGCTCCCTCCCAGACATCTGTGTACTTCTGTGCCAGCAGGCATAATACCGGGCCCCTCTATGGCTACACCTTCGGTTCG	CASRHNTGPLYGYTF	4
AATTCCCTGGAGCTTGGTGACTCTGCTGTGTATTTCTGTGCCAGCAGCCAAGGGTCGCAGGGGAGATGGGACTACACCTTCGGTTCG	CASSQGSQGRWDYTF	11
CCAGCGCACAGAGCGGGGGGACTCAGCCGTGTATCTCTGTGCCAGCAGCTTAATAGCAACATGAACACTGAAGCTTTCTTTGGACAA		1
TCCCTGGAGCTTGGTGACTCTGCTGTGTATTTCTGTGCCAGCAGCCCAAGGGTAGCGGGGGCCTACAATGAGCAGTTCTTCGGGCCA	CASSPRVAGAYNEQFF	1
CTGCTGTCGGCTGCTCCCTCCCAGACATCTGTGTACTTCTGTGCCAGCAACCGACAGGGGGCGGACGACGAGCAGTACTTCGGGCCG	CASNRQGADDEQYF	1
TCGCCCAGCCCCAACCAGACCTCTCTGTACTTCTGTGCCAGCAGTATAAGCGGGTCTCATAAGGGCAATGAGCAGTTCTTCGGGCCA	CASSISGSHKGNEQFF	1
AAGATCCAGCCTGCAGAGCTTGGGGACTCGGCCGTGTATCTCTGTGCCAGCAGCTTTACTAGCGGCTACGAGCAGTACTTCGGGCCG	CASSFTSGYEQYF	1
CCAGCCCATGGAACCCAGGGACTTGGGCCTATATTTCTGTGCCACCTCGTAAGGGAGGAGCCCTACAATGAGCAGTTCTTCGGGCCA		1
TCTCTGGAGCTGGGGGACTCAGCTTTGTATTTCTGTGCCAGCAGCGTAGAAGGTAAGGGCAGCTTCTACGAGCAGTACTTCGGGCCG	CASSVEGKGSFYEQYF	1
AGGCTGCTGTCGGCTGCTCCCTCCCAGACACCTGTGTACTTCTGTGCCAGCAGTTACAGGGCTTTGGGAGAAGCTTTCTTTGGACAA	CASSYRALGEAFF	1
GCCCAGCCCCAACCAGACCTCTCTGTACTTCTGTGCCAGCAGTTTACACGGTATGGGGGGGGTTCCTACGAGCAGTACTTCGGGCCG		1
AATTCCCTGGAGCTTGGTGACTCTGCTGTGTATTTCTGTGCCAGCAGCCAAGGCTGGACAACTAATGAAAAACTGTTTTTTGGCAGT	CASSQGWTTNEKLFF	1
GAGTCTGCCAGGCCCTCACATACCTCTCAGTACCTCTGTGCCAGCAGTGAGGGACTAGCGGGGGTAAATGAGCAGTTCTTCGGGCCA	CASSEGLAGVNEQFF	1
ATCCAGCCCTCAGAACCCAGGGACTCAGCTGTGTACTTCTGTGCCAGCGGGGTTGTTCTTAACACCGGGGAGCTGTTTTTTGGAGAA	CASGVVLNTGELFF	1
CTGCAAAGCTTGAGGACTCGGCCGTGTATCTCTGTGCCAGCAGCCGTACAGGGTTACTCTGGGGCCAACGTCCTGACTTTCGGGGCC		1
GGCGTCTGCTGTACCCTCTCAGACATCTGTGTACTTCTGTGCCAGCAGTCAAAGGCGGGACAGGGGGCTTAGCAGTACTTCGGGCCG		1
CACACCCTGCAGCCAGAAGACTCGGCCCTGTATCTCTGCGCCAGCAGCCAAGATCTGGCTACTTACAATGAGCAGTTCTTCGGGCCA	CASSQDLATYNEQFF	1
ATCCAGCCCTCAGAACCCAGGGACTCAGCTGTGTATTTTTGTGCTAGTGGTCCGCGAGGGAGTACCTACGAGCAGTACTTCGGGCCG	CASGPRGSTYEQYF	1
GCAAAGCTTGAGGACTCGGCCGTGTATCTCTGTGCCAGCAGACCCGGGACAGTCGGGCCTTCCAACACTGAAGCTTTCTTTGGACAA	CASRPGTVGPSNTEAFF	1
CACGCCCTGCAGCCAGAAGACTCAGCCCTGTATCTCTGCGCCAGCAGCCAAGGAGAGACAGGGGTAGGCGAGCAGTACTTCGGGCCG	CASSQGETGVGEQYF	1
CTCAGGCTGCTGTCGGCTGCTCCCTCCCAGACATCTGTGTACTTCTGTGCCAGCAGTTACCGGGGGAATGAGCAGTTCTTCGGGCCA	CASSYRGNEQFF	1
CAGAGCGGGGGGACTCAGCCGTGTATCTCTGTGCCAGCAGCTGTTTGAGATGACAGGGGGAAGTCCTACGAGCAGTACTTCGGGCCG		1
AGGACTCGGCCGTGTATCTCTGTGCCAGCAGCTCCTGGACTAGCGGGGGGTACCTACTCTGGGGCCAACGTCCTGACTTTCGGGGCC		1
ATCCGGTCCACAAAGCTGGAGGACTCAGCCATGTACTTCTGTGCCAGCAGCGGCCAGTATCGTACCGGGGAGCTGTTTTTTGGAGAA	CASSGQYRTGELFF	4
CAGCGCACAGAGCGGGGGGACTCAGCCGTGTATCTCTGTGCCAGCAGCTTAGGGTTCGGGGGGCACTACGAGCAGTACTTCGGGCCA	CASSLGFGGHYEQYF	1
CTGCTGTCGGCTGCTCCCTCCCAGACATCTGTGTACTTCTGTGCCAGCAGGCAAACTAGCGGGAGAAACGAGCAGTACTTCGGGCCG	CASRQTSGRNEQYF	1
CTGCTGTCGGCTGCTCCCTCCCAGACATCTGTGTACTTCTGTGCCAGCAGCCCCATCGGGGGCGACACTGAAGCTTTCTTTGGACAA	CASSPIGGDTEAFF	4
CAGCGCACAGAGCAGGGGGACTCGGCCATGTATCTCTGTGCCAGCAGCTTAGCTTTCTCGGACACCGGGGAGCTGTTTTTTGGAGAA	CASSLAFSDTGELFF	5
ATCCAGCCCTCAGAACCCAGGGACTCAGCTGTGTACTTCTGTGCCAGCAGTTCCCGACCGGGACAGCTCGAGCAGTACTTCGGGCCG	CASSSRPGQLEQYF	1
AATGTGAACGCCTTGTTGCTGGGGGACTCGGCCCTCTATCTCTGTGCCAGCAGGCCCGGGATGGGGACTGAAGCTTTCTTTGGACAA	CASRPGMGTEAFF	1
TGACATCGGCCCAAAAGAACCCGACAGCTTTCTATCTCTGTGCCAGTAGTATTGGGGGGGGCAAAGCAGCCCCAGCATTTTGGTGAT		1
GAGCTTGGGGACTCGGCCGTGTATCTCTGTGCCAGCAGCTCAGGGACAGGGGCGGCCCTCTCCTACAATGAGCAGTTCTTCGGGCCA	CASSSGTGAALSYNEQFF	1
AATTCCCTGGAGCTTGGTGACTCTGCTGTGTATTTCTGTGCCAGCAGCCAAGTTAGCGGGGGTTGGTCTGAAGCTTTCTTTGGACAA	CASSQVSGGWSEAFF	1
ATCCAGCGCACACAGCAGGAGGACTCCGCCGTGTATCTCTGTGCCAGCAGCTTAGCGCCGGGCTCCTACGAGCAGTACTTCGGGCCG	CASSLAPGSYEQYF	6
CTGTCGGCTGCTCCCTCCCAGACATCTGTGTACTTCTGTGCCAGCAGCTCGGACAGGGACGATAATTCACCCCTCCACTTTGGGAAC	CASSSDRDDNSPLHF	1
ACACAGCAGGAGGACTCGGCCGTGTATCTCTGTGCCAGCAGCTTAGATAGCGGGAAAGTGGTCACAGATACGCAGTATTTTGGCCCA	CASSLDSGKVVTDTQYF	1
CTCAAGATCCAGCCTGCAAAGCTTGAGGACTCGGCCGTGTATCTCTGTGCCAGCAGCTTAGCGGGTAATGAGCAGTTCTTCGGGCCA	CASSLAGNEQFF	1
AACGCCTTGTTGCTGGGGGACTCGGCCCTCTATCTCTGTGCCAGCAGCTTCGGGACAGGGCGGGCCGGGGAGCTGTTTTTTGGAGAA	CASSFGTGRAGELFF	1
GGATCCAGCAGGTAGTGCGAGGAGATTCGGCAGCTTATTTCTGTGCCAGCTCAAGGGACAGGGAGGCACGAGCAGTACTTCGGGCCG		1
AGGCTGGAGTTGGCTGCTCCCTCCCAGACATCTGTGTACTTCTGTGCCAGCACTATAACAGCGAACTATGGCTACACCTTCGGTTCG	CASTITANYGYTF	1
CGCACACAGCAGGAGGACTCGGCCGTGTATCTCTGTGCCAGCAGCTCTACCGGGACCCCAGTAGCCGGGGAGCTGTTTTTTGGAGAA	CASSSTGTPVAGELFF	1
AACGCCTTGTTGCTGGGGGACTCGGCCCTCTATCTCTGTGCCAGCAGCTTATCCCCAGGGTCCTACTATGGCTACACCTTCGGTTCG	CASSLSPGSYYGYTF	1
CTGTACCCTCTCAGACATCTGTGTACTTCTGTGCCAGCAGTGACTCGAGTCGGGGAGGGGACCATCAATGAGCAGTTCTTCGGGCCA		1
GGGTTGGAGTCGGCTGCTCCCTCCCAAACATCTGTGTACTTCTGTGCCTCTGGGCCCGGGGGGTACAATGAGCAGTTCTTCGGGCCA	CASGPGGYNEQFF	2
CAGCAGGTAGTGCGAGGAGATTCGGCAGCTTATTTCTGTGCCAGCTCACCGACAGGGAACAATAACTATGGCTACACCTTCGGTTCG	CASSPTGNNNYGYTF	1
TCAGAACCCAGGGACTCAGCTGTGTACTTCTGTGCCAGCACCCCCAGACAGGGGGCCTCTGGCACAGATACGCAGTATTTTGGCCCA	CASTPRQGASGTDTQYF	2
ACCTTGGAGCTGGGGGACTCGGCCCTTTATCTTTGCGCCAGCAGCTTGGGGACAGTAGATAGCAATCAGCCCCAGCATTTTGGTGAT	CASSLGTVDSNQPQHF	1
CGCACACAGCAGGAGGACTCGGCCGTGTATCTCTGTGCCAGCAGCTTAGGTGAAAAGGCCGGGAGTCAGACCCAGTACTTCGGGCCA	CASSLGEKAGSQTQYF	1
AGCACCTTGGAGCTGGGGGACTCGGCCCTTTATCTTTGCGCCAGCAGGTTACAGCCCGCAACTAATGAAAAACTGTTTTTTGGCAGT	CASRLQPATNEKLFF	1
CCTGCAGAGCTTGGGGACTCGGCCATGTATCTCTGTGCCAGCAGCTTAGCGGACAGGGGCGGCACAGATACGCAGTATTTTGGCCCA	CASSLADRGGTDTQYF	1
GTGACCAGTGCCCATCCTGAAGACAGCAGCTTCTACATCTGCAGTGCTGAGCCTAGCAATAGCAATCAGCCCCAGCATTTTGGTGAT	CSAEPSNSNQPQHF	2
ACCTTGGAGCTGGGGGACTCGGCCCTTTATCTTTGCGCCAGCAGCAGGGCCGGGACTAGCGGAGGAGAGACCCAGTACTTCGGGCCA	CASSRAGTSGGETQYF	1
ATCAATTCCCTGGAGCTTGGTGACTCTGCTGTGTATTTCTGTGCCAGCAGCCAAGATCACAGGGGGTGTGAGCAGTTCTTCGGGCCA	CASSQDHRGCEQFF	1
TCCGCCAGCACCAACCAGACATCTATGTACCTCTGTGCCAGCAGTTTATCCCCAGGGGCAGGTAATTCACCCCTCCACTTTGGGAAC	CASSLSPGAGNSPLHF	1
ATTCTGGAGTCCGCCAGCACCAACCAGACATCTATGTACCTCTGTGCCAGCAGTGGGACTCCAGATGAGACCCTCCACTTTGGGAAC	CASSGTPDETLHF	1
CTTGGAGCTGGACGACTCGGCCCTGTATCTCTGTGCCAGCAGCTATTACCGGGGCCGAGCTCTGGAAACACCATATATTTTGGAGAG		1
GCTACCAGCTCCCAGACATCTGTGTACTTCTGTGCCATCAGTGGGGGAAGACAGGAGGGGATGAACACTGAAGCTTTCTTTGGACAA	CAISGGRQEGMNTEAFF	1
AATTCCCTGGAGCTTGGTGACTCTGCTGTGTATTTCTGTGCCAGCAGCCAAGACTGGGGCCGGGAAGAGACCCAGTACTTCGGGCCA	CASSQDWGREETQYF	1
TTGGAGCTGGGGGACTCGGCCCTTTATCTTTGCGCCAGCAGCTTGGGGTTAGCCGGAGGGGTCAATCAGCCCCAGCATTTTGGTGAT	CASSLGLAGGVNQPQHF	1
ACATCGGCCCAAAAGAACCCGACAGCTTTCTATCTCTGTGCCGGAGGGGGAGGGGGTAGCCAGAAATCCGGCTACACCTTCGGTTCG	CAGGGGGSQKSGYTF	1
GGCGTCTGCTGTACCCTCTCAGACATCTGTGTACTTCTGTGCCAGCAAGGGACCGCTCGCCCCTACAATGAGCAGTTCTTCGGGCCA		2
CGCACAGAGCAGGGGGACTCGGCCATGTATCTCTGTGCCAGCCTTTCCGGGGGCGAGTTATCCACCGGGGAGCTGTTTTTTGGAGAA	CASLSGGELSTGELFF	1
TCTAAGAAGCTCCTTCTCAGTGACTCTGGCTTCTATCTCTGTGCCAGCGGGAGTTTATCGGGGGCCGATACGCAGTATTTTGGCCCA	CASGSLSGADTQYF	1
ACTGTGAGCAACATGAGCCCTGAAGACAGCAGCATATATCTCTGCAGCGTATGCGTGGCGCATAACACTGAAGCTTTCTTTGGACAA	CSVCVAHNTEAFF	1
ACACAGCAGGAGGACTCCGCCGTGTATCTCTGTGCCAGCAGCCCCCAAACCGGGCAGGGTCCTGACTATGGCTACACCTTCGGTTCG	CASSPQTGQGPDYGYTF	1
GGCTGCTCCCTCCCAGACATCTGTGTACTTCTGTGCCAGCAGTGAAGGTTGCAGGGGGTCGTGTGCGATGGCTACACCTTCGGTTCG		1
CTGGAGTCGGCTGCTCCCTCCCAGACATCTGTGTACTTCTGTGCCAGCAGACATCCCCCAACAGGTCCTAGGGAGTACTTCGGGCCG	CASRHPPTGPREYF	1
CAGCCTGCAAAGCTTGAGGACTCGGCCGTGTATCTCTGTGCCAGCAGCTTAAGTGGACCTCCATCCAAAGGCTACACCTTCGGTTCG	CASSLSGPPSKGYTF	2
CACACCCTGCAGCCAGAAGACTCGGCCCTGTATCTCTGTGCCAGCAGCCAAGTCTTGGGATCCGGCTATGGCTACACCTTCGGTTCG	CASSQVLGSGYGYTF	1
CTGGAGTCTGCTGCCTCCTCCCAGACATCTGTATATTTCTGCGCCAGCAGTCCCTTGACAGGGACCTACGAGCAGTACTTCGGGCCG	CASSPLTGTYEQYF	2
AAGATCCAGCCCTCAGAACCCAGGGACTCAGCTGTGTACTTCTGTGCCAGCAGTAAGGGGCTGGACACTGAAGCTTTCTTTGGACAA	CASSKGLDTEAFF	2
AAGATCCAGCGCACAGAGCGGGGGGACTCAGCCGTGTATCTCTGTGCATGCGGGGGCCGTAACACCGGGGAGCTGTTTTTTGGAGAA	CACGGRNTGELFF	1
AACCCGACAGCTTTCTATCTCTGTGCCAGTAGTATAAGGAGATTAGCGGGGGGGCCAATCCCAAACAATGAGCAGTTCTTCGGGCCA	CASSIRRLAGGPIPNNEQFF	2
AGCTCTCTGGAGCTGGGGGACTCAGCTTTGTATTTCTGTGCCAGCAGCGCCCCGGGACACCCGGCGGAGACCCAGTACTTCGGGCCA	CASSAPGHPAETQYF	2
CTGAGCTCTCTGGAGCTGGGGGACTCAGCTTTGTATTTCTGTGCCAGCAGCGTAGCAGGGCTCTCCTACGAGCAGTACTTCGGGCCG	CASSVAGLSYEQYF	1
AATTCCCTGGAGCTTGGTGACTCTGCTGTGTATTTCTGTGCCAGCAGCCAAGTTGGCATAACCAAAAACATTCAGTACTTCGGCGCC	CASSQVGITKNIQYF	1
ACCAGTGCCCATCCTGAAGACAGCAGCTTCTACATCTGCAGTGCTAGTTGGAGCGGGGGGCCCTCCTACGAGCAGTACTTCGGGCCG	CSASWSGGPSYEQYF	1
GCGCACACAGCAGGAGGACTCGGCCGTGTATCTCTGTGCCAGCAGCTTAGGAGTCAGGATATGGCCGGGGAGCTGTTTTTTGGAGAA		1
ATTCCCTGGAGCTTGGTGACTCTGCTGTGTATTTCTGTGCCAGCAGCCAAGATCACAGGGGGGGACTATGGCTACACCTTCGGTTCG		1
CAGCCTGCAGAACTGGAGGATTCTGGAGTTTATTTCTGTGCCAGCAGCTTCGGACAGGGAGGCCTTCGCGAGCAGTACTTCGGGCCG	CASSFGQGGLREQYF	1
AGGGACTCAGCTGTGTACTTCTGTGCCAGCAGTTTCCCTGCTAGCGGAGGTTACCTAAGCTCCTACAATGAGCAGTTCTTCGGGCCA	CASSFPASGGYLSSYNEQFF	1
TCCACAAAGCTGGAGGACTCAGCCATGTACTTCTGTGCCAGCGTGGCGACTATGCTCTCTGGGGCCAACGTCCTGACTTTCGGGGCC	CASVATMLSGANVLTF	1
CAGAGCTTGGGGACTCGGCCATGTATCTCTGTGCCACCCCGGTCCGGGACATACCAATATAGCAATCAGCCCCAGCATTTTGGTGAT		1
CTGCTGTCGGCTGCTCCCTCCCAGACATCTGTGTACTTCTGTGCCAGCAGCCCGACAGGGGCGATGGGTGGCTACACCTTCGGTTCG	CASSPTGAMGGYTF	1
TCAGGGGACACAGCACTGTATTTCTGTGCCAGCAGCTTCTGGGACAGGGCCCCATTCGCAACTAATGAAAAACTGTTTTTTGGCAGT	CASSFWDRAPFATNEKLFF	1
TCGGCCCAAAAGAACCCGACAGCTTTCTATCTCTGTGCCAGTAGTATACAGAACAGGAGAGGCACAGATACGCAGTATTTTGGCCCA	CASSIQNRRGTDTQYF	1
AACGCCTTGTTGCTGGGGGACTCGGCCCTCTATCTCTGTGCCAGCAGCTTGCTCTCAGGGGGCACAGATACGCAGTATTTTGGCCCA	CASSLLSGGTDTQYF	1
GAGTCGGCTGCTCCCTCCCAGACATCTGTGTACTTCTGTGCCAGCAGAACCTCCGGACGGGGGGAAGAGACCCAGTACTTCGGGCCA	CASRTSGRGEETQYF	1
ATCCAGCCTGCAGAGCTTGGGGACTCGGCCGTGTATCTCTGTGCCAGCAGCTTTGGACAGGGTTCCTACGAGCAGTACTTCGGGCCG	CASSFGQGSYEQYF	1
CAGCCCTCAGAACCCAGGGACTCAGCTGTGTACTTCTGTGCCAGCAGGCAAGGACAAGGGGAAGGATATGGCTACACCTTCGGTTCG	CASRQGQGEGYGYTF	1
CCAGCCTGCAGAGCTTGGGGACTCGGCCGTGTATCTCTGTGCCAGCAACGTGCGGGACAGGCCTACAATGAGCAGTTCTTCGGGCCA		1
CCATCCCCAACCAGACAGCTCTTTACTTCTGTGCCACCAGTGACAGGGGGCGCGGAGGAAACTAATGAAAAACTGTTTTTTGGCAGT		1
ACCAGTGCCCATCCTGAAGACAGCAGCTTCTACATCTGCAGTGCTAGAGACCCCGCAGGGAGCTCCTACGAGCAGTACTTCGGGCCA	CSARDPAGSSYEQYF	2
ACCTTGGAGCTGGGGGACTCGGCCCTTTATCTTTGCGCCAGCAGCTTGGGATAGCGGGAGTGGATCGGGGAGCTGTTTTTTGGAGAA	CASSLG*REWIGELFF	1
TGTGAACGCCTTGGAGCTGGACGACTCGGCCCTGTATCTCTGTGCCAGCAGCCAGCCAGCTTAGAGCGGCCCCAGCATTTTGGTGAT		1
AACGCCTTGTTGCTGGGGGACTCGGCCCTCTATCTCTGTGCCAGCAGCTTCGGGGCGAGCGGGAGAGATACGCAGTATTTTGGCCCA	CASSFGASGRDTQYF	2
CACTCTGGAGTCTGCTGCCTCCTCCCAGACATCTGTATATTTCTGCGCCAGCAGTATTTGGCTCATGTCGAGCAGTACTTCGGGCCG		1
ATCCAGCGCACACAGCAGGAGGACTCCGCCGTGTATCTCTGTGCCAGCAGCTTAGAAAGCGGACCCTACGAGCAGTACTTCGGGCCG	CASSLESGPYEQYF	1
CAGCGCACAGAGCAGCGGGACTCAGCCATGTATCGCTGTGCTAGCAGCTTAAGAGCGGGATTGGACGGGGAGCTGTTTTTTGGAGAA	CASSLRAGLDGELFF	1
AATTCCCTGGAGCTTGGTGACTCTGCTGTGTATTTCTGTGCCAGCAGCCGAACATCGAGCTCTGGAAACACCATATATTTTGGAGAG	CASSRTSSSGNTIYF	1
CTGGGGTCCGCTACCAGCTCCCAGACATCTGTGTACTTCTGTGCCATCAATAAGGGGCCCCAGGAATATGGCTACACCTTCGGTTCG	CAINKGPQEYGYTF	1
ATCCAGCCCTCAGAACCCAGGGACTCAGCTGTGTACTTCTGTGCCAGCAGTTTTGGGAGGGGAACCGGGGAGCTGTTTTTTGGAGAA	CASSFGRGTGELFF	2
GATCCAGTCCACGGAGTCAGGGGACACAGCACTGTATTTCTGTGCCAGCAGCAACAGGGGCTCGGGGAGACCCAGTACTTCGGGCCA		1
TCGCCCAGCCCCAACCAGACCTCTCTGTACTTCTGTGCCAGCAGTTCCCGCAACCCAATGGGGGCAGATACGCAGTATTTTGGCCCA	CASSSRNPMGADTQYF	1
GCCTTGGAGCTGGACGACTCGGCCCTGTATCTCTGTGCCAGCAGGACACGACAGGGGGGTAGGACCGGGGAGCTGTTTTTTGGAGAA	CASRTRQGGRTGELFF	1
GCCCAGCCCCAACCAGACCTCTCTGTACTTCTGTGCCAGCAGTCCGACCGACTAGCGGGGACCACAGATACGCAGTATTTTGGCCCA		2
AGCACCTTGGAGCTGGGGGACTCGGCCCTTTATCTTTGCGCCAGCAGCCCAAAGACAGGGAATCCGGGGGAGCTGTTTTTTGGAGAA	CASSPKTGNPGELFF	1
CTGTCGGCTGCTCCCTCCCAGACATCTGTGTACTTCTGTGCCAGCAGTTAAAGGGACAGGGCTTGCAATGAGCAGTTCTTCGGGCCA	CASS*RDRACNEQFF	1
CTGATCCTGGAGTCGCCCAGCCCCAACCAGACCTCTCTGTACTTCTGTGCCAGCAGTTTTGGAGGGCGCCAGCAGTACTTCGGGCCG	CASSFGGRQQYF	2
GTGACATCGGCCCAAAAGAACCCGACAGCTTTCTATCTCTGTGCCAGTAGTACTACAGGGCCAAGCCAGCCCCAGCATTTTGGTGAT	CASSTTGPSQPQHF	1
CTACACACCCTGCAGCCAGAAGACTCGGCCCTGTATCTCTGTGCCAGCAGGCCCGGGACCAAGGGAAACACCATATATTTTGGAGAG	CASRPGTKGNTIYF	1
AGCAGCGGGACTCGGCCATGTATCGCTGTGCCAGCAGCTTAGTACCTCCACCTCCTCTATAGCAATCAGCCCCAGCATTTTGGTGAT		2
ACTCTGACTGTGAGCAACATGAGCCCTGAAGACAGCAGCATATATCTCTGCAGCGTTGAGTCTAATGAAAAACTGTTTTTTGGCAGT	CSVESNEKLFF	1
CTAGAGTCTGCCATCCCCAACCAGACAGCTCTTTACTTCTGTGCCACCGGGGACTCCCTGAGGAGCGGGGAGCTGTTTTTTGGAGAA	CATGDSLRSGELFF	1
GAGTCGCCCAGCCCCAACCAGACCTCTCTGTACTTCTGTGCCAGCAGTTTATTTCCAGGACTGAACACTGAAGCTTTCTTTGGACAA	CASSLFPGLNTEAFF	1
CTCCTTCTCAGTGACTCTGGCTTCTATCTCTGTGCCTGGTCCCTGAGGGGGCAATCTACGGCCAAAAACATTCAGTACTTCGGCGCC	CAWSLRGQSTAKNIQYF	1
CTGTCGGCTGCTCCCTCCCAGACATCTGTGTACTTCTGTGCCAGCAGTCCTCAAGCCGGGACAGCCTACGAGCAGTACTTCGGGCCG	CASSPQAGTAYEQYF	7
TCGGCCCAAAAGAACCCGACAGCTTTCTATCTCTGTGCCAGTAGTATAGTATTTAGAGGGGGCGATCAGCCCCAGCATTTTGGTGAT	CASSIVFRGGDQPQHF	1
AACGCCTTGGAGCTGGAGGACTCGGCCCTGTATCTCTGTGCCAGCAGCCTCTCACCTAGTGGGGGTGGTGAGCAGTTCTTCGGGCCA	CASSLSPSGGGEQFF	1
TCGCCCAGCCCCAACCAGACCTCTCTGTACTTCTGTGCCAGCAGTTTAGTGGGCGGGAGATTTAATGAAAAACTGTTTTTTGGCAGT	CASSLVGGRFNEKLFF	2
AACGCCTTGGAGCTGGAGGACTCGGCCCTGTATCTCTGTGCCAGCACGATCGGGAGTAAGAGCACCGGGGAGCTGTTTTTTGGAGAA	CASTIGSKSTGELFF	1
GTGACCAGTGCCCATCCTGAAGACAGCAGCTTCTACATCTGCAGTGCTAGAGGGGGTAAAGGGTGGGAGACCCAGTACTTCGGGCCA	CSARGGKGWETQYF	1
ATGTGAGCACCTTGGAGCTGGGGGACTCGGCCCTTTATCTTTGCGCCAGCAGCTCCGCGGGTGAACACTGAAGCTTTCTTTGGACAA		1
TCGGCCCAAAAGAACCCGACAGCTTTCTATCTCTGTGCCAGTAGCAGAAATTCACAGGGGGACCATCAGCCCCAGCATTTTGGTGAT	CASSRNSQGDHQPQHF	1
TCTCTGGAGCTGGGGGACTCAGCTTTGTATTTCTGTGCCAGCAGCCCTCTTGGAGGGGGCATGGGAAATGAGCAGTTCTTCGGGCCA	CASSPLGGGMGNEQFF	1
ACGATCCAGCGCACACAGCAGGAGGACTCGGCCGTGTATCTCTGTGCCAGCAGCCCCCGGGGCAACTATGGCTACACCTTCGGTTCG	CASSPRGNYGYTF	1
GTCCCTAGAGTCTGCCATCCCCAACCAGACAGCTCTTTACTTCTGTGCCACCAGTGATTTGCACATTATGGCTACACCTTCGGTTCG		1
CTGGAGTTGGCTGCTCCCTCCCAGACATCTGTGTACTTCTGTGCCACCCGAACAGGCTTCCGCTGGGATGAGCAGTTCTTCGGGCCA	CATRTGFRWDEQFF	1
ACTCTGACAGTGACCAGTGCCCATCCTGAAGACAGCAGCTTCTACATCTGCAGTGCGCCCTCGGGGGGTTTAGCTTTCTTTGGACAA	CSAPSGGLAFF	3
AGCACCTTGGAGCTGGGGGACTCGGCCCTTTATCTTTGCGCCAGCAGCTTGCAAGGGGGATTGAACACTGAAGCTTTCTTTGGACAA	CASSLQGGLNTEAFF	44
ATCCAGCCCTCAGAACCCAGGGACTCAGCTGTGTACTTCTGTGCCAGCAGTTTAGGACAGGGTGTCTACGAGCAGTACTTCGGGCCG	CASSLGQGVYEQYF	2
CTGAAGATCCGGTCCACAAAGCTGGAGGACTCAGCCATGTACTTCTGTGCCAGCAATGAGCAAACCTATGGCTACACCTTCGGTTCG	CASNEQTYGYTF	3
CTGCAGCCAGAAGACTCGGCCCTGTATCTCTGCGCCAGCAGCCAAGAACAAGAGCTACGCCATAATTCACCCCTCCACTTTGGGAAC	CASSQEQELRHNSPLHF	1
ACTGTGAGCAACATGAGCCCTGAAGACAGCAGCATATATCTCTGCAGCGTCCGCTCCCCGGGACAGGGAGGCTACACCTTCGGTTCG	CSVRSPGQGGYTF	1
ACCAGTGCCCATCCTGAAGACAGCAGCTTCTACATCTGCAGTGCTAGGGGTAGCGGGGGAGGCGAGTATACGCAGTATTTTGGCCCA	CSARGSGGGEYTQYF	1
CTTGTTGCTGGGGGACTCGGCCCTCTATCTCTGTGCCAGCAGCTTGGCTGTGGACATAAACAACCCGAAAAACTGTTTTTTGGCAGT		6
CAGCGCACACAGCAGGAGGACTCGGCCGTGTATCTCTGTGCCAGCAGCCCGACGTGGAGTAATGGAGAGACCCAGTACTTCGGGCCA	CASSPTWSNGETQYF	1
TAGAGTCTGCCATCCCCAACCAGACAGCTCTTTACTTCTGTGCCACGATCAGGGGGTTTTAGTACCGGGGAGCTGTTTTTTGGAGAA		1
CTGGAGTTGGCTGCTCCCTCCCAGACATCTGTGTACTTCTGTGCCAGCAGAAATTCAGGGGACGACTATGGCTACACCTTCGGTTCG	CASRNSGDDYGYTF	1
AATTCCCTGGAGCTTGGTGACTCTGCTGTGTATTTCTGTGCCAGCAGCCAAGATGCGGGGAGGGCCGGGGAGCTGTTTTTTGGAGAA	CASSQDAGRAGELFF	1
GCCCATCCTGAAGACAGCAGCTTCTACATCTGCAGTGCTGTGCGGACTAGCGGGCGAAGGTCTTCCTACGAGCAGTACTTCGGGCCG	CSAVRTSGRRSSYEQYF	1
TCCCTGGAGCTTGGTGACTCTGCTGTGTATTTCTGTGCCAGCAGCCAAGATGGGGGGCGGGTCGATCAGCCCCAGCATTTTGGTGAT	CASSQDGGRVDQPQHF	1
CCAGCGCACAGAGCGGGGGGACTCAGCCGTGTATCTCTGTGCCAGCAGCCGCCCACTGACAGCCTCACTGAAGCTTTCTTTGGACAA		1
CTCTGGAGCTGGGGGACTCAGCTTTGTATTTCTGTGCCAGCAGCATTATCCCGGGACTAGCGGGTCTACGAGCAGTACTTCGGGCCG		1
CTGGGGGACTCGGCCCTTTATCTTTGCGCCAGCAGCTTGGAACCGCTTAGCGGGAGCTTAGACACCGGGGAGCTGTTTTTTGGAGAA	CASSLEPLSGSLDTGELFF	1
CGCACAGAGCAGGGGGACTCGGCCATGTATCTCTGTGCCAGCAGCTTAGGTAGGGGCGGCCGCACAGATACGCAGTATTTTGGCCCA	CASSLGRGGRTDTQYF	2
TTGGAGTCGGCTGCTCCCTCCCAAACATCTGTGTACTTCTGTGCCAGTACTCGGACTGGGCCCTACAATGAGCAGTTCTTCGGGCCA	CASTRTGPYNEQFF	1
CACTGCAGCAAGAAGACTCAGCTGCGTATCTCTGCACCAGCAGCCAAGATGCGGGACAGGGACCAAGAGACCCAGTACTTCGGGCCA		1
CTGGAGTCTGCCAGGCCCTCACATACCTCTCAGTACCTCTGTGCCAGCACCTTGGGGGGGGCCACAGATACGCAGTATTTTGGCCCA	CASTLGGATDTQYF	1
GCTCTCTGGAGCTGGGGGACTCAGCTTTGTATTTCTGTGCCAGCCCCCACCGGGACCCCCTCCTCCGGGGAGCAGTACTTCGGGCCG		1
CTGACTGTGAGCAACATGAGCCCTGAAGACAGCAGCATATATCTCTGCAGCGTTGAAGGAGGGGTCAATGAGCAGTTCTTCGGGCCA	CSVEGGVNEQFF	1
GTCTGCTGTACCCTCTCAGACATCTGTGTACTTCTGTGCCAGCAATACCCCGGGGACAGGGTCTCCTACGAGCAGTACTTCGGGCCG		1
CAGCCTGCAAAGCTTGAGGACTCGGCCGTGTATCTCTGTGCCAGCAGCAAAGCCGGGACAGGGATGGACGAGCAGTACTTCGGGCCG	CASSKAGTGMDEQYF	3
AAGAAGCTCCTTCTCAGTGACTCTGGCTTCTATCTCTGTGCCTGGAGTGGGGTTTTTTTGAGGAACACTGAAGCTTTCTTTGGACAA	CAWSGVFLRNTEAFF	2
GCCCAAAAGAACCCGACAGCTTTCTATCTCTGTGCCAGTAGTAGATCGGGACTAGCGGATAGCACAGATACGCAGTATTTTGGCCCA	CASSRSGLADSTDTQYF	1
TCCCTGGAGCTTGGTGACTCTGCTGTGTATTTCTGTGCCAGCAGCCAAGATCGCAGGAACTCTGGAAACACCATATATTTTGGAGAG	CASSQDRRNSGNTIYF	5
GAACGCCTTGTTGCTGGGGGACTCGGCCCTCTATCTCTGTGCCAGCAGCGTTTCGCCGGGACAGTAAATGGCTACACCTTCGGTTCG		1
CAGCCCTCAGAACCCAGGGACTCAGCTGTGTACTTCTGTGCCAGCAGGCTTGGGGGATCCCCCTCCTACGAGCAGTACTTCGGGCCG	CASRLGGSPSYEQYF	1
GTGACATCGGCCCAAAAGAACCCGACAGCTTTCTATCTCTGTGCCAGTAGTATCTCCACAGGGAACACTGAAGCTTTCTTTGGACAA	CASSISTGNTEAFF	1
GAGTCGCCCAGCCCCAACCAGACCTCTCTGTACTTCTGTGCCAGCAGTTTATGGGGGGAAAGTTTAGAGACCCAGTACTTCGGGCCA	CASSLWGESLETQYF	1
CACGCCCTGCAGCCAGAAGACTCAGCCCTGTATCTCTGCGCCAGCAGCGCGGGCTTAGATAGCAATCAGCCCCAGCATTTTGGTGAT	CASSAGLDSNQPQHF	1
TTCCCTGGAGCTTGGTGACTCTGCTGTGTATTTCTGTGCCAGACGGAACTAGCGGGAGGACGCACAGATACGCAGTATTTTGGCCCA		1
ATCCGGTCCACAAAGCTGGAGGACTCAGCCATGTACTTCTGTGCCAGCAGTTCCGGGATCTTGAGCACTGAAGCTTTCTTTGGACAA	CASSSGILSTEAFF	19
CCACGGAGTCAGGGGACACAGCACTGTATTTCTGTGCCAGCAGCATGCGAGGGGCGGGAGGGCACAGATACGCAGTATTTTGGCCCA		3
CAGCAGGTAGTGCGAGGAGATTCGGCAGCTTATTTCTGTGCCAGCTCACCTACGGGGGGACTTGGCTACGAGCAGTACTTCGGGCCG	CASSPTGGLGYEQYF	1
AGGATCCAGCAGGTAGTGCGAGGAGATTCGGCAGCTTATTTCTGTGCCAGCTCACTTGGACAAGGAGAGACCCAGTACTTCGGGCCA	CASSLGQGETQYF	1
GTGCCTTGGAGCTGGGGGACTCGGCCCTGTATCTCTGTGCCAGAAGCTTTGGGGACTAGCGGCACCGGGGAGCTGTTTTTTGGAGAA		1
CAGCCCTCAGAACCCAGGGACTCAGCTGTGTACTTCTGTGCCAGCAGCCTCAGCACAGGGAGAACAGATACGCAGTATTTTGGCCCA	CASSLSTGRTDTQYF	6
CTCAGAACCCAGGGACTCAGCTGTGTACTTCTGTGCCAGCTCGAGGAAGATCAGGGTAGGTTCGGCACTGAAGCTTTCTTTGGACAA		1
CCCAGCCCCAACCAGACCTCTCTGTACTTCTGTGCCAGCAGTTTAAGTCCGAGGCGGCGGGCTGGAAACACCATATATTTTGGAGAG	CASSLSPRRRAGNTIYF	1
AGTGCCCATCCTGAAGACAGCAGCTTCTACATCTGCAGTGCTAGAGATTGGGGAGGGGGGCTGCCAGATACGCAGTATTTTGGCCCA	CSARDWGGGLPDTQYF	1
ATCCAGCCCTCAGAACCCAGGGACTCAGCTGTGTACTTCTGTGCCAGCAGTTTAGCAGGGGGGGAAGAAAAACTGTTTTTTGGCAGT	CASSLAGGEEKLFF	1
CAGCAGGAGGACTCCGCCGTGTATCTCTGTGCCAGCAGCTCAAATGGACAGGGAAGGGAAAAGGACTATGGCTACACCTTCGGTTCG	CASSSNGQGREKDYGYTF	2
GCCTTGGAGCTGGAGGACTCGGCCCTGTATCTCTGTGCCAGCAGCGGGGGGGACAGGGCAAACACAGATACGCAGTATTTTGGCCCA	CASSGGDRANTDTQYF	1
AGCCTGCAGAGCAGGGGGACTCGGCCGTGTATGTCTGTGCAAGTCGTTTTTACCGGGACAGAGACCTACGAGCAGTACTTCGGGCCG		3
AATGTGAACGCCTTGGAGCTGGACGACTCGGCCCTGTATCTCTGTGCCAGCAGCCTGCTAGGTGGCGATACGCAGTATTTTGGCCCA	CASSLLGGDTQYF	1
AAGCTCCTTCTCAGTGACTCTGGCTTCTATCTCTGTGCCTGGAGTGTAGGCACTAGCGGGAAGGGCAATGAGCAGTTCTTCGGGCCA	CAWSVGTSGKGNEQFF	1
TTGGCTGCTCCCTCCCAGACATCTGTGTACTTCTGTGCCAGCAGTTCCTCGACCGTTAGGGGGACCGGGGAGCTGTTTTTTGGAGAA	CASSSSTVRGTGELFF	1
AGGCTGGAGTTGGCTGCTCCCTCCCAGACATCTGTGTACTTCTGTGCCAGCAGCAGGACTAGTGGTAACGAGCAGTACTTCGGGCCG	CASSRTSGNEQYF	1
GTGAGCACCTTGGAGCTGGGGGACTCGGCCCTTTATCTTTGCGCCAGCAGCTTGCCGCTAGCGCCCAATGAGCAGTTCTTCGGGCCA	CASSLPLAPNEQFF	1
GCCTTGGAGCTGGAGGACTCGGCCCTGTATCTCTGTGCCAGCAGCTTGACGAAGCGGTCTAGCACAGATACGCAGTATTTTGGCCCA	CASSLTKRSSTDTQYF	1
GTGACATCGGCCCAAAAGAACCCGACAGCTTTCTATCTCTGTGCCAGTAGTAGGGGGATCTACACCGGGGAGCTGTTTTTTGGAGAA	CASSRGIYTGELFF	1
ACTGTGACATCGGCCCAAAAGAACCCGACAGCTTTCTATCTCTGTGCCAGTAAGGCTAGCGGGTTCCAGAACTTGTACTTCGGGCCG	CASKASGFQNLYF	1
CCAGACAGCTCTTTACTTCTGTGCCACCAGTGATGGGGACAAAAGAGCAGAGGAGTACGGGGTACAGATACGCAGTATTTTGGCCCA		1
AGTGCCCATCCTGAAGACAGCAGCTTCTACATCTGCAGTGCTCTCCAACCGACCACCCGGGGTTCTCAGGGCTACACCTTCGGTTCG	CSALQPTTRGSQGYTF	1
TGCAGCAAGAAGACTCAGCTGCGTATCTCTGCACCAGCAGCCAAAAGGGGACTAGCGGCTGGATACAATGAGCAGTTCTTCGGGCCA		1
GACCAGTGCCCATCCTGAAGACAGCAGCTTCTACATCTGCAGTGCCCCCCCCTGACTAGCGGGAAGGGGACCCAGTACTTCGGGCCA		4
CCTCTCACTGTGACATCGGCCCAAAAGAACCCGACAGCTTTCTATCTCTGTGCCAGTAGTATCGGGGTTGAGCAGTTCTTCGGGCCA	CASSIGVEQFF	1
ACCTTGGAGCTGGGGGACTCGGCCCTTTATCTTTGCGCCAGCAGCCACCAAGGGGGCGCGAACACCGGGGAGCTGTTTTTTGGAGAA	CASSHQGGANTGELFF	1
CAGCGCACACAGCAGGAGGACTCGGCCGTGTATCTCTGTGCCAGCAGCTTAGACCCCCTGGGGACCGGGGAGCTGTTTTTTGGAGAA	CASSLDPLGTGELFF	1
GTGACATCGGCCCAAAAGAACCCGACAGCTTTCTATCTCTGTGCCAGTAGTATTGTGTCAGGGCCCTACGAGCAGTACTTCGGGCCG	CASSIVSGPYEQYF	1
CCCTCCCAGACATCTGTGTACTTCTGTGCCAGCAGTCCTCTTTTGACTAGCGGGGGGCCCTCCTACAATGAGCAGTTCTTCGGGCCA	CASSPLLTSGGPSYNEQFF	1
GTGAGCAACATGAGCCCTGAAGACAGCAGCATATATCTCTGCAGCGTTGCGCGAGGGAGCGGGCAAGAGACCCAGTACTTCGGGCCA	CSVARGSGQETQYF	1
CATCCTGAAGACAGCAGCTTCTACATCTGCAGTGCGCACAAGACATGGTTAGGTGAATTCGGCACAGATACGCAGTATTTTGGCCCA	CSAHKTWLGEFGTDTQYF	1
AATGTGAACGCCTTGTTGCTGGGGGACTCGGCCCTCTATCTCTGTGCCAGCAGCTTGTTCGACAGTTCACCCCTCCACTTTGGGAAC	CASSLFDSSPLHF	1
AGCAACATGAGCCCTGAAGACAGCAGCATATATCTCTGCAGCGTTGGGGGACAGGGGGCGTTGGGCACTGAAGCTTTCTTTGGACAA	CSVGGQGALGTEAFF	1
GCCCAAAAGAACCCGACAGCTTTCTATCTCTGTGCCAGTAGTATTAGAGTCGGGACAGGGGGCACCTATGGCTACACCTTCGGTTCG	CASSIRVGTGGTYGYTF	1
AAGGTGCAGCCTGCAGAACTGGAGGATTCTGGAGTTTATTTCTGTGCCAGCAGCTCTGACCTTGTCAATACGCAGTATTTTGGCCCA	CASSSDLVNTQYF	1
AACGCCTTGGAGCTGGACGACTCGGCCCTGTATCTCTGTGCCGGCAAAGGGCGGGGGGGGCCTGACAATGAGCAGTTCTTCGGGCCA	CAGKGRGGPDNEQFF	1
CTGGAGTCGCCCAGCCCCAACCAGACCTCTCTGTACTTCTGTGCCAGCAGTTTATCGAACAGGTACACTGAAGCTTTCTTTGGACAA	CASSLSNRYTEAFF	1
AACGCCTTGTTGCTGGGGGACTCGGCCCTCTATCTCTGTGCCAGCAGCTTGCGACTAGCGGGGGACAATGAGCAGTTCTTCGGGCCA	CASSLRLAGDNEQFF	1
AGAGCGGGGGGACTCAGCCGTGTATCTCTGTGCCAGCAGCTTAAGAACCCGGGAGGGCCGTGGTACAATGAGCAGTTCTTCGGGCCA		1
ATCCAGCGCACAGAGCGGGGGGACTCAGCCGTGTATCTCTGTGCCAGCAGCTTATACTCTGGGGCCAACGTCCTGACTTTCGGGGCC	CASSLYSGANVLTF	3
CTGAGGATCCAGCAGGTAGTGCGAGGAGATTCGGCAGCTTATTTCTGTGCCAGCTCCCAGACAGGGGACGAGCAGTACTTCGGGCCG	CASSQTGDEQYF	1
AAGATCCAGCCCTCAGAACCCAGGGACTCAGCTGTGTACTTCTGTGCCAGCGGCGGGGGGAGCAATCAGCCCCAGCATTTTGGTGAT	CASGGGSNQPQHF	1
GTGAGCACCTTGGAGCTGGGGGACTCGGCCCTTTATCTTTGCGCCAGCACCACCGGCGGGAGCGGGGAGACCCAGTACTTCGGGCCA	CASTTGGSGETQYF	1
GGCGTCTGCTGTACCCTCTCAGACATCTGTGTACTTCTGTGCCAGCAGCTCCCTACTAGCGGCCAAGAGACCCAGTACTTCGGGCCA		1
AGCACCTTGGAGCTGGGGGACTCGGCCCTTTATCTTTGCGCCAGCAGCTCGGAAACCTACGGGGCAGCCCGCTACACCTTCGGTTCG	CASSSETYGAARYTF	1
CTGTCGGCTGCTCCCTCCCAGACATCTGTGTACTTCTGTGCCAGCAGCCCGGGGCCCATGACAGGGAGTGAAGCTTTCTTTGGACAA	CASSPGPMTGSEAFF	1
GTGAACGCCTTGTTGCTGGGGGACTCGGCCCTGTATCTCTGTGCCAGCAGCTTACTTCAAGCCACAGATACGCAGTATTTTGGCCCA	CASSLLQATDTQYF	1
AGTTCTAAGAAGCTCCTTCTCAGTGACTCTGGCTTCTATCTCTGTGCCTGGAGCGCGGGGGCGGTGGCTGAAGCTTTCTTTGGACAA	CAWSAGAVAEAFF	2
TCGGCTGCTCCCTCCCAGACATCTGTGTACTTCTGTGCCAGCAGTTACTCGACCGAATTGAAGAACACTGAAGCTTTCTTTGGACAA	CASSYSTELKNTEAFF	5
AGTGCCCATCCTGAAGACAGCAGCTTCTACATCTGCAGTGCTAGCCCCAGAACTAGCGGGAGTAAAAATGAGCAGTTCTTCGGGCCA	CSASPRTSGSKNEQFF	1
CTGTCGGCTGCTCCCTCCCAGACATCTGTGTACTTCTGTGCCAGCAGGGAAAGCGGGGGGACCTTGCGCGAGCAGTACTTCGGGCCG	CASRESGGTLREQYF	1
AATTCCCTGGAGCTTGGTGACTCTGCTGTGTATTTCTGTGCCAGCAGCCATCGAAGGTGGGCCACCGGGGAGCTGTTTTTTGGAGAA	CASSHRRWATGELFF	1
CCTGCAAAGCTTGAGGACTCGGCCGTGTATCTCTGTGCCAGCAGCTTAGAGGGCCGAAACTCTGGAAACACCATATATTTTGGAGAG	CASSLEGRNSGNTIYF	1
CAGTCCACGGAGTCAGGGGACACAGCACTGTATTTCTGTGCCAGCAGCAAGACTAGCGGGTCCCGATACGAGCAGTACTTCGGGCCG	CASSKTSGSRYEQYF	1
TTGGAGTCGGCTGCTCCCTCCCAAACATCTGTGTACTTCTGTGCCAGCAGTTACAGGGCCTTGAACTATGGCTACACCTTCGGTTCG	CASSYRALNYGYTF	1
ACACAGCAGGAGGACTCCGCCGTGTATCTCTGTGCCAGCAGCAGAACCAGGACAGCGTTGGGGTCAGAGACCCAGTACTTCGGGCCA	CASSRTRTALGSETQYF	1
AGGCTGCTGTCGGCTGCTCCCTCCCAGACATCTGTGTACTTCTGTGCCAGCAGTTACTCCATGGACACTGAAGCTTTCTTTGGACAA	CASSYSMDTEAFF	1
ATCCAGCGCACAGAGCGGGGGGACTCAGCCGTGTATCTCTGTGCCAGCAGCTTAGGGCCCGGGTCGGGTGAGCAGTTCTTCGGGCCA	CASSLGPGSGEQFF	1
CGCTCACCAGGCCTGGGGGACGCAGCCATGTACCTGTGTGCCACCAGCAGAGATAAAGGACTAGCCACCGAGCAGTACTTCGGGCCG	CATSRDKGLATEQYF	1
ATCAATTCCCTGGAGCTTGGTGACTCTGCTGTGTATTTCTGTGCCAGCAGCCGATTGGACAGAAACACTGAAGCTTTCTTTGGACAA	CASSRLDRNTEAFF	1
CTTGGTGACTCTGCTGTGTATTTCTGTGCCAGCAGCCAAGATTTTCGGGACAGGGGGCCCCCGACCTACGAGCAGTACTTCGGGCCG	CASSQDFRDRGPPTYEQYF	1
CAAAAGAACCCGACAGCTTTCTATCTCTGTGCCAGTAGTGAACAATACGGCGGGGGACCAGTCTTGTACGAGCAGTACTTCGGGCCG	CASSEQYGGGPVLYEQYF	1
GAGTCCGCTACCAGCTCCCAGACATCTGTGTACTTCTGTGCCATCAGTGGAAGGCGGATACCCACAGATACGCAGTATTTTGGCCCA	CAISGRRIPTDTQYF	1
TTCCCTGGAGCTTGGTGACTCTGCTGTGTATTTCTGTGCCAGCAGCCAGAGGGTGAGGAGGGGCTTCAGCCCCAGCATTTTGGTGAT		6
ATCCTGAGTTCTAAGAAGCTCCTTCTCAGTGACTCTGGCTTCTATCTCTGTGCCTGGAGCTCGAGGGGTGAAGCTTTCTTTGGACAA	CAWSSRGEAFF	2
CTGCTGTCGGCTGCTCCCTCCCAGACATCTGTGTACTTCTGTGCCAGCAGCGAAACAGGGATGAACACTGAAGCTTTCTTTGGACAA	CASSETGMNTEAFF	1
AGCACCTTGGAGCTGGGGGACTCGGCCCTTTATCTTTGCGCCAGCAGCTGGACTAGCGGGGGTTCCTACGAGCAGTACTTCGGGCCG	CASSWTSGGSYEQYF	1
AGCACCTTGGAGCTGGGGGACTCGGCCCTTTATCTTTGCGCCAGCAGCTTGGTTAGTTCGGGCTCAGATACGCAGTATTTTGGCCCA	CASSLVSSGSDTQYF	1
TTGGAGTCGGCTGCTCCCTCCCAAACATCTGTGTACTTCTGTGCCAGCAGTTAGCCCGACCTGGATTCACCCCTCCACTTTGGGAAC	CASS*PDLDSPLHF	1
GTGAGCACCTTGGAGCTGGGGGACTCGGCCCTTTATCTTTGCGCCAGCAGCCCAGGGGTGTGGATCACTGAAGCTTTCTTTGGACAA	CASSPGVWITEAFF	2
AGCACCTTGGAGCTGGGGGACTCGGCCCTTTATCTTTGCGCCAGCAGCCCCCGGGTCGGTAGCACAGATACGCAGTATTTTGGCCCA	CASSPRVGSTDTQYF	1
CTTGGAGCTGGACGACTCGGCCCTGTATCTCTGTGCCAGCAGCTAAAACTTTAGCGGGAGCGTTCCTACGAGCAGTACTTCGGGCCG		1
GAGCACCTTGGAGCTGGGGGACTCGGCCCTTTATCTTTGCGCCAGCAGCTTGGAGCCTAGAGACACCGGGGAGCTGTTTTTGGAGAA		1
GGAGATCCAGCGCACAGAGCAGGGGGACTCGGCCATGTATCTCTGTGCCATTGAGACAGGGACAATCAGCCCCAGCATTTTGGTGAT		1
ATCCAGCGCACAGAGCAGGGGGACTCGGCCATGTATCTCTGTGCCAGCAGCTCGGACGCGGGGGGAAACACCATATATTTTGGAGAG	CASSSDAGGNTIYF	1
GCGCACAGAGCGGGGGGACTCAGCCGTGTATCTCTGTGCCAGCAGCACTCCGACAAGTCGAGCAATCAGCCCCAGCATTTTGGTGAT		1
CTCAGTGACTCTGGCTTCTATCTCTGTGCCTGGAGAGCCCTCACCGGACGGGAAAAACGGAGGCGCTATGGCTACACCTTCGGTTCG	CAWRALTGREKRRRYGYTF	1
GTGACATCGGCCCAAAAGAACCCGACAGCTTTCTATCTCTGTGCCAGTAAGGCTAGCGGGAACCAAGAGACCCAGTACTTCGGGCCA	CASKASGNQETQYF	1
AATGTGAGCACCTTGGAGCTGGGGGACTCGGCCCTTTATCTTTGCGCCAGCAGCTCCCAAGCGTCCAATGAGCAGTTCTTCGGGCCA	CASSSQASNEQFF	1
ACAGTGACCAGTGCCCATCCTGAAGACAGCAGCTTCTACATCTGCAGTGCGGATGGGGGAGGAGGGGAGACCCAGTACTTCGGGCCA	CSADGGGGETQYF	23
ACATCGGCCCAAAAGAACCCGACAGCTTTCTATCTCTGTGCCAGTAGTCCTGGACAGGGAGGCTACACTGAAGCTTTCTTTGGACAA	CASSPGQGGYTEAFF	1
ATCCAGCGCACACAGCAGGAGGACTCGGCCGTGTATCTCTGTGCCAGCAGCTTAGCGGGGGGGGTAGAGACCCAGTACTTCGGGCCA	CASSLAGGVETQYF	1
GTGCGAGGAGATTCGGCAGCTTATTTCTGTGCCAGCTCTCTTCGGACTAGCGGGGGGAACCTTCAAGAGACCCAGTACTTCGGGCCA	CASSLRTSGGNLQETQYF	1
AGTCGGCTGCTCCCTCCCAGACATCTGTGTACTTCTGTGCCAGCAGTGAACTAATCGGGGGGGGGAGAGACCCAGTACTTCGGGCCA		1
AGCCCTCAGAACCCAGGGACTCAGCTGTGTATTTTTGTGCTAGTGGTTTGGTAAGGGGAACAGTTCTACGAGCAGTACTTCGGGCCG		1
CTGACGATCCAGCGCACAGAGCAGCGGGACTCGGCCATGTATCGCTGTGCCAGCAGCTTATATTCAGAGACCCAGTACTTCGGGCCA	CASSLYSETQYF	1
GTGACCAGTGCCCATCCTGAAGACAGCAGCTTCTACATCTGCAGTGCTAGAGGGGGGCAGGTGCTGACTGAAGCTTTCTTTGGACAA	CSARGGQVLTEAFF	1
CGGTCCACAAAGCTGGAGGACTCAGCCATGTACTTCTGTGCCAGCAACGGACTAGCGGGGGGGAGGGAGACCCAGTACTTCGGGCCA	CASNGLAGGRETQYF	1
TCCCTAGAGTCTGCCATCCCCAACCAGACAGCTCTTTACTTCTGTGCCACCAGTGGGACAGGGGGTAGTGGCTACACCTTCGGTTCG	CATSGTGGSGYTF	3
TCTGCCAGGCCCTCACATACCTCTCAGTACCTCTGTGCCAGCAGTCCCCCCTCAGGGACAGGGGGGACTGAAGCTTTCTTTGGACAA	CASSPPSGTGGTEAFF	1
ATCAATTCCCTGGAGCTTGGTGACTCTGCTGTGTATTTCTGTGCCAGCAGCCGCGGGTGGACTAATGAAAAACTGTTTTTTGGCAGT	CASSRGWTNEKLFF	1
ACACAGCAGGAGGACTCGGCCGTGTATCTCTGTGCCAGCAGCTTGGCTACTAGCGGGAGGGGAATAGATACGCAGTATTTTGGCCCA	CASSLATSGRGIDTQYF	1
CTTTCCTCTCACTGTGACATCGGCCCAAAAGAACCCGACAGCTTTCTATCTCTGTCAGGGTCGTTTGGCGAGCAGTACTTCGGGCCG		1
CAGCGCACAGAGCAGCGGGACTCGGCCATGTATCGCTGTGCCAGCAGCTTAGAGCCGACAGGGCATCAGCCCCAGCATTTTGGTGAT	CASSLEPTGHQPQHF	1
TTGGAGCTGGGGGACTCGGCCCTTTATCTTTGCGCCAGCAGCCTGGGACAGGGGGCTTCGGGGGCCAACGTCCTGACTTTCGGGGCC	CASSLGQGASGANVLTF	1
CTGCAGCCAGAAGACTCGGCCCTGTATCTCTGTGCCAGCAGCCAAGACGGGGCTTCTGGGACCTACAATGAGCAGTTCTTCGGGCCA	CASSQDGASGTYNEQFF	1
TCTCTGGAGCTGGGGGACTCAGCTTTGTATTTCTGTGCCAGCAGCGCCCACAGAGATCCCTATAATTCACCCCTCCACTTTGGGAAC	CASSAHRDPYNSPLHF	1
CACTGCAGCAAGAAGACTCAGCTGCGTATCTCTGCACCAGCAGCCAAGATAAGCTAGCGGAGCACAGATACGCAGTATTTTGGCCCA		2
AAGATCCGGTCCACAAAGCTGGAGGACTCAGCCATGTACTTCTGTGCAACCAGCAGATTGGGGCCGGAGACCCAGTACTTCGGGCCA	CATSRLGPETQYF	1
CAGCGCACAGAGCGGGGGGACTCAGCCGTGTATCTCTGTGCCAGCAGCTTAGGCGGGACAGACACAGATACGCAGTATTTTGGCCCA	CASSLGGTDTDTQYF	4
GAGTCTGCTGCCTCCTCCCAGACATCTGTATATTTCTGCGCCAGCAGTGAGACTAGCGGGGGGCAAGAGACCCAGTACTTCGGGCCA	CASSETSGGQETQYF	1
GTGAACGCCTTGGAGCTGGACGACTCGGCCCTGTATCTCTGTGCCAGCAGCTCGCTAGCGGGAGCTAGTACGCAGTATTTTGGCCCA	CASSSLAGASTQYF	1
ATCCAGCCCTCAGAACCCAGGGACTCAGCTGTGTACTTCTGTGCCAGCAGTTTAGCAAGGAACACCGGGGAGCTGTTTTTTGGAGAA	CASSLARNTGELFF	1
CAGCCCTCAGAACCCAGGGACTCAGCTGTGTACTTCTGTGCCAGCAGGCCTACCCTGAGCTCCTACAATGAGCAGTTCTTCGGGCCA	CASRPTLSSYNEQFF	1
ACAGTGACCAGTGCCCATCCTGAAGACAGCAGCTTCTACATCTGCAGTGCTAGAGATCTGACAGGGAGCGAGCAGTACTTCGGGCCG	CSARDLTGSEQYF	1
CCAGACAGCTCTTTACTTCTGTGCCACCAGTGATTTGCTTTAAATTAGTTTTCTGGCAGGGTCAATCAGCCCCAGCATTTTGGTGAT		1
AGTGCCCATCCTGAAGACAGCAGCTTCTACATCTGCAGTGCTAGATCCCGAGGGACAGGCCACACCGGGGAGCTGTTTTTTGGAGAA	CSARSRGTGHTGELFF	2
ACATCGGCCCAAAAGAACCCGACAGCTTTCTATCTCTGTGCCAGTAGTATCCAGTGGACACCCTACAATGAGCAGTTCTTCGGGCCA	CASSIQWTPYNEQFF	2
CTAAACCTGAGCTCTCTGGAGCTGGGGGACTCAGCCCTGTACTTCTGTGCCAGCAGCTCCGAAGGCAATGAGCAGTTCTTCGGGCCA	CASSSEGNEQFF	1
GTCGCCCAGCCCCAACCAGACCTCTCTGTACTTCTGTGCCAGCAACTTCCCTGGGGGCACCAGAACACTGAAGCTTTCTTTGGACAA		1
AACCAGACCTCTCTGTACTTCTGTGCCAGCAGTTGCGGCATAAGGTACCGGGACAGGGGTGGCAATCAGCCCCAGCATTTTGGTGAT	CASSCGIRYRDRGGNQPQHF	1
ACATCGGCCCAAAAGAACCCGACAGCTTTCTATCTCTGTGCCAGTAGTCCCCTCGAGGGCCTAGACTATGGCTACACCTTCGGTTCG	CASSPLEGLDYGYTF	1
CTGCTGTCGGCTGCTCCCTCCCAGACATCTGTGTACTTCTGTGCCAGCAGTACAACAGGAGTCCAAGAGACCCAGTACTTCGGGCCA	CASSTTGVQETQYF	1
ACTGTGACATCGGCCCAAAAGAACCCGACAGCTTTCTATCTCTGTGCCAGTAGTATCCCCTATAAAGTAGAAGCTTTCTTTGGACAA	CASSIPYKVEAFF	1
ACATCGGCCCAAAAGAACCCGACAGCTTTCTATCTCTGTGCCAGTATAGAGGGGGGCACTGAGGTTCGTGGCTACACCTTCGGTTCG	CASIEGGTEVRGYTF	1
TCACCAGGCCTGGGGGACGCAGCCATGTACCTGTGTGCCACCAGCAGAGATCGCCGGAGGGAAAATGAAAAACTGTTTTTTGGCAGT	CATSRDRRRENEKLFF	1
CGCACAGAGCAGGGGGACTCGGCCATGTATCTCTGTGCCAGCAGCACAATAGGACAGGGGAGGAACACTGAAGCTTTCTTTGGACAA	CASSTIGQGRNTEAFF	1
GCCCAAAAGAACCCGACAGCTTTCTATCTCTGTGCCAGTAGTCCTCCCACCGCGGAGGCAATAACAGATACGCAGTATTTTGGCCCA	CASSPPTAEAITDTQYF	1
GTGAGCACCTTGGAGCTGGGGGACTCGGCCCTTTATCTTTGCGCCAGCAGCTTCGCTCCCTTGCCGTCCGAGCAGTACTTCGGGCCG	CASSFAPLPSEQYF	1
ACAGTGACCAGTGCCCATCCTGAAGACAGCAGCTTCTACATCTGCAGTGCTAGAGTACAGTGGAACACTGAAGCTTTCTTTGGACAA	CSARVQWNTEAFF	1
GTGACCAGTGCCCATCCTGAAGACAGCAGCTTCTACATCTGCAGTGCCCCAGGGACAGGGGGGTACAATGAGCAGTTCTTCGGGCCA	CSAPGTGGYNEQFF	1
ACCAGTGCCCATCCTGAAGACAGCAGCTTCTACATCTGCAGTGCTGCCCCCGGGTCATCAAGCTCCTACGAGCAGTACTTCGGGCCG	CSAAPGSSSSYEQYF	1
CTGACAGTGACCAGTGCCCATCCTGAAGACAGCAGCTTCTACATCTGCAGTGCTAGTGCCAGGCCCTATGGCTACACCTTCGGTTCG	CSASARPYGYTF	1
GCCCTGCAGCCAGAAGACTCAGCCCTGTATCTCTGCGCCAGCAGCCAAGAACCGGGACAGCGTCACAATGAGCAGTTCTTCGGGCCA	CASSQEPGQRHNEQFF	1
CCACTCTCAAGATCCAGCCTGCAAAGCTTGAGGACTCGGCCGTGTATCTCTGTGCCAGCAGTCCTAGAGACCCAGTACTTCGGGCCA		1
TCGGCTGCTCCCTCCCAGACATCTGTGTACTTCTGTGCCAGCAGTGAAGGGGGTGGGGGAGCCAAAAACATTCAGTACTTCGGCGCC	CASSEGGGGAKNIQYF	31
GATCCAGTCCACGGAGTCAGGGGACACAGCACTGTATTTCTGTGCCAGCAGCAATCAGTAGGACAACGTGGCTACACCTTCGGTTCG		1
TCGCCCAGCCCCAACCAGACCTCTCTGTACTTCTGTGCCAGCAGTACTCGCACAGGGAGCTCCTACAATGAGCAGTTCTTCGGGCCA	CASSTRTGSSYNEQFF	1
CTGGAGTCGCCCAGCCCCAACCAGACCTCTCTGTACTTCTGTGCCACCCGGCCCAGACAGCCCAATCAGCCCCAGCATTTTGGTGAT	CATRPRQPNQPQHF	1
AGATGAATGTGAGCACCTTGGAGCTGGGGGACTCGGCCCTTTATCTTTGCGCCAGCAGCTTCCAATTCTGAAGCTTTCTTTGGACAA		1
AGCACCTTGGAGCTGGGGGACTCGGCCCTTTATCTTTGCGCCAGCAGCGCCGGGACAGGGTATGGCTCACCCCTCCACTTTGGGAAC	CASSAGTGYGSPLHF	2
CTCAGCCGTGTATCTCTGTGCCAGCAGCCGACCGGGACAGGGTGGACTAGCGGGAGGACGCCACCCTACGAGCAGTACTTCGGGCCG		1
GCTGCTGTCGGCTGCTCCCTCCCAGACATCTGTGTACTTCTGTGCCAGCTCAGGGGGGAGAAGTGTTATGGCTACACCTTCGGTTCG		1
AAGAAGCTCCTTCTCAGTGACTCTGGCTTCTATCTCTGTGCCTGGAGACACATCAGGGGGCCGAACACTGAAGCTTTCTTTGGACAA	CAWRHIRGPNTEAFF	1
GAACGCCTTGGAGCTGGACGACTCGGCCCTGTATCTCTGTGCCAGCAGCTCAACAGGGCTCGTAACTATGGCTACACCTTCGGTTCG		1
AACGCCTTGTTGCTGGGGGACTCGGCCCTGTATCTCTGTGCCAGCAGACGAGACAGTTCCGGGGCCAACGTCCTGACTTTCGGGGCC	CASRRDSSGANVLTF	1
GAGTTGGCTGCTCCCTCCCAGACATCTGTGTACTTCTGTGCCAGCAGTGTGGGTTATGGGGGTTCCTACGAGCAGTACTTCGGGCCG	CASSVGYGGSYEQYF	1
TCCGCCAGCACCAACCAGACATCTATGTACCTCTGTGCCAGCAGTTCCTATAGGGGGGAGGTTAACTATGGCTACACCTTCGGTTCG	CASSSYRGEVNYGYTF	5
AGCTCTCTGGAGCTGGGGGACTCAGCTTTGTATTTCTGTGCCAGCAGCGAGGGGACACTTCAAGATCAGCCCCAGCATTTTGGTGAT	CASSEGTLQDQPQHF	1
AGCACCTTGGAGCTGGGGGACTCGGCCCTTTATCTTTGCACCAGCAGCTCCATAGCGGGGGGCACAGATACGCAGTATTTTGGCCCA	CTSSSIAGGTDTQYF	3
TGGGGGACTCGGCCCTTTATCTTTGCGCCAGCAGCTGGGAGGCGACAAAGATTAATTTAGGGCAATCAGCCCCAGCATTTTGGTGAT		1
AAGAAGCTCCTTCTCAGTGACTCTGGCTTCTATCTCTGTGCCTGGAGTGGATGGACAGGTCAGAACTATGGCTACACCTTCGGTTCG	CAWSGWTGQNYGYTF	1
TTGGAGTCGGCTGCTCCCTCCCAGACATCTGTGTACTTCTGTGCCAGCAGTTACTCGACGGGTTCCTACGAGCAGTACTTCGGGCCG	CASSYSTGSYEQYF	1
TCGGCCCAAAAGAACCCGACAGCTTTCTATCTCTGTGCCAGTAAGATGGGAGGCCTCGCTGGATCCAATGAGCAGTTCTTCGGGCCA	CASKMGGLAGSNEQFF	1
GTGACCAGTGCCCATCCTGAAGACAGCAGCTTCTACATCTGCAGTGCTAGTCCGGGACTAGCGGGAGGTATACAGTTCTTCGGGCCA	CSASPGLAGGIQFF	1
GAGGATCCAGCAGGTAGTGCGAGGAGATTCGGCAGCTTATTTCTGTGCCAGCTCACCAAGAAAACCGGGGAGCTGTTTTTTGGAGAA		1
AATGTGAACGCCTTGGAGCTGGACGACTCGGCCCTGTATCTCTGTGCCAGCAGCTCCCGCGGGGGGACTGAAGCTTTCTTTGGACAA	CASSSRGGTEAFF	1
CTGGAGTCGCCCAGCCCCAACCAGACCTCTCTGTACTTCTGTGCCAGCAGTTTATCGGGAGGGGCCAACGTCCTGACTTTCGGGGCC	CASSLSGGANVLTF	1
GCCCATCCTGAAGACAGCAGCTTCTACATCTGCAGTGCCATTTCTATAGGGACTAGCGTCAAATACAATGAGCAGTTCTTCGGGCCA	CSAISIGTSVKYNEQFF	1
CACAGAGCGGGGGGACTCAGCCGTGTATCTCTGTGCCAGCAGCTTTAAAGGGGGGCGGGTAGTGGAAACACCATATATTTTGGAGAG		1
AGCAGGTAGTGCGAGGAGATTCGGCAGCTTATTTCTGTGCCAGCTCACCACTAGGGGCAGTCTGCGGAGACCCAGTACTTCGGGCCA		1
TCCGCCAGCACCAACCAGACATCTATGTACCTCTGTGCCAGCAGGCCTAAACTCGGTCTCAGGGATTCACCCCTCCACTTTGGGAAC	CASRPKLGLRDSPLHF	2
CTGTCGGCTGCTCCCTCCCAGACATCTGTGTACTTCTGTGCCAGCAGTCTAGCTAGCGGGGGGACCTACGAGCAGTACTTCGGGCCG	CASSLASGGTYEQYF	1
TCCCCTGACCCTGGAGTCTGCCAGGCCCTCACATACCTCTCAGTACCTCTGTGCCAGAGTAAAAACTATGGCTACACCTTCGGTTCG		1
TCGGCCCAAAAGAACCCGACAGCTTTCTATCTCTGTGCCAGTGATGGGACTAGCGGGGGGGGTCCAGATACGCAGTATTTTGGCCCA	CASDGTSGGGPDTQYF	1
CTGGCAATCCTGTCCTCAGAACCGGGAGACACGGCACTGTATCTCTGCGCCCGGTAGGGGGGGCTCTAGGGCTACACCTTCGGTTCG	CAR*GGL*GYTF	1
CCAGCCTGCAAAGCTTGAGGACTCGGCCGTGTATCTCTGTGCCAGCAGCCCAGCGGGGGCACAAACACTGAAGCTTTCTTTGGACAA		1
CTGTCGGCTGCTCCCTCCCAGACATCTGTGTACTTCTGTGCCAGCAGTCCGTTGGCGGGGGGGCAAGATGAGCAGTTCTTCGGGCCA	CASSPLAGGQDEQFF	1
CCCATCCTGAAGACAGCAGCTTCTACATCTGCAGTGCCAAATTATTCGGACTAGCGGGGCAAGGGGGATACGCAGTATTTTGGCCCA		1
GACATCGGCCCAAAAGAACCCGACAGCTTTCTATCTCTGTGCCAGTAGTATTTCAGCGCGCCTTCCTACGAGCAGTACTTCGGGCCG		1
TGACCAGTGCCCATCCTGAAGACAGCAGCTTCTACATCTGCAGTGCTAGAGATGGACAGGGGCAATCAGCCCCAGCATTTTGGTGAT		1
ATCCAGCCTGCAAAGCTTGAGGACTCGGCCGTGTATCTCTGTGCCAGCAGCCAATTGGTCTACACCGGGGAGCTGTTTTTTGGAGAA	CASSQLVYTGELFF	1
CTGTGACATCGGCCCAAAAGAACCCGACAGCTTTCTATCTCTGTGCCAGTAGTCCAGGACTACTACAATGAGCAGTTCTTCGGGCCA		1
AGCCCCAACCAGACCTCTCTGTACTTCTGTGCCAGCAGTCTCCTATCATCAGCCGGGACAGGTAACACTGAAGCTTTCTTTGGACAA	CASSLLSSAGTGNTEAFF	1
CTAAACCTGAGCTCTCTGGAGCTGGGGGACTCAGCTTTGTATTTCTGTGCCAGCAGCGTAGATTTGAACACCATATATTTTGGAGAG	CASSVDLNTIYF	1
GTCTGCCATCCCCAACCAGACAGCTCTTTACTTCTGTGCCACCAGTGATTTGATCCGGGTGGGGGCACTGAAGCTTTCTTTGGACAA		1
CAAAAGAACCCGACAGCTTTCTATCTCTGTGCCAGTAGTCCCGCTCCGAAACAGGATGGGGCTGCGGAAAAACTGTTTTTTGGCAGT	CASSPAPKQDGAAEKLFF	1
TTGGTGACTCTGCTGTGTATTTCTGTGCCAGCAGCTCACAGGACAGGCAGAGTCTTTAGCTCCTACAATGAGCAGTTCTTCGGGCCA		1
CAGCCCTCAGAACCCAGGGACTCAGCTGTGTACTTCTGTGCCAGCAGTACTCGCACAGGGGTGGGTCAGCCCCAGCATTTTGGTGAT	CASSTRTGVGQPQHF	1
AAGAAGCTCCTTCTCAGTGACTCTGGCTTCTATCTCTGTGCCTGGAGTGAAGCGACTAGCGGTCACAATGAGCAGTTCTTCGGGCCA	CAWSEATSGHNEQFF	1
CTGTCGGCTGCTCCCTCCCAGACATCTGTGTACTTCTGTGCCAGCAGACAAGGCGGGGGCTCAAGTACCGAGCAGTTCTTCGGGCCA	CASRQGGGSSTEQFF	1
ACCTTGGAGCTGGGGGACTCGGCCCTTTATCTTTGCGCCAGCAGCTACGAGGGACAGGGTAACACCGGGGAGCTGTTTTTTGGAGAA	CASSYEGQGNTGELFF	1
CTGGAGTCCGCTACCAGCTCCCAGACATCTGTGTACTTCTGTGCCATCACGCGACGGTTAAACACCGGGGAGCTGTTTTTTGGAGAA	CAITRRLNTGELFF	1
GTGACCAGTGCCCATCCTGAAGACAGCAGCTTCTACATCTGCAGTGCTATCCGGGACTTGAACACCGGGGAGCTGTTTTTTGGAGAA	CSAIRDLNTGELFF	1
CTCTCTGGAGCTGGGGGACTCAGCTTTGTATTTCTGTGCCAGCAGCCCGCGACCCGGGGAACCACCGGGGAGCTGTTTTTTGGAGAA		1
AAGAAGCTCCTTCTCAGTGACTCTGGCTTCTATCTCTGTGCCTGGAGTGTACCGGGGAGGGGAAATCAGCCCCAGCATTTTGGTGAT	CAWSVPGRGNQPQHF	2
AGGCTGGAGTCGGCTGCTCCCTCCCAGACATCTGTGTACTTCTGTGCCAGCAGCGTTACAGGGGACTATGGCTACACCTTCGGTTCG	CASSVTGDYGYTF	1
CGCTCACCAGGCCTGGGGGACGCAGCCATGTACCTGTGTGCCACCAGCGGCGGGAAAACTAGCACAGATACGCAGTATTTTGGCCCA	CATSGGKTSTDTQYF	1
AGCACCTTGGAGCTGGGGGACTCGGCCCTTTATCTTTGCGCCAGCAGCTTGGTGGCTAGCGCAACCTACGAGCAGTACTTCGGGCCG	CASSLVASATYEQYF	1
ACTGTGAGCAACATGAGCCCTGAAGACAGCAGCATATATCTCTGCAGCGTCAAGGGCACAGGGTCGGATACCATATATTTTGGAGAG	CSVKGTGSDTIYF	3
GTGACCAGTGCCCATCCTGAAGACAGCAGCTTCTACATCTGCAGTGCTAGTGCGGGACTTGATATAAATGAGCAGTTCTTCGGGCCA	CSASAGLDINEQFF	2
CTGGAGTCGGCTGCTCCCTCCCAGACATCTGTGTACTTCTGTGCCAGCAGTGAAATGCGGGGTAATCAGCCCCAGCATTTTGGTGAT	CASSEMRGNQPQHF	1
CTGGAGCTTGGTGACTCTGCTGTGTATTTCTGTGCCAGCAGCCCGTGGACTGATACCCCCTTTGGTGATACGCAGTATTTTGGCCCA	CASSPWTDTPFGDTQYF	4
CTGAATGTGAACGCCTTGGAGCTGGACGACTCGGCCCTGTATCTCTGTGCCAGCAGCCGGGGCTTCGACGAGCAGTACTTCGGGCCG	CASSRGFDEQYF	1
AGTGCCCATCCTGAAGACAGCAGCTTCTATATCTGCAGTGCTAGAGCCCCGGACGGGAGAAGCTACAATGAGCAGTTCTTCGGGCCA	CSARAPDGRSYNEQFF	1
AAGATCCAGCGCACACAGCAGGAGGACTCCGCCGTGTATCTCTGTGCCAGCAGCTTCGAGGGGAACTACGAGCAGTACTTCGGGCCG	CASSFEGNYEQYF	1
CCCTCCCAAACATCTGTGTACTTCTGTGCCAGCAGAAATCTCCCGTCTTTTCTCCTAAGTTCAGGAAACACCATATATTTTGGAGAG	CASRNLPSFLLSSGNTIYF	2
ATCCAGCCCTCAGAATCCAGGGACTCAGCTGTGTACTTCTGTGCCAGCAGTTTTCAGGTCTCTGGAAACACCATATATTTTGGAGAG	CASSFQVSGNTIYF	1
GAGTCGGCTGCTCCCTCCCAAACATCTGTGTACTTCTGTGCCAGCAGTATCCGGACAGGGCCTCTCACTGAAGCTTTCTTTGGACAA	CASSIRTGPLTEAFF	1
TGAAGACAGCAGCTTCTACATCTGCAGTGCCTTTAACCGGGACTAGCGGGAGGGTTGCCCCCCACAGATACGCAGTATTTTGGCCCA		1
AGTCCGCTACCAGCTCCCAGACATCTGTGTACTTCTGTGCCAGGTGGCGGACGGGACAGGGGGCCCTAGGTCCAGTACTTCGGGCCA		1
ATCCTGAGGATCCAGCAGGTAGTGCGAGGAGATTCGGCAGCTTATTTCTGTGCCAGCTCACGGGGGAATGAGCAGTTCTTCGGGCCA	CASSRGNEQFF	1
AGTCTGCCATCCCCAACCAGACAGCTCTTTACTTCTGTGCCACCAGTGACAAGAGTCGGGACAGAAGGAGGCTACACCTTCGGTTCG		1
TGTACCCTCTCAGACATCTGTGTACTTCTGTGCCAGCAGTGACCGGGACAGGGGGTATGGAAGAAAACTGAAGCTTTCTTTGGACAA		1
ATCCGGTCCACAAAGCTGGAGGACTCAGCCATGTACTTCTGTGCCAGCAGTGGGCCGCGTCTCGATTCACCCCTCCACTTTGGGAAC	CASSGPRLDSPLHF	1
GTGAACGCCTTGGAGCTGGACGACTCGGCCCTGTATCTCTGTGCCAGCAGGGGAGATGAATTCTCCTACGAGCAGTACTTCGGGCCG	CASRGDEFSYEQYF	1
AGCTCTCTGGAGCTGGGGGACTCAGCTTTGTATTTCTGTGCCAGCAGCTCAGGACAGGGGAGTCAAGAGACCCAGTACTTCGGGCCA	CASSSGQGSQETQYF	1
GTCCGCTACCAGCTCCCAGACATCTGTGTACCTTTAGTAGGGACCTAACAGGGGAGGGAGGACACCGGGGAGCTGTTTTTTGGAGAA		1
GTGAACGCCTTGGAGCTGGACGACTCGGCCCTGTATCTCTGTGCCAGCACCGCGGACAGGGGGCTTGAAAAACTGTTTTTTGGCAGT	CASTADRGLEKLFF	1
CAGCGCACACAGCAGGAGGACTCGGCCGTGTATCTCTGTGCCAGCAGCGTCTCCCTTACTGGGCGGACTGAAGCTTTCTTTGGACAA	CASSVSLTGRTEAFF	1
CTCAGGCTGCTGTCGGCTGCTCCCTCCCAGACATCTGTGTACTTCTGTGCCATCCTCGCAGGGTAGAACGAGCAGTACTTCGGGCCG	CAILAG*NEQYF	4
ACTGTGAGCAACATGAGCCCTGAAGACAGCAGCATATATCTCTGCAGCGTACGATCCGGGGATGGCTATGGCTACACCTTCGGTTCG	CSVRSGDGYGYTF	4
CCCTCAGAACCCAGGGACTCAGCTGTGTACTTCTGTGCCAGCAGTTTAGTTTGGCTTACCTCTGGAAACACCATATATTTTGGAGAG	CASSLVWLTSGNTIYF	1
ATCCTGGAGTCGCCCAGCCCCAACCAGACCTCTCTGTACTTCTGTGCCAGCAGTTACGGGAGCAATCAGCCCCAGCATTTTGGTGAT	CASSYGSNQPQHF	1
GTTGGAGTCGGCTGCTCCCTCCCAAACATCTGTGTACTTCTGTGCCAGCAGTTAATACCTGGGGCCAACGTCCTGACTTTCGGGGCC		1
TTGGAGATCCAGCGCACAGAGCAGGGGGACTCGGCCATGTATCTCTGTGCCAGCAGCATAATAAGGAGGGGCTACACCTTCGGTTCG	CASSIIRRGYTF	3
ACAGTGACCAGTGCCCATCCTGAAGACAGCAGCTTCTACATCTGCAGTGCTAGCGGGAGTACCTACAATGAGCAGTTCTTCGGGCCA	CSASGSTYNEQFF	1
GATCCAGTCCACGGAGTCAGGGGACACAGCACTGTATTTCTGTGCCAGCAGCACTGGCCGGGGGCCAACGAGCAGTACTTCGGGCCG		2
ACTGTGAGCAACATGAGCCCTGAAGACAGCAGCATATATCTCTGCAGCGCCGCTGAGGGGATTGGGGAGACCCAGTACTTCGGGCCA	CSAAEGIGETQYF	1
TTCATCCTGAGTTCTAAGAAGCTCCTTCTCAGTGACTCTGGCTTCTATCTCTGTGCCTGGGCCCAAGAGACCCAGTACTTCGGGCCA	CAWAQETQYF	1
ACTGTGACATCGGCCCAAAAGAACCCGACAGCTTTCTATCTCTGTGCCAGTAGTATAGTACTGGCCGGGGAGCTGTTTTTTGGAGAA	CASSIVLAGELFF	6
AGTTCTAAGAAGCTCCTTCTCAGTGACTCTGGCTTCTATCTCTGTGCCTGGTCCGTAGGGATCACAGAGACCCAGTACTTCGGGCCA	CAWSVGITETQYF	1
AGCCCTCAGAACCCAGGGACTCAGCTGTGTACTTCTGTGCCAGCAGTTTAAATTAACCTAAAGAACACTGAAGCTTTCTTTGGACAA		1
CCTGCAGAACTGGAGGATTCTGGAGTTTATTTCTGTGCCAGCAGCCAAGACTCGGGACAGTATAATGAAAAACTGTTTTTTGGCAGT	CASSQDSGQYNEKLFF	1
AAGATCCAGCCCTCAGAACCCAGGGACTCAGCTGTGTATTTTTGTGCTAGTCATGGTGCGTTCCAAGAGACCCAGTACTTCGGGCCA	CASHGAFQETQYF	4
AGGATCCAGCAGGTAGTGCGAGGAGATTCGGCAGCTTATTTCTGTGCCAGCTCTCCCGACAGTAACTATGGCTACACCTTCGGTTCG	CASSPDSNYGYTF	1
ATCCGCTCACCAGGCCTGGGGGACGCGGCCATGTACCTGTGTGCCACCAGCAGAGAAAGGTACACCGGGGAGCTGTTTTTTGGAGAA	CATSRERYTGELFF	4
AGGTGCAGCCTGCAGAACTGGAGGATTCTGGAGTTTATTTCTGTGCCAGCAGCCAGGATCCCGGCGGGCGAGCAGTACTTCGGGCCG		2
GTCTGCCATCCCCAACCAGACAGCTCTTTACTTCTGTGCCACCAGTGATTTGACCCGGCCAAAACCTACGAGCAGTACTTCGGGCCG		1
CAGCGCACACAGCAGGAGGACTCGGCCGTGTATCTCTGTGCCAGCAGCCTCCGGGCTAGCGGGAGTCACGAGCAGTACTTCGGGCCG	CASSLRASGSHEQYF	7
ATTCTGGAGTCCGCCAGCACCAACCAGACATCTATGTACCTCTGTGCCAGCAGTTTACCAGGGGGCTACGAGCAGTACTTCGGGCCG	CASSLPGGYEQYF	1
GCCTTGGAGCTGGAGGACTCGGCCCTGTATCTCTGTGCCAGCAGGTACCCCGGACTAGCGGAAGGGAATGAGCAGTTCTTCGGGCCA	CASRYPGLAEGNEQFF	1
GTGACCAGTGCCCATCCTGAAGACAGCAGCTTCTACATCTGCAGTGCTAGAGCTCCTAACTCCAAACCCGAGCAGTACTTCGGGCCG	CSARAPNSKPEQYF	1
TCCCTAGAGTCTGCCATCCCCAACCAGACAGCTCTTTACTTCTGTGCCACCAGTGATGTCCGGGCCAATGAGCAGTTCTTCGGGCCA	CATSDVRANEQFF	1
ACCAGTGCCCATCCTGAAGACAGCAGCTTCTACATCTGCAGTGCTAGGTGGTTGGGACAGGCCTACAATGAGCAGTTCTTCGGGCCA	CSARWLGQAYNEQFF	1
ATCCAGCGCACAGAGCAGGGGGACTCGGCCATGTATCTCTGTGCCAGCAGCTTTGGACAATCTTTTAGTGCTTCGGACTTCGGGCCG	CASSFGQSFSASDF	1
CTGAGGATCCAGCAGGTAGTGCGAGGAGATTCGGCAGCTTATTTCTGTGCCAGCTCACCGGCAGGTGGAGGCTACACCTTCGGTTCG	CASSPAGGGYTF	1
CTGACTGTGAGCAACATGAGCCCTGAAGACAGCAGCATATATCTCTGCAGCGTCGAAGAGGGGGGCTATGGCTACACCTTCGGTTCG	CSVEEGGYGYTF	1
CACAAAGCTGGAGGACTCAGCCATGTACTTCTGTGCCAGCAGGAAGGCCCTAGGTTTGCCTCCTACAATGAGCAGTTCTTCGGGCCA		1
ACCAGTGCCCATCCTGAAGACAGCAGCTTCTACATCTGCAGTGCTAGAGACGGACAGGGGGCTGAAAACATTCAGTACTTCGGCGCC	CSARDGQGAENIQYF	1
GTGACCAGTGCCCATCCTGAAGACAGCAGCTTCTACATCTGCAGTGCTAGAGCAAGCGGGGTCTCCTACGAGCAGTACTTCGGGCCG	CSARASGVSYEQYF	1
CTGACGATCCAGCGCACACAGCAGGAGGACTCGGCCGTGTATCTCTGTGCCAGCAGCTTAGTGGGAGTGGGGCAGTTCTTCGGGCCA	CASSLVGVGQFF	1
TCCTTCTCAGTGACTCTGGCTTCTATCTCTGTGCCTGGAGTGTAGTCGCCCCGCGCGGGGTGCACAGATACGCAGTATTTTGGCCCA		3
TTGGAGTCGGCTGCTCCCTCCCAAACATCTGTGTACTTCTGTGCCAGCAGGGTTGGCCCAACTAATGAAAAACTGTTTTTTGGCAGT	CASRVGPTNEKLFF	1
CAGCGCACAGAGCGGGGGGACTCAGCCGTGTATCTCTGTGCCAGCAGCTTAACGGGGGGGCCGAATGAAAAACTGTTTTTTGGCAGT	CASSLTGGPNEKLFF	2
GACCAGTGCCCATCCTGAAGACAGCAGCTTCTACATCTGCAGTGCTAGAGATAAAGGGGGGCGCCAGATACGCAGTATTTTGGCCCA		1
GCACTGCAGCAAGAAGACTCAGCTGCGTATCTCTGCACCAGCAACCAGAGCGGGGGGCTAGCCAAAAACATTCAGTACTTCGGCGCC	CTSNQSGGLAKNIQYF	2
ACAGTGACCAGTGCCCATCCTGAAGACAGCAGCTTCTACATCTGCAGTGCATTGGAAGCAACTAATGAAAAACTGTTTTTTGGCAGT	CSALEATNEKLFF	1
CTGACAGTGACCAGTGCCCATCCTGAAGACAGCAGCTTCTACATCTGCAGTGCTAGAGATGCTAAGTCTAAGCAGTACTTCGGGCCG	CSARDAKSKQYF	1
AGTTCTAAGAAGCTCCTTCTCAGTGACTCTGGCTTCTATCTCTGTGCCTGGAGTATCGACAGGGGCACTGAAGCTTTCTTTGGACAA	CAWSIDRGTEAFF	1
ACTGTGACATCGGCCCAAAAGAACCCGACAGCTTTCTATCTCTGTGCCAGTAGTGACAGGGGTTCTGAAAAACTGTTTTTTGGCAGT	CASSDRGSEKLFF	1
ACCAGTGCCCATCCTGAAGACAGCAGCTTCTACATCTGCAGTGCTAGAGATCGGTTGAACAATTGGGACGAGCAGTACTTCGGGCCG	CSARDRLNNWDEQYF	1
ACTCTGACAGTGACCAGTGCCCATCCTGAAGACAGCAGCTTCTACATCTGCAGTGCTAGGCGGGGGTACGAGCAGTACTTCGGGCCG	CSARRGYEQYF	1
GCTCCCTCCCAGACATCTGTGTACTTCTGTGCCAGCAGTTACTCAGTTAAGTAGACAGGGGCGGATTACGAGCAGTACTTCGGGCCG	CASSYSVK*TGADYEQYF	10
CCCATCCTGAAGACAGCAGCTTCTACATCTGCAGTGCTAGAGATTCCCTGGGGAGGGGACAATGGAAACACCATATATTTTGGAGAG		1
AAGATCCGGTCCACAAAGCTGGAGGACTCAGCCATGTACCTCTGTGCCAGCAGCAAAGACAGTAACTATGGCTACACCTTCGGTTCG	CASSKDSNYGYTF	3
ATCCAGCCCTCAGAACCCAGGGACTCAGCTGTGTACTTCTGTGCCAGCAGTTTACGGGACAGGGCTGGGGAGCTGTTTTTTGGAGAA	CASSLRDRAGELFF	1
ATCCTGGAGTCGCCCAGCCCCAACCAGACCTCTCTGTACTTCTGTGCCAGCAGTTCAGGGGTTAGCTACGAGCAGTACTTCGGGCCG	CASSSGVSYEQYF	1
TCCGCTACCAGCTCCCAGACATCTGTGTACTTCTGTGCCATCAGAACTAGCGGGGGGTATGGCACCGGGGAGCTGTTTTTTGGAGAA	CAIRTSGGYGTGELFF	1
GGGGACTCGGCCCTTTATCTTTGCGCCAGCAGCTTCCGAAGCCTTTCCTCTAGCGGGAGCTCCTACAATGAGCAGTTCTTCGGGCCA	CASSFRSLSSSGSSYNEQFF	1
GAGTCGCCCAGCCCCAACCAGACCTCTCTGTACTTCTGTGCCAGCAGTTTATCCCTTGCAGGGAACACTGAAGCTTTCTTTGGACAA	CASSLSLAGNTEAFF	1
GAGATCCAGCGCACAGAGCAGGGGGACTCGGCCATGTATCTCTGTGCCAGCAGCTTAGGGGGGACGGCTGAAGCTTTCTTTGGACAA	CASSLGGTAEAFF	2
CCTCACATACCTCTCAGTACCTCTGTGCCATCCCTTCCCGGGGACAGGGTTCTCTTTTCCACAAACACTGAAGCTTTCTTTGGACAA		1
CCGCTCAGGCTGCTGTCGGCTGCTCCCTCCCAGACATCTGTGTACTTCTGTGCCAGCAGTGAAGAGGCTACGCAGTATTTTGGCCCA	CASSEEATQYF	7
TGGAGTCTGCTGCCTCCTCCCAGACATCTGTATATTTCTGCGCCAGCAGTGAGGAGTTGAAGCAATCAGCCCCAGCATTTTGGTGAT		2
ATCCAGCGCACACAGCAGGAGGACTCGGCCGTGTATCTCTGTGCCAGCAGCTTGAACAGGGAGGGAACTGAAGCTTTCTTTGGACAA	CASSLNREGTEAFF	1
ACATCGGCCCAAAAGAACCCGACAGCTTTCTATCTCTGTGCCAGTAGTCCAATGATGACAGGGACTCTTGGCTACACCTTCGGTTCG	CASSPMMTGTLGYTF	1
GTCCACGGAGTCAGGGGACACAGCACTGTATTTCTGTGCCAGCAGCAATACATACAGGGGGCAGGGGAAAAACTGTTTTTTGGCAGT		1
ACATCGGCCCAAAAGAACCCGACAGCTTTCTATCTCTGTGCCAGCCGCGATATTGGAGGTAACACCGGGGAGCTGTTTTTTGGAGAA	CASRDIGGNTGELFF	2
GTGAGCACCTTGGAGCTGGGGGACTCGGCCCTTTATCTTTGCGCCAGCAGCTTCAGGGGGGGGTCAGATACGCAGTATTTTGGCCCA	CASSFRGGSDTQYF	1
GCCCTGCAGCCAGAAGACTCAGCCCTGTATCTCTGCGCCAGCAGCCAAGATCTCGGGGCCCTAGGCTATGGCTACACCTTCGGTTCG	CASSQDLGALGYGYTF	1
GTCGGCTGCTCCCTCCCAGACATCTGTGTACTTCTGTGCCAGCAGTAGCGGGACAGTTATTCGTACAATGAGCAGTTCTTCGGGCCA		1
GCTGCTCCCTCCCAGACATCTGTGTACTTCTGTGCCAGCAGTTACGACGCGGAGGGGGCGAGCTTTTACGAGTAGTACTTCGGGCCG	CASSYDAEGASFYE*YF	1
TCCCTGGAGCTTGGTGACTCTGCTGTGTATTTCTGTGCCAGCAGCCAACCCACCCTTAGCGGGGCGGAGACCCAGTACTTCGGGCCA	CASSQPTLSGAETQYF	1
AGAGTCTGCCATCCCCAACCAGACAGCTCTTTACTTCTGTGCCACCAGTGTTCCGGGGGGTCAGACAATGAGCAGTTCTTCGGGCCA		1
AATGTGAACGCCTTGTTGCTGGGGGACTCGGCCCTCTATCTCTGTGCCAGCAGCGTGGGGTGGAACACTGAAGCTTTCTTTGGACAA	CASSVGWNTEAFF	3
GCCCTGCAGCCAGAAGACTCAGCCCTGTATCTCTGCGCCAGCAGCCAAGACCGACTGGACAGGGGAAACACCATATATTTTGGAGAG	CASSQDRLDRGNTIYF	1
CAGCCAGAAGACTCGGCCCTGTATCTCTGTGCCAGCAGCCAAGAGGGGACTAGCGGGAGGTCCTACAATGAGCAGTTCTTCGGGCCA	CASSQEGTSGRSYNEQFF	1
CAGTCCACGGAGTCAGGGGACACAGCACTGTATTTCTGTGCCAGCAGCGACCCACAGTCTCCCAAAAACATTCAGTACTTCGGCGCC	CASSDPQSPKNIQYF	1
CAAAAGAACCCGACAGCTTTCTATCTCTGTGCCAGTAGTATTGGAAGACAGGGAGTAGGGGGACAAGAGACCCAGTACTTCGGGCCA	CASSIGRQGVGGQETQYF	1
TCCGCCAGCACCAACCAGACATCTATGTACCTCTGTGCCAGCAGTTTTATTAGCGGGAGGAACTCCTACGAGCAGTACTTCGGGCCG	CASSFISGRNSYEQYF	1
GTCCGCCAGCACCAACCAGACATCTATGTACCTCTGTGCCAGCAGTTTATAAGCCGGGACAGGGAGAGAGAGCAGTACTTCGGGCCG		1
TCACATACCTCTCAGTACCTCTGTGCCAGCAGTCAAGCATAACTTTGCGGGGGGTGACCCAGCTCCTACGAGCAGTACTTCGGGCCG	CASSQA*LCGG*PSSYEQYF	1
CAGCCCTCAGAACCCAGGGACTCAGCTGTGTACTTCTGTGCCAGCAGTCCCTTCCAGGGATCCCAAGAGACCCAGTACTTCGGGCCA	CASSPFQGSQETQYF	1
TCTCTGGAGCTGGGGGACTCAGCTTTGTATTTCTGTGCCAGCAGCGTATATAGCACACCGGGACGGGACGAGCAGTACTTCGGGCCG	CASSVYSTPGRDEQYF	1
TTGGAGCTGGGGGACTCGGCCCTTTATCTTTGCGCCAGCAGCTTTCATACTATCGAGCCAGGCACAGATACGCAGTATTTTGGCCCA	CASSFHTIEPGTDTQYF	1
CTGGAGCTTGGTGACTCTGCTGTGTATTTCTGTGCCAGCAGCCAAGAATCCCGGACAGGGAGGAACACTGAAGCTTTCTTTGGACAA	CASSQESRTGRNTEAFF	1
CTGGAGTCGCCCAGCCCCAACCAGACCTCTCTGTACTTCTGTGCCAGCAGTCCATGGACAGGGAACTACGAGCAGTACTTCGGGCCG	CASSPWTGNYEQYF	2
CACATCAATTCCCTGGAGCTTGGTGACTCTGCTGTGTATTTCTGTGCCAGCCGACCGGGAGGTACCTACGAGCAGTACTTCGGGCCG	CASRPGGTYEQYF	1
AACCTGAGCTCTCTGGAGCTGGGGGACTCAGCTTTGTATTTCTGTGCCAGCAGCGACACCGGGAACACTGAAGCTTTCTTTGGACAA	CASSDTGNTEAFF	1
GTGACCAGTGCCCATCCTGAAGACAGCAGCTTCTACATCTGCAGTGCTAGAGGGGACAGGGGGCACACTGAAGCTTTCTTTGGACAA	CSARGDRGHTEAFF	1
GTGAACGCCTTGGAGCTGGAGGACTCGGCCCTGTATCTCTGTGCCAGCAGCTTGGGAGGGACAGGCACTGAAGCTTTCTTTGGACAA	CASSLGGTGTEAFF	1
AGGCTGGAGTCGGCTGCTCCCTCCCAGACATCTGTGTACTTCTGTGCCAGCAGTACTACAGGTACCGGGGAGCTGTTTTTTGGAGAA	CASSTTGTGELFF	1
CTGGAGTCAGCTACCCGCTCCCAGACATCTGTGTATTTCTGCGCCAGCAGAGGGGGGGCCCGTGTAGATACGCAGTATTTTGGCCCA	CASRGGARVDTQYF	1
CCCAGCCCCAACCAGACCTCTCTGTACTTCTGTGCCAGCAGTTTGATCGGGACAGTCTCTGGGGCCAACGTCCTGACTTTCGGGGCC	CASSLIGTVSGANVLTF	1
CCCTCAGAACCCAGGGACTCAGCTGTGTACTTCTGTGCCAGCAGTTCCACTAGCGGGAGGGGCACCGGGGAGCTGTTTTTTGGAGAA	CASSSTSGRGTGELFF	2
GTCAGGGGACACAGCACTGTATTTCTGTGCCAGCAGCAAAGCTAGCGGGAGGGCCGAAGGAACACCGGGGAGCTGTTTTTTGGAGAA		1
AATTCCCTGGAGCTTGGTGACTCTGCTGTGTATTTCTGTGCCAGCAGCCAAGAGGGTTCGAGCAATCAGCCCCAGCATTTTGGTGAT	CASSQEGSSNQPQHF	9
CTGGAGTCCGCTACCAGCTCCCAGACATCTGTGTACTTCTGTGCCATCAGTGAGACCCATGGTTGGACTGAAGCTTTCTTTGGACAA	CAISETHGWTEAFF	1
GGAGCTGGGGGACTCGGCCCTTTATCTTTGCGCCAGCAGACTTGGGGGGGGCCCGATTATAGCAATCAGCCCCAGCATTTTGGTGAT		1
CTGCAGCCAGAAGACTCGGCCCTGTATCTCTGTGCCAGCAGCCGCCCGACTAGCGGGGGGGCCGCAGATACGCAGTATTTTGGCCCA	CASSRPTSGGAADTQYF	1
CTGGAGTCTGCTGCCTCCTCCCAGACATCTGTATATTTCTGCGCCAGCAGTTCTGAGGCCGGGCGGGAAAAACTGTTTTTTGGCAGT	CASSSEAGREKLFF	2
CTACACGCCCTGCAGCCAGAAGACTCAGCCCTGTATCTCTGCGCCAGCAGCCAAGAGGAAGGTAGAGGAGGCCAGTACTTCGGGCCA	CASSQEEGRGGQYF	1
CGCACAGAGCGGGGGGACTCAGCCGTGTATCTCTGTGCCAGCAGCTGGGCAGGGGGGCGGAACCAAGAGACCCAGTACTTCGGGCCA	CASSWAGGRNQETQYF	1
GAGTCGGCTGCTCCCTCCCAGACATCTGTGTACTTCTGTGCCAGCAGGGCCGGGACTAGGAACACAGATACGCAGTATTTTGGCCCA	CASRAGTRNTDTQYF	1
CCTCTCACTGTGACATCGGCCCAAAAGAACCCGACAGCTTTCTATCTCTGTGCCAGTAGGTCTAACACTGAAGCTTTCTTTGGACAA	CASRSNTEAFF	1
ACCAGTGCCCATCCTGAAGACAGCAGCTTCTACATCTGCAGTGCCCTCGGACTAGTTAGCTCCTACAATGAGCAGTTCTTCGGGCCA	CSALGLVSSYNEQFF	1
ATCCAGCGCACACAGCAGGAGGACTCGGCCGTGTATCTCTGTGCCAGCAGCCCAGGGGTGGTTACCTACGAGCAGTACTTCGGGCCG	CASSPGVVTYEQYF	1
GAGTCGGCTGCTCCCTCCCAGACATCTGTGTACTTCTGTGCCAGCAGTTTCCCAGGGGCACTTAATGAAAAACTGTTTTTTGGCAGT	CASSFPGALNEKLFF	1
ATCAATTCCCTGGAGCTTGGTGACTCTGCTGTGTATTTCTGTGCCAGCAGCCAAATCATTCCGCCGGATACGCAGTATTTTGGCCCA	CASSQIIPPDTQYF	2
ACAAAGCTGGAGGACTCAGCCATGTACTTCTGTGCCAGCAGTGATTTTTTCCGGGGCGCGAACACCGGGGAGCTGTTTTTTGGAGAA	CASSDFFRGANTGELFF	4
ATCCGGTCCACAAAGCTGGAGGACTCAGCCATGTACTTCTGTGCCAGCAGGGACAGGGGTAGCACAGATACGCAGTATTTTGGCCCA	CASRDRGSTDTQYF	1
AATTCCCTGGAGCTTGGTGACTCTGCTGTGTATTTCTGTGCCAGCAGCCAAGACCCATCGCCTGCCTATGGCTACACCTTCGGTTCG	CASSQDPSPAYGYTF	1
GAGTCCGCTACCAGCTCCCAGACATCTGTGTACTTCTGTGCCAGTACAGAGACAGGGAATTTACTTTACACCATATATTTTGGAGAG	CASTETGNLLYTIYF	1
AAGATCCAGCGCACACAGCAGGAGGACTCCGCCGTGTATCTCTGTGCCAGCAGCTGGGTCCCCAATCAGCCCCAGCATTTTGGTGAT	CASSWVPNQPQHF	5
CGCACACAGCAGGAGGACTCGGCCGTGTATCTCTGTGCCAGCAGCTTACTAGCGGGGGGGGTGCACAATGAGCAGTTCTTCGGGCCA	CASSLLAGGVHNEQFF	1
ACCTGAGCTCTCTGGAGCTGGGGGACTCAGCTTTGTATTTCTGTGCCAGCAGCGTAGGTAGCTTCGGGTGAGCAGTTCTTCGGGCCA		2
GCGTCTGCTGTACCCTCTCAGACATCTGTGTACTTCTGTGCCAGCAGTGACTCGAGGGGGATCGGCGGGGAGCTGTTTTTTGGAGAA	CASSDSRGIGGELFF	1
ATCCTGGAGTCGCCCAGCCCCAACCAGACCTCTCTGTACTTCTGTGCCAGCAGTTTCACTAACACCGGGGAGCTGTTTTTTGGAGAA	CASSFTNTGELFF	1
AGCACCTTGGAGCTGGGGGACTCGGCCCTTTATCTTTGCGCCAGCAGCTTGGGGACAGGGATGTGGAAAAAACTGTTTTTTGGCAGT	CASSLGTGMWKKLFF	1
ACAGCAGGAGGACTCGGCCGTGTATCTCTGTGCCAGCAGCCCCCTTCCGGGGGTAGGGTGGGCAATCAGCCCCAGCATTTTGGTGAT		1
CGGCCCAAAAGAACCCGACAGCTTTCTATCTCTGTGCCAGTAACTAGCGGGAGGGCCTCTCTTCGGGAGACCCAGTACTTCGGGCCA		90
GAGATGAATGTGAGCACCTTGGAGCTGGGGGACTCGGCCCTTTATCTTTGCGCCAGCAGCTTTAGGGGCGAGCAGTACTTCGGGCCG	CASSFRGEQYF	1
CCCTCAGAACCCAGGGACTCAGCTGTGTACTTCTGTGCCAGCAGTTTAGGGACTAGCGGGGGGTTCTATGAGCAGTTCTTCGGGCCA	CASSLGTSGGFYEQFF	1
AGGCTGCTGTCGGCTGCTCCCTCCCAGACATCTGTGTACTTCTGTGCCAGCAGTTACTCCGGAGACTATGGCTACACCTTCGGTTCG	CASSYSGDYGYTF	1
ACAGTGACCAGTGCCCATCCTGAAGACAGCAGCTTCTACATCTGCAGTGCTGGACCCCTGAGCACAGATACGCAGTATTTTGGCCCA	CSAGPLSTDTQYF	1
GAAGGAATCCTTTCCTCTCACTGTGACATCGGCCCAAAAGAACCCGACAGCTTTCTATCTCTGTGCCAGTATGGGGTCTTCGGGCCG		11
TTGGAGTCGGCTGCTCCCTCCCAAACATCTGTGTACTTCTGTGCCAGCAGTTACCGGCGAACTAACTATGGCTACACCTTCGGTTCG	CASSYRRTNYGYTF	4
AATGTGAACGCCTTGTTGCTGGGGGACTCGGCCCTCTATCTCTGTGCCAGCAGACAGACCCCGTACAATGAGCAGTTCTTCGGGCCA	CASRQTPYNEQFF	1
AGCTCTCTGGAGCTGGGGGACTCAGCTTTGTATTTCTGTGCCAGCAGCCCCCAGCGGGGGGGCTACAATGAGCAGTTCTTCGGGCCA	CASSPQRGGYNEQFF	1
GTGAACGCTTTGGAGCTGGACGACTCGGCCCTGTATCTCTGTGCCAGCAGCTTGGAATCCCTAGCGGGAGGGCTGTTCTTCGGGCCA	CASSLESLAGGLFF	1
CCCTCAGAACCCAGGGACTCAGCTGTGTACTTCTGTGCCAGCAGTTATTCTTCTCGGTTGAATAGCGAAAAACTGTTTTTTGGCAGT	CASSYSSRLNSEKLFF	1
ACTCTGGAGTCAGCTACCCGCTCCCAGACATCTGTGTATTTCTGCGCCAGCCAGCTCTTAGGGAACACTGAAGCTTTCTTTGGACAA	CASQLLGNTEAFF	1
CAGTCCACGGAGTCAGGGGACACAGCACTGTATTTCTGTGCCAGCAGCCCCTATAGCCTAGCCAAAAACATTCAGTACTTCGGCGCC	CASSPYSLAKNIQYF	1
GTGAACGCCTTGGAGCTGGAGGACTCGGCCCTGTATCTCTGTGCCAGCAGACGCGGACAGAGCAATCAGCCCCAGCATTTTGGTGAT	CASRRGQSNQPQHF	1
AGCTCTCTGGAGCTGGGGGACTCAGCTTTGTATTTCTGTGCCAGCAGCCCCTTGACAGGGAGGGGAGAGACCCAGTACTTCGGGCCA	CASSPLTGRGETQYF	1
GCTCCCAGACATCTGTGTACTTCTGTGCCATCAGGAGGCGGCCATCGGGGCCAGGGTCAACTCCTATGAAAACTGTTTTTTGGCAGT		1
TCCTTTCCTCTCACTGTGACATCGGCCCAAAAGAACCCGACAGCTTTCTATCTCTGTGCCAGTATATAACCCCAGCATTTTGGTGAT	CASI*PQHF	1
GCACAGAGCAAGGGCGACTCGGCTGTGTATCTCTGTGCCAGAAGCTTCCGGGACAGGGGCTATAACACTGAAGCTTTCTTTGGACAA	CARSFRDRGYNTEAFF	1
GTGACATCGGCCCAAAAGAACCCGACAGCTTTCTATCTCTGTGCCAGTAGCCTCACCCGGGACGGGGTTGGAACTTTCTTTGGACAA	CASSLTRDGVGTFF	1
AAGAAGCTCCTTCTCAGTGACTCTGGCTTCTATCTCTGTGCCTGGAGTGCAAAAGACAGGGGTGACACTGAAGCTTTCTTTGGACAA	CAWSAKDRGDTEAFF	1
AGCACCTTGGAGCTGGGGGACTCGGCCCTTTATCTTTGCGCCAGCAGCCCCTGGGGGGCAGACGGTACTGAAGCTTTCTTTGGACAA	CASSPWGADGTEAFF	1
CTGAGTTCTAAGAAGCTCCTTCTCAGTGACTCTGGCTTCTATCTCTGTGCCTGGAGTGTCCCCAGGGAAAAACTGTTTTTTGGCAGT	CAWSVPREKLFF	1
CTGATCCTGGAGTCGCCCAGCCCCAACCAGACCTCTCTGTACTTCTGTGCCAGCAGTTTTGCGGGTCGGGGGGCCCTCTTCGGGCCA	CASSFAGRGALF	1
TTGGAGCTGGACGACTCGGCCCTGTATCTCTGTGCCAGCAGCTTAGGAGGGAGGGCCGGTTGGAACAATGAGCAGTTCTTCGGGCCA	CASSLGGRAGWNNEQFF	1
GCTGCTCCCTCCCAGACATCTGTGTACTTCTGTGCCAGCAGTTACCGGAAGACGGGACAGGGGGCGCATGGCTACACCTTCGGTTCG	CASSYRKTGQGAHGYTF	1
CAGCGCACACAGCAGGAGGACTCCGCCGTGTATCTCTGTGCCAGCAGCTTAGGTTCCGGGAAGGGGTACGAGCAGTACTTCGGGCCG	CASSLGSGKGYEQYF	1
ATCCTGAGTTCTAAGAAGCTCCTTCTCAGTGACTCTGGCTTCTATCTCTGTGCCTGGATGGGGTTAGATACGCAGTATTTTGGCCCA	CAWMGLDTQYF	7
GGGACACAGCACTGTATTTCTGTGCCAGCAGCAAAGGGTTCCTTTAAGGCTAGCGGGAGTGAAGTCTACGAGCAGTACTTCGGGCCG		1
CGATTCAGCGCACAGAGCAGCGGGACTCAGCCATGTATCGCTGTGCCTCTCGGGGGGCGGACTAATGAAAAACTGTTTTTTGGCAGT		1
ACATCGGCCCAAAAGAACCCGACAGCTTTCTATCTCTGTGCCAGTAGTAAGGCCTAGCGGGGATTAGATACGCAGTATTTTGGCCCA	CASSKA*RGLDTQYF	6
AGCACCTTGGAGCTGGGGGACTCGGCCCTTTATCTTTGCGCCAGCAGCTTGGATACAGGAAGTCTTTATGGCTACACCTTCGGTTCG	CASSLDTGSLYGYTF	2
CTGAAGATCCGGTCCACAAAGCTGGAGGACTCAGCCATGTACTTCTGTGCCAGCAGCCCAGTAAATCAGCCCCAGCATTTTGGTGAT	CASSPVNQPQHF	1
CTGAGTTCTAAGAAGCTCCTTCTCAGTGACTCTGGCTTCTATCTCTGTGCCTGGAGTGTATATAACAATGAGCAGTTCTTCGGGCCA	CAWSVYNNEQFF	1
CGCCTTGTTGCTGGGGGACTCGGCCCTGTATCTCTGCGCCAGCAGCCAAGATGGACAGGGATTTTCGAGACCCAGTACTTCGGGCCA		1
TTGTCCACTCTGTCAGTGACCAGTGCCCATCCTGAAGACAGCAGCTTCTACATCTGCAGTGCTCGAGTTGAGCAGTTCTTCGGGCCA	CSARVEQFF	1
CTGCTGTCGGCTGCTCCCTCCCAGACATCTGTGTACTTCTGTGCCAGCAGAGGGACAGGGGGTGCCTACGAGCAGTACTTCGGGCCG	CASRGTGGAYEQYF	2
ACATCGGCCCAAAAGAACCCGACAGCTTTCTATCTCTGTGCCAGTAGTATTGATGGAGGGGGCTCGATTGAAGCTTTCTTTGGACAA	CASSIDGGGSIEAFF	1
CCTCTCACTGTGACATCGGCCCAAAAGAACCCGACAGCTTTCTATCTCTGTGCCAGTAGTATGCTCTATGGCTACACCTTCGGTTCG	CASSMLYGYTF	1
GGATCCAGCAGGTAGTGCGAGGAGATTCGGCAGCTTATTTCTGTGCCAGCTCACCGCGCAGGGGGCAGCGAGCAGTACTTCGGGCCG		1
CTGCAGCCAGAAGACTCGGCCCTGTATCTCTGCGCCAGCAGCCAAGAAACTAGCGGGCTGGACGCCGGGGAGCTGTTTTTTGGAGAA	CASSQETSGLDAGELFF	1
CTGAAGATCCGGTCCACAAAGCTGGAGGACTCAGCCATGTACTTCTGTGCCAGCAGCGTAGCGGAGTACGAGCAGTACTTCGGGCCG	CASSVAEYEQYF	1
