nucleotide	aminoAcid	estimatedNumberGenomes
CCCAACCAGACAGCTCTTTACTTCTGTGCCAGCAGTTCGTACACAGGGGCGAACACTGAAGCTTTCTTTGGACAA	CASSSYTGANTEAFF	2
CAAAAGAACCCGACAGCTTTCTATCTCTGTGCCAGTAGTATATATCTAGCGGGGAGTGGTACGCAGTATTTTGGCCCA	CASSIYLAGSGTQYF	3
GACTCGGCCGTGTATGTCTGTGCCAGCAGCTTGATAGACAGGGACACCGGGGAGCTGTTTTTTGGAGAA	CASSLIDRDTGELFF	1
CCTCCCAGACATCTGTGTACTTGTGTGCCAGCAGTAGGGATGATAACTATGGCTACACCTTCGGTTCG	CASSRDDNYGYTF	4
TTCTCAGTGACTCTGGCTTCTATCTCTGTGCCTGGAGTGTACGGGGGCGTAAAGCTTTCTTTGGACAA	CAWSVRGRKAFF	62
CTCCCTCYCAGACWTCTGTKTACTTSTGTGCCAGCAGTTCCGGGGGGGCGTATGACAATGAGCAGTTCTTCGGGCCA	CASSSGGAYDNEQFF	5
CACCAACCAGACATCTATGTACCTCTGTGCCATCCTCGACTCACAAGAGACCCAGTACTTCGGGCCA	CAILDSQETQYF	4
AGCTTGGTGACTCTGCTGTGTATTTCTGTGCCAGCAGCCGCCGGGGTGGGGTTGAGACCCAGTATTTCGGGCCA	CASSRRGGVETQYF	3
CCTCCCAGACATCTGTGTACTTGTGTGCCAGCACAAGAGGGGGCTTACGAGCAGTACTTCGGGCCG		2
GACTCGGCCGTGTATGTCTGTGCCAGCAGCCCCCCCGGGACAGGAACAGATACGCAGTATTTTGGCCCA	CASSPPGTGTDTQYF	20
AAGCCACGTTTGGTGCCAAAAGAACCCGACAGCTTTTATCTCTGTGCCAGTAGTATAAGACAGGGGGCCGAAGCTTTCTTTGGACAA		4
CCCAACCAGACAGCTCTTTACTTCTGTGCCACCTCTGGCGGCGCTAACTATGGCTACACCTTCGGTTCG	CATSGGANYGYTF	4
TGCCAGTAGTGTAACTACCCCTGGGCAGGGGGCTCACGATGGATCTATTAGCAATCAGCCCCAGCATTTTGGTGAT	CASSVTTPGQGAHDGSISNQPQHF	1
GGACTCGGCCCTTTATCTTTGCGCCAGCAGCTTGGCCGCAGGGGGTGAGACCCAGTACTTCGGGCCA	CASSLAAGGETQYF	3
CGAGGAGATTCGGCAGCTTATTTCTGTGCCAGCTCCCTCAGTGGGCAGGGAAGGGAGCAGTACTTCGGGCCG	CASSLSGQGREQYF	4
GACTCGGCCGTGTATGTCTGTGCCAGCAGCCAAGATTTCGACAGTCCGGGAGCAACTAATGAAAAACTGTTTTTTGGCAGT	CASSQDFDSPGATNEKLFF	25
CCTCCCAGACATCTGTGTACTTGTGTGCCAGCAGTTCCCCGGGACAGGGAGTGAACATTCAGTACTTCGGCGCC	CASSSPGQGVNIQYF	3
CAAAAGAACCCGACAGCTTTCTATCTCTGTGCCAGTACCCCAGTTTCCGGCGTTTTGTCTGGAAACACCATATATTTTGGAGAG	CASTPVSGVLSGNTIYF	6
CGAGGAGATTCGGCAGCTTATTTCTGTGCCAGCTCACCCCATATTGAGGACTAGCTTTGGTAATGAGCAGTTCTTCGGGCCA		2
CAAAAGAACCCGACAGCTTTCTATCTCTGTGCCAGTAGTATGGGACAGGGGTCGCATCAGCCCCAGCATTTTGGTGAT	CASSMGQGSHQPQHF	9
CCTCCCAGACATCTGTGTACTTGTGTGCCAGCAGTTACCAGGGTTCCACTGAAGCTTTCTTTGGACAA	CASSYQGSTEAFF	7
CCTCCCAGACATCTGTGTACTTGTGTGCCAGCAGTAGACCGGCCTCGGGAAGCAATGAGCAGTTCTTCGGGCCA	CASSRPASGSNEQFF	31
GACTCGGCCGTGTATGTCTGTGCCAGCAGCCCCGGGACAGCCACCGGGGAGCTGTTTTTTGGAGAA	CASSPGTATGELFF	2
CCCTGAAGACAGCAGCATATATCTCTGCAGCGTTGTCCTATCTGGGGCCAACGTCCTGACTTTCGGGGCC	CSVVLSGANVLTF	9
TGGGGGACTCAGCTTTGTATTTCTGTGCCAGCAGTGGACCGGGAGATCAGCCCCAGCATTTTGGTGAT	CASSGPGDQPQHF	1
ATCCTGAAGACAGCAGCTTCTACATCTGCAGTGCTAGAGCCTTTACAGGGGCGCGGGGGATGAGGGAGACCCAGTACTTCGGGCCA	CSARAFTGARGMRETQYF	14
GGACTCGGCCCTTTATCTTTGCGCCAGCAGCTTGGCCTCTAGCGGGAGTTGGGAGACCCAGTACTTCGGGCCA	CASSLASSGSWETQYF	1
GACTCGGCCGTGTATGTCTGTGCCAGCAGCCTTGGGTGGGGGATGAAACCCACTGAAGCTTTCTTTGGACAA	CASSLGWGMKPTEAFF	1
AGCTTGGTGACTCTGCTGTGTATTTCTGTGCCAGCAGCCAAGATGGTCGGAATACTGTTAAGCAGTTCTTCGGGCCA	CASSQDGRNTVKQFF	2
ATCCTGAAGACAGCAGCTTCTACATCTGCAGTGCTAGAGATAACAACGGCGGACAGCCCCAGCATTTTGGTGAT	CSARDNNGGQPQHF	4
CAAAAGAACCCGACAGCTTTCTATCTCTGTGCCAGTACCGAGGACAGGGGGCATCGTACGAGCAGTACTTCGGGCCG		3
CCTCCCAGACATCTGTGTACTTGTGTGCCAGCCGTGGACGGACGATTATTCTTAACACCGGGGAGCTGTTTTTTGGAGAA	CASRGRTIILNTGELFF	4
ATCCTGAAGACAGCAGCTTCTACATCTGCAGTGCTAGAGATCTGGGTCAGAATAATTTACCCCTCCACTTTGGGAAC	CSARDLGQNNLPLHF	3
CCCTGAAGACAGCAGCATATATCTCTGCAGCGTTGGGGAGGGCCTAAACATTCAGTACTTCGGCGCC	CSVGEGLNIQYF	1
CAAAAGAACCCGACAGCTTTCTATCTCTGTGCCAGTAGTAAGGAGCGGGACAGTGTTTCTAGAGACACCTTCGGTTCG	CASSKERDSVSRDTF	5
CCCTGAAGACAGCAGCATATATCTCTGCAGCGTTGATGAGGGACCGGCTAGCAAGCAGTTCTTCGGGCCA	CSVDEGPASKQFF	1
GCTCCCAGACATCTGTGTATTTCTGCGCCAGCAGTGATCCAGCTCGGGTGGGCTACACCTTCGGTTCG	CASSDPARVGYTF	7
CAAAAGAACCCGACAGCTTTCTATCTCTGTGCCACCTTACGGGGAGGGAATTGGAACACTGAAGCTTTCTTTGGACAA	CATLRGGNWNTEAFF	1
CCTCCCAGACATCTGTGTACTTGTGTGCCAGCAGTGACTCATAAGACAGGCGAGAGAATGAACACTGAAGCTTTCTTTGGACAA		1
CAAAAGAACCCGACAGCTTTCTATCTCTGTGCCAGTAGTATATATAAGGGTGGTAGCCCCAGCATTTTGGTGAT		4
CCTCCCAGACATCTGTGTACTTGTGTGCCAGCAGCCTGGGAGGTATCCGTTCACCCCTCCACTTTGGGAAC	CASSLGGIRSPLHF	8
CCTCCCAGACATCTGTGTACTTGTGTGCCATCAGTGATGGACGGAATAGCAATCAGCCCCAGCATTTTGGTGAT	CAISDGRNSNQPQHF	19
CGAGGAGATTCGGCAGCTTATTTCTGTGCCAGCTCACCGTTAGCGGCGGAGGGCACAGATACGCAGTATTTTGGCCCA	CASSPLAAEGTDTQYF	1
GACTCGGCCGTGTATGTCTGTGCCAGCAGCCCAAACCAGGGGCTGGATGGCTACACCTTCGGTTCG	CASSPNQGLDGYTF	1
TGGGGGACTCAGCTTTGTATTTCTGTGCCAGCAGTCCGGGACAACCTGGGGCCAACGTCCTGACTTTCGGGGCC	CASSPGQPGANVLTF	4
TGGCAAGCCACGTTTGGTGCATCCTGAAGACAGCAGTTCTACATCTGCAGTGCTCGCGACCGCCAAGAGACCCAGTACTTCGGGCCA	CSARDRQETQYF	11
AGCTTGGTGACTCTGCTGTGTATTTCTGTGCCAGCAGCCCTCCCGGGACCTATTGGAATGAGCAGTTCTTCGGGCCA	CASSPPGTYWNEQFF	5
CCTCCCAGACATCTGTGTACTTGTGTGCCAGCAGTTACGGACAGAACCAAGAGACCCAGTACTTCGGGCCA	CASSYGQNQETQYF	2
GAGACACGGCACTGTATCTCTGCGCCAGCAGTCAATCTAGCACAGATACGCAGTATTTTGGCCCA	CASSQSSTDTQYF	1
CAAAAGAACCCGACAGCTTTCTATCTCTGTGCCAGTAGGGGACCGGGTTCGAATCAGCCCCAGCATTTTGGTGAT	CASRGPGSNQPQHF	1
CAAAAGAACCCGACAGCTTTCTATCTCTGTGCCACCAGTATAGAGGGGAGGGTGACTGAAGCTTTCTTTGGACAA	CATSIEGRVTEAFF	6
AGCTTGGTGACTCTGCTGTGTATTTCTGTGCCAGCAGCCAAACAAGGGACCAGCCCCAGCATTTTGGTGAT	CASSQTRDQPQHF	10
AGCTTGGTGACTCTGCTGTGTATTTCTGTGCCAGCAGTCTACAAAGGGACACCTACTACGAGCAGTACTTCGGGCCG	CASSLQRDTYYEQYF	4
CCCTGAAGACAGCAGCATATATCTCTGCAGCGTTGCCGGTAGCTCCTACAATGAGCAGTTCTTCGGGCCA	CSVAGSSYNEQFF	6
AGCTTGGTGACTCTGCTGTGTATTTCTGTGCCAGCAGCCAACAGGGGGGCTCCTATAATTCACCCCTCCACTTTGGGAAC	CASSQQGGSYNSPLHF	4
GCTCCCAGACATCTGTGTATTTCTGCGCCAGCAGTGAAGGGACTAGCGACACAGATACGCAGTATTTTGGCCCA	CASSEGTSDTDTQYF	5
AACCCAGGGACTCAGCTGTGTATTTTTGTGCCATCGCCAGGAGGGGGCCCTGAAGCTTTCTTTGGACAA		5
GCTCCCAGACATCTGTGTATTTCTGCGCCAGCAGCCGGACCCCGGGGGAGACCCAGTACTTCGGGCCA	CASSRTPGETQYF	6
CCTCCCAGACATCTGTGTACTTGTGTGCCAGCAGTGTGGCTCTCAGCTCCTACGAGCAGTACTTCGGGCCG	CASSVALSSYEQYF	7
CCTCCCAGACATCTGTGTACTTGTGTGCCAGCACCTTGGGACAGGGGCCTGGGGCCAACGTCCTGACTTTCGGGGCC	CASTLGQGPGANVLTF	6
CCCAACCAGACAGCTCTTTACTTCTGTGCCAGCAGTTTGCGGTCCACCGGAGAGACCCAGTACTTCGGGCCA	CASSLRSTGETQYF	4
GACTCGGCCGTGTATGTCTGTGCCAGCAGCTTAGAGGACGACCCCCACCCCTATGGCTACACCTTCGGTTCG	CASSLEDDPHPYGYTF	3
AACCCAGGGACTCAGCTGTGTATTTTTGTGCCAGCAGCCTAAGTCGGGGTGGCTACACCTTCGGTTCG	CASSLSRGGYTF	6
AACCCAGGGACTCAGCTGTGTATTTTTGTGCCAGCATCCCCGGGGGCGGGAGCTCCTACAATGAGCAGTTCTTCGGGCCA	CASIPGGGSSYNEQFF	4
CACCAACCAGACATCTATGTACCTCTGTGCCACCACCTCGGGCCTGTTAAGTGATACGCAGTATTTTGGCCCA	CATTSGLLSDTQYF	9
AACCCAGGGACTCAGCTGTGTATTTTTGTGCTAGTGGTTTGCCAACCGGGCACTGAAGCTTTCTTTGGACAA		4
TCTGTGTACTTGTGTGCCAGCAGTTACTCGGGTTTGTTATGGGACAGGGAGTCCCATAACTATGGCTACACCTTCGGTTCG	CASSYSGLLWDRESHNYGYTF	3
CCCAACCAGACAGCTCTTTACTTCTGTGCCAGCAGTTTATCACGCCCCCCGGGACAGGTACGAGCAGTACTTCGGGCCG		6
AACCCAGGGACTCAGCTGTGTATTTTTGTGCCAGCAGTTTAAGGACAGCTGACGGCTACACCTTCGGTTCG	CASSLRTADGYTF	3
CAAAAGAACCCGACAGCTTTCTATCTCTGTGCCATCGCAGACGGTAGCTCCTACAATGAGCAGTTCTTCGGGCCA	CAIADGSSYNEQFF	1
AGCTTGGTGACTCTGCTGTGTATTTCTGTGCCAGCAGCCAAGAATTCGGGGGGGCGTCCTTCGGGCCA	CASSQEFGGASF	1
CGAGGAGATTCGGCAGCTTATTTCTGTGCCAGCTCACCAACTGCATCAGGTGCCGGGGAGCTGTTTTTTGGAGAA	CASSPTASGAGELFF	1
GCCACGTTTGGTGGCCTCCTCCCAGACATCTGTTATTTCTGCGCCAGCAGTGAGTTCCGGGGGGATGGCGAGCAGTACTTCGGGCCG	CASSEFRGDGEQYF	3
CCCAACCAGACMKCTCTKTACTTCTGTGCCAGCAGGAGGGTGGGGGCCAACGTCCTGACTTTCGGGGCC	CASRRVGANVLTF	4
GACTCGGCCGTGTATGTCTGTGCCAGCAGCCCATTAGGCTTCAGCACAGATACGCAGTATTTTGGCCCA	CASSPLGFSTDTQYF	2
TSRGGGACTCAGCTKTGTAYTTCTGTGCCAGCCTCCGGGACAGGGGGCAGAACACTGAAGCTTTCTTTGGACAA	CASLRDRGQNTEAFF	2
GACTCGGCCGTGTATGTCTGTGCCAGCCGTCGCGGGGCCATCTCTGGAAACACCATATATTTTGGAGAG	CASRRGAISGNTIYF	6
CAGAAGACTCAGCCCTGTATCTCTGCGCCAGCAGCTTGTTGATGGGAGAGGCTTTCTTTGGACAA	CASSLLMGEAFF	4
CAAAAGAACCCGACAGCTTTCTATCTCTGTGCCAGTAGTATAGGGAACCGGAACACTGAAGCTTTCTTTGGACAA	CASSIGNRNTEAFF	1
ACTCGGCCGTGTATGTCTGTGCCAGCAGCTTAATAGACGATCGGCTACAGGGGCCGATTAAACCAAGAGACCCAGTACTTCGGGCCA		1
AGCTTGGTGACTCTGCTGTGTATTTCTGTGCCAGCAGCTGGTGAAATTCCATTTTTGGCATCATCAGCCCCAGCATTTTGGTGAT		2
GGACTCGGCCCTTTATCTTTGCGCCAGCAGTGGGACAGGGGGCGCGGAAAAACTGTTTTTTGGCAGT	CASSGTGGAEKLFF	9
CCCTGAAGACAGCAGCATATATCTCTGCAGCGTTGAAGATTTACCCCCGGGAGGGGGTGTCAGACAGTACTTCGGGCCG	CSVEDLPPGGGVRQYF	34
CACCAACCAGACATCTATGTACCTCTGTGCCAGCACCGAAACTAGCGGGAGGGCGACAGATACGCAGTATTTTGGCCCA	CASTETSGRATDTQYF	6
CGAGGAGATTCGGCAGCTTATTTCTGTGCCAGCTCACCACCAACGCAGGGCCCAGATACGCAGTATTTTGGCCCA	CASSPPTQGPDTQYF	12
CCTCCCAGACATCTGTGTACTTGTGTGCCATCATGGAGGGAACGAGGTCGGACTCTGGAAATACCATATATTTTGGAGAG	CAIMEGTRSDSGNTIYF	5
CCTCCCAGACATCTGTGTACTTGTGTGCCAGCAGTTATCAAGGGACCGCCGAGCAGTACTTCGGGCCG	CASSYQGTAEQYF	2
GGACTCGGCCCTTTATCTTTGCGCCAGCGGGAGAGGAATCGTACAAGAGACCCAGTACTTCGGGCCA	CASGRGIVQETQYF	2
CAAAAGAACCCGACAGCTTTCTATCTCTGTGCCAGTAGTAAGGACAGTGCGAACACCGGGGAGCTGTTTTTTGGAGAA	CASSKDSANTGELFF	1
TSRGGGACTCAGCTKTGTAYTTCTGTGCCAGCAGCCGGGACATAATCCTATATGGCTACACCTTCGGTTCG	CASSRDIILYGYTF	1
GACTCGGCCGTGTATGTCTGTGCCAGCAGCTTAGAGGGACACGGGCGAAGGACTGAAGCTTTCTTTGGACAA	CASSLEGHGRRTEAFF	4
CACCAACCAGACATCTATGTACCTCTGTGCCAGCAGAAGACAGTACACCGGGGAGCTGTTTTTTGGAGAA	CASRRQYTGELFF	1
GACTCGGCCGTGTATGTCTGTGCCAGCAAGGGGCAGACAAACACCGGGGAGCTGTTTTTTGGAGAA	CASKGQTNTGELFF	6
GACTCGGCCGTGTATGTCTGTGCCAGCAGCTTAGTAGCGGGAGGTGGAGATACGCAGTATTTTGGCCCA	CASSLVAGGGDTQYF	3
GACTCGGCCGTGTATGTCTGTGCCAGCAGCCAGAGGATCAAATACGACAAAGTCGGGCCAACGTCCTGACTTCGGGGCC		5
GACGCAGCCATGTACCTGTGTGCCACCAGCGGGCCCCGGGACAGGGTCGGTGAGGGTGGCTACACCTTCGGTTCG	CATSGPRDRVGEGGYTF	2
GGGGGACTYGGCYGTGTATCTCTGTGCCAGCAGCTTAGTCGCCGGGTCTGAGCAGTTCTTCGGGCCA	CASSLVAGSEQFF	4
CGAGGAGATTCGGCAGCTTATTTCTGTGCCAGCTCACCACCGCGTGGCGAGACCCAGTACTTCGGGCCA	CASSPPRGETQYF	1
ATCCTGAAGACAGCAGCTTCTACATCTGCAGTGCTCCCTTTTTAGGGAACACTGAAGCTTTCTTTGGACAA	CSAPFLGNTEAFF	40
CCTCCCAGACATCTGTGTACTTGTGTGCCAGCAGCGGGACTACCACCGGGGAGCTGTTTTTTGGAGAA	CASSGTTTGELFF	1
CCTCCCAGACATCTGTGTACTTGTGTGCCAGCAGTCCCCGGGCAGGGGGCCCCACAGATACGCAGTATTTTGGCCCA	CASSPRAGGPTDTQYF	9
CACCAACCAGACATCTATGTACCTCTGTGCCAGCAGTTTATATACATCCCCCGGGAACACTGAAGCTTTCTTTGGACAA	CASSLYTSPGNTEAFF	1
TYCTCAGTGACTCTGGCTTCTATCTCTGTGCCTGGAGTGTCCAGGGTCCCGGGGAGCTGTTTTTTGGAGAA	CAWSVQGPGELFF	2
CCCWMCCAGACAKCTSTKTACTTSTGTGCCACCAAGGATTGGAACACCGGGGAGCTGTTTTTTGGAGAA	CATKDWNTGELFF	13
CCTCCCAGACATCTGTGTACTTGTGTGCCAGCAGTTACGGACAGGAGAACTATGGCTACACCTTCGGTTCG	CASSYGQENYGYTF	6
CRRRRGACTCAGCCSTGTATCTCTRCGCCAGCAGCCAAGGTTGGGGTGAAAATCAGCCCCAGCATTTTGGTGAT	XASSQGWGENQPQHF	1
ATCCTGAAGACAGCAGCTTCTACATCTGCAGTGCTCCGGGCGGGGCTGGGGAGCAGTTCTTCGGGCCA	CSAPGGAGEQFF	6
CACCAACCAGACATCTATGTACCTCTGTGCCAGCAGTTTGAGTTCGAGGCGACGAGGGACTGAAGCTTTCTTTGGACAA	CASSLSSRRRGTEAFF	8
TSRGGGACTCAGCTKTGTAYTTCTGTGCCAGCAGTGAACCAGCTTTGGAGACCCAGTACTTCGGGCCA	CASSEPALETQYF	1
AGCTTGGTGACTCTGCTGTGTATTTCTGTGCCAGCAGCCCCGGGACCTACGAGCAGTACTTCGGGCCA	CASSPGTYEQYF	1
CCCAACCAGACAGCTCTTTACTTCTGTGCCAGCAGTTACGACGGATACTATGGCTACACCTTCGGTTCG	CASSYDGYYGYTF	1
CCTCCCAGACATCTGTGTACTTGTGTGCCAGCAGTTACCGCCTGAACACTGAAGCTTTCTTTGGACAA	CASSYRLNTEAFF	2
GAGACACGGCACTGTATCTCTGCGCCAGCAGTCAAGTAGTGGGGAGAGGCAATCAGCCCCAGCATTTTGGTGAT	CASSQVVGRGNQPQHF	7
CCTCCCAGACATCTGTGTACTTGTGTGCCACCCGGCAGCCCAGCACAGATACGCAGTATTTTGGCCCA	CATRQPSTDTQYF	5
CAAAAGAACCCGACAGCTTTCTATCTCTGTGCCAGTAGTCCGACACCTCAGGGGGCAAGGTATGGCTACACCTTCGGTTCG	CASSPTPQGARYGYTF	11
CCTCCCAGACATCTGTGTACTTGTGTGCCAGCAGTTTCAATAGGGAAACTGAAGCTTTCTTTGGACAA	CASSFNRETEAFF	1
GCTCCCAGACATCTGTGTATTTCTGCGCCAGCAGGGACTAGCGGGAAGTTACAATGAGCAGTTCTTCGGGCCA		1
CCTCCCAGACATCTGTGTACTTGTGTGCCTCGAGGGAACAGGCGAACACTGAAGCTTTCTTTGGACAA	CASREQANTEAFF	3
CCCAACCAGACAGCTCTTTACTTCTGTGCCACCAGTGAAGGGGGGACCGGGACCTCGGAAGAGACCCAGTACTTCGGGCCA	CATSEGGTGTSEETQYF	9
ATCCTGAAGACAGCAGCTTCTACATCTGCAGTGCAACCCGACAGCCTATGAACACTGAAGCTTTCTTTGGACAA	CSATRQPMNTEAFF	3
CCCTGAAGACAGCAGCATATATCTCTGCAGCGTTTCCTTATTCGAACCTGAAGCTTTCTTTGGACAA	CSVSLFEPEAFF	7
CACCAACCAGACATCTATGTACCTCTGTGCCAGCAGTTTACTGGCGGGAGCGTTTCTAGCACAAGAGACCCAGTACTTCGGGCCA	CASSLLAGAFLAQETQYF	6
CTCCCTCYCAGACWTCTGTKTACTTSTGTGCCAGCAGTAACCGACGAGGACAGGGGAACTACGAGCAGTACTTCGGGCCG	CASSNRRGQGNYEQYF	3
CACCAACCAGACATCTATGTACCTCTGTGCCAGCAGTTCCGACAGGGTGCTAGGCTACACCTTCGGTTCG	CASSSDRVLGYTF	1
GACTCGGCCGTGTATSTCTGTGCCAGCAGCTTATCCAGGGGATTGGACGACACTGAAGCTTTCTTTGGACAA	CASSLSRGLDDTEAFF	6
TGGGGGACTCAGCTTTGTATTTCTGTGCCAGCAGTGTAAGAGGGGAAACCGGGGAGCTGTTTTTTGGAGAA	CASSVRGETGELFF	1
CCTCCCAGACATCTGTGTACTTGTGTGCCAGCAGGATTCAAAGCGGGCCTCAAAAACATTCAGTACTTCGGCGCC		5
ATCCTGAAGACAGCAGCTTCTACATCTGCAGTGCTAGGGGGCCCGGGACAGGTCCCGCTGTTTGGACAA		1
GACTCGGCCGTGTATGTCTGTGCCAGCAGCTTGGGGGGCTTTTACACAGATACGCAGTATTTTGGCCCA	CASSLGGFYTDTQYF	3
TYCTCAGTGACTCTGGCTTCTATCTCTGTGCCTGGATGGCTTGGGGGGCCAGTGGCTACACCTTCGGTTCG	CAWMAWGASGYTF	5
CCCWMCCAGACAKCTSTKTACTTSTGTGCCAGCAGTTTAGCTAGGACCCCGAAGAATGAGCAGTTCTTCGGGCCA	CASSLARTPKNEQFF	1
GGACTCGGCCCTTTATCTTTGCGCCAGCAGCCCGACTAGCGGGGGATCCGGGGAGCTGTTTTTTGGAGAA	CASSPTSGGSGELFF	4
CAGAACTGGAGGATTCTGGAGTTTATTTCTGTGCCAGCAGCCAAGATACGAATACGAGCAGTACTTCGGGCCG		4
TSRGGGACTCAGCTKTGTAYTTCTGTGCCAGCAGTGAATTGACAGGGGATCAGCCCCAGCATTTTGGTGAT	CASSELTGDQPQHF	7
CCTCACATACCTCTCAGTACCTCTGTGCCAGCAGTGAATATACGGGAACCTACGAGCAGTACTTCGGGCCG	CASSEYTGTYEQYF	6
GACGCAGCCATGTACCTGTGTGCCACCAGCAGAGAATACACAGGGAACTACGAGCAGTACTTCGGGCCG	CATSREYTGNYEQYF	2
AGCTTGGTGACTCTGCTGTGTATTTCTGTGCCAGCAGCCAAGGGAGACGGGATGCTTTCTTTGGACAA	CASSQGRRDAFF	1
TCMRGRGACWCAGCWSKGTAYTTCTGTGCCACTAAAAGACAGGGGGCAAGGACCGGGGAGYTGTTTTTTGGAGAA	CATKRQGARTGELFF	2
CACCAACCAGACATCTATGTACCTCTGTGCCAGCAGTGTGACAGGCGATAGCACAGATACGCAGTATTTTGGCCCA	CASSVTGDSTDTQYF	14
CAAAAGAACCCGACAGCTTTCTATCTCTGTGCCAGTAGCACTAGCGGGGTAGCAGATACGCAGTATTTTGGCCCA	CASSTSGVADTQYF	1
CAAAAGAACCCGACAGCTTTCTATCTCTGTGCCAGTAGTATGGGCCCTAGCGGGGGGGCGGTAAATACGCAGTATTTTGGCCCA	CASSMGPSGGAVNTQYF	4
GACTCGGCCGTGTATGTCTGTGCCAGCAGCCATGGACTAGCGGGGTACGAGCAGTACTTCGGGCCG	CASSHGLAGYEQYF	25
GACTCGGCCGTGTATGTCTGTGCCAGCAGCTTTAACCAGGGACAGAGCAACGAGCAGTACTTCGGGCCG	CASSFNQGQSNEQYF	5
MAGAAGACTCAGCYSYGTATCTCTGCGCCAGCAGCCGACAGGGACAGCCGGACACTGAAGCTTTCTTTGGACAA	CASSRQGQPDTEAFF	36
ATCCTGAAGACAGCAGCTTCTACATCTGCAGTGCTGATACCGGGACTAGCGCCTTGAACGAGCAGTACTTCGGGCCG	CSADTGTSALNEQYF	1
GACTCGGCCGTGTATGTCTGTGCCAGCAGCCCCCTGGCGGGGAGGAGCAATCAGCCCCAGCATTTTGGTGAT	CASSPLAGRSNQPQHF	28
CACCAACCAGACATCTATGTACCTCTGTGCCAGCAGTTTGGGGGGGCCCCCCAATCAGCCCCAGCATTTTGGTGAT	CASSLGGPPNQPQHF	1
CCTCCCAGACATCTGTGTACTTGTGTGCCAGCAGCCGATCGGACGATCCCTCCTACGAGCAGTACTTCGGGCCG	CASSRSDDPSYEQYF	3
CTTGGTGACTCTGCTGTGTATTTCTGTGCCAGCAGCCAAGATTACCGGACAGGGGGCGGGAGCGGCACTGAAGCTTTCTTTGGACAA	CASSQDYRTGGGSGTEAFF	7
GGACTCGGCCCTTTATCTTTGCGCCAGCAGCTGGGGACTAGCGGGAAGTGCCGGGGAGCTGTTTTTTGGAGAA	CASSWGLAGSAGELFF	2
CCTCACATACCTCTCAGTACCTCTGTGCCAGCAGTAGACAGGGTGCAGATACGCAGTATTTTGGCCCA	CASSRQGADTQYF	12
AGGACTCSGCCGTGTATCTCTGTGCCAGCAGCCCCCCGACCGGAGAGACCCAGTACTTCGGGCCA	CASSPPTGETQYF	6
GACGCAGCCATGTACCTGTGTGCCACCAGCAGCCGGACTAGCGGGAGGCGCCTAGCACAGATACGCAGTATTTTGGCCCA		45
GACTCGGCCGTGTATGTCTGTGCCAGCAGCTTTCCGGGACAGTCCTATGGCTACACCTTCGGTTCG	CASSFPGQSYGYTF	3
CAAAAGAACCCGACAGCTTTCTATCTCTGTGCCAGTAGTCATCTCCAGGGTTATAATTCACCCCTCCACTTTGGGAAC	CASSHLQGYNSPLHF	3
TTCTCAGTGACTCTGGCTTCTATCTCTGTGCCTGGAGCTTATGGACAGACGATAGCAATCAGCCCCAGCATTTTGGTGAT	CAWSLWTDDSNQPQHF	8
CGAAGCTTGAGGATTCAGCAGTGTATTTTTGTGCCAGCAGCCAAAGTGTGGGGGACAGCGGCCAGCCCCAGCATTTTGGTGAT	CASSQSVGDSGQPQHF	4
GACTCGGCCRTGTATSKCTGTGCCAGCAGCCCATACGGGACACAGCATAACACTGAAGCTTTCTTTGGACAA	CASSPYGTQHNTEAFF	7
CAGAACTGGAGGATTCTGGAGTTTATTTCTGTGCCAGCAGCCCGGACAGTAACCAAGAGACCCAGTACTTCGGGCCA	CASSPDSNQETQYF	7
CAAAAGAACCCGACAGCTTTCTATCTCTGTGCCAGTAGTATGTTTAATGAGCAGTTCTTCGGGCCA	CASSMFNEQFF	5
CGAGGAGATTCGGCAGCTTATTTCTGTGCCAGCTCATCACACAGGGGACGGCGGATTCAGTACTTCGGCGCC	CASSSHRGRRIQYF	2
CCTCACATACCTCTCAGTACCTCTGTGCCAGCAGCGCGGGGGACCGCACAGATACGCAGTATTTTGGCCCA	CASSAGDRTDTQYF	1
GACTCGGCCGTGTATGTCTGTGCCAGCAGCAGTAGAACAGGGATCACTGAAGCTTTCTTTGGACAA	CASSSRTGITEAFF	6
ATCCTGAAGACAGCAGCTTCTACATCTGCAGTGTCGGGATAGAGAGTGGCTACACCTTCGGTTCG	CSVGIESGYTF	3
CCTCCCAGACATCTGTGTACTTGTGTGCCAGCAGTCCCGGGGGGCGATGGAATCAGCCCCAGCATTTTGGTGAT	CASSPGGRWNQPQHF	4
CGAGGAGATTCGGCAGCTTATTTCTGTGCCAGCTCACGAGCAGGCGGGGACCCCTCTGGAAACACCATATATTTTGGAGAG	CASSRAGGDPSGNTIYF	10
CGAGGAGATTCGGCAGCTTATTTCTGTGCCAGCTCACCCGCGGCAGGAGCCAACTATGGCTACACCTTCGGTTCG	CASSPAAGANYGYTF	19
TSRGGGACTCAGCTKTGTAYTTCTGTGCCAGCAGGACCGGGACAGGGGCCTACGAGCAGTACTTCGGGCCG	CASRTGTGAYEQYF	2
GACTCGGCCRTGTATSKCTGTGCCAGCAGCCCACTAGCGGGAGTAACAGATACGCAGTATTTTGGCCCA	CASSPLAGVTDTQYF	6
MAGAAGACTCAGCYSYGTATCTCTGCGCCAGCAAATTCGGCGGGGGGTTTGGCGGGGAGCTGTTTTTTGGAGAA	CASKFGGGFGGELFF	1
CGAGGAGATTCGGCAGCTTATTTCTGTGCCAGCTCGGGTCAGGGATCCGGTAACACCGGGGAGCTGTTTTTTGGAGAA	CASSGQGSGNTGELFF	15
GACTCGGCCGTGTATGTCTGTGCCAGCAGCTTAGAAGGCTACACAGATACGCAGTATTTTGGCCCA	CASSLEGYTDTQYF	1
ATCCTGAAGACAGCAGCTTCTACATCTGCAGTGCTAGAGGGACTCCGGGACTAGCGGCCCCACGAGCAGTTCTTCGGGCCA		1
CCCAACCAGACAGCTCTTTACTTCTGTGCCACCAGTGTTTACGTCCAACTATGAAGCTTTCTTTGGACAA		3
CAGAACTGGAGGATTCTGGAGTTTATTTCTGTGCCAGCAGCCAAGTTCGGGGGGCATCTAATGAAAAACTGTTTTTTGGCAGT	CASSQVRGASNEKLFF	1
TGGGGGACTCAGCTTTGTATTTCTGTGCCAGCAGTGCGACCACGCCCGGGGAGCTGTTTTTTGGAGAA	CASSATTPGELFF	1
ASCTCCCAGACATCTGTGTACTTSTGTGCCAGCGCACCGGGACAGGGGAGTGAAAAACTGTTTTTTGGCAGT	CASAPGQGSEKLFF	1
CAGAACTGGAGGATTCTGGAGTTTATTTCTGTGCCAGCAGCCGAAACAGCGGGGGGGCCTTTGAGCAGTTCTTCGGGCCA	CASSRNSGGAFEQFF	1
CAAAAGAACCCGACAGCTTTCTATCTCTGTGCCAGTAGTTGGACCGAGGACGTGAATGAGCAGTTCTTCGGGCCA	CASSWTEDVNEQFF	3
CAGAAGACTCAGCCCTGTATCTCTGCGCCAGCAGCCAAGGGGCAGACACCATATATTTTGGAGAG	CASSQGADTIYF	3
CGAGGAGATTCGGCAGCTTATTTCTGTGCCAGCTCACCACCTTTTCGGGACCAAGAGACCCAGTACTTCGGGCCA	CASSPPFRDQETQYF	10
CCTCCCAGACATCTGTGTACTTGTGTGCCTCGGGGGGAAGCGGCTACTACAATGAGCAGTTCTTCGGGCCA	CASGGSGYYNEQFF	8
CCCAACCAGACAGCTCTTTACTTCTGTGCCACCAGTGATTTCCAGGGTACCCTACAATGAGCAGTTCTTCGGGCCA		8
AACCCAGGGACTCAGCTGTGTATTTTTGTGCCAGCAGTTTTTCTGCACAGGGAATCAACGGCTACACCTTCGGTTCG	CASSFSAQGINGYTF	1
CCCTGAAGACAGCAGCATATATCTCTGCAGCGTTGGCAGGGGTGACACTGAAGCTTTCTTTGGACAA	CSVGRGDTEAFF	4
CCTCCCAGACATCTGTGTACTTGTGTGCCATCAGTAGCGGTCATAGCAATCAGCCCCAGCATTTTGGTGAT	CAISSGHSNQPQHF	2
CAGAACTGGAGGATTCTGGAGTTTATTTCTGTGCCAGCAGCCAGGGACAGGGGGGCACCGGGGAGCTGTTTTTTGGAGAA	CASSQGQGGTGELFF	20
TGTACCCTCYCAGACATCTGTGTACTTSTGTGCCAGCAGCGCCGGGACTAGGCACAATGAGCAGTTCTTCGGGCCA	CASSAGTRHNEQFF	7
CCTCCCAGACATCTGTGTACTTGTGTGCCATCAGTGGAAGCACAGAGAATGAAAAACTGTTTTTTGGCAGT	CAISGSTENEKLFF	6
GACTCGGCCGTGTATGTCTGTGCCAGCGGTTCGGTTACAGGGGGAAATGGACCCCAGCATTTTGGTGAT	CASGSVTGGNGPQHF	1
CCTCCCAGACATCTGTGTACTTGTGTGCCAGCAGGACACTCGCAGGGTTGAACACTGAAGCTTTCTTTGGACAA	CASRTLAGLNTEAFF	9
CCTCCCAGACATCTGTGTACTTGTGTGCCAGCAGAGACTAGCGCTACCCCAAGAGACCCAGTACTTCGGGCCA		8
AACCCAGGGACTCAGCTGTGTATTTTTGTGCCAGCAGTTTTGGGACCATGAATACTGAAGCTTTCTTTGGACAA	CASSFGTMNTEAFF	17
GAGACACGGCACTGTATCTCTGCGCCAGCAACACCAATGACAGGAATTAGCAATCAGCCCCAGCATTTTGGTGAT		4
AACCCAGGGACTCAGCTGTGTAYTTYTGTGCCAGCAGTCCACCCTCAGGTCAAGTCACTGAAGCTTTCTTTGGACAA	CASSPPSGQVTEAFF	2
GACTCGGCCGTGTATGTCTGTGCCAGCACCCTCCAGGGACAGGGAAGATACGCAGTATTTTGGCCCA		8
ATCCTGAAGACAGCAGCTTCTACATCTGCAGTGCTAGGCTCGCGGGGCAAACTGAAGCTTTCTTTGGACAA	CSARLAGQTEAFF	41
GACTCGGCCGTGTATGTCTGTGCCAGCAGCTTAGCAGGCGGAAGCTCCTACGAGCAGTACTTCGGGCCG	CASSLAGGSSYEQYF	1
AACCCAGGGACTCAGCTGTGTATTTTTGTGCCAGCAGTTTAACTGGGGCCAACGTCCTGACTTTCGGGGCC	CASSLTGANVLTF	8
AGCTTGGTGACTCTGCTGTGTATTTCTGTGCCAGCAGCCAATTAGCGGGGGGCGGGGAGACCCAGTACTTCGGGCCA	CASSQLAGGGETQYF	14
TSRGGGACTCAGCTKTGTAYTTCTGTGCCAGCGACCCTTTGGGCGGGACCGGGGAGCTGTTTTTTGGAGAA	CASDPLGGTGELFF	1
CCTCCCAGACATCTGTGTACTTGTGTGCCAGCAGTTACCAATCCGGGACAGGGTACTATGGCTACACCTTCGGTTCG	CASSYQSGTGYYGYTF	1
TGGGGGACTCAGCTTTGTATTTCTGTGCCAGCAGCCCGGACAGGGGAAGAGTTACCGGGGAGCTGTTTTTTGGAGAA	CASSPDRGRVTGELFF	2
CCCAACCAGACAGCTCTTTACTTCTGTGCCACCAGGAGTCAAGGGAGGGGGAATGAGCAGTTCTTCGGGCCA	CATRSQGRGNEQFF	17
TGGGGGACTCAGCTTTGTATTTCTGTGCCAGCATTGTCGGGACCTACGAGCAGTACTTCGGGCCG	CASIVGTYEQYF	3
CAAAAGAACCCGACAGCTTTCTATCTCTGTGCCAGTAGTATAGATCTACAGGAAAGGGCGGACAATGAGCAGTTCTTCGGGCCA	CASSIDLQERADNEQFF	12
CTTGGTGACTCTGCTGTGTATTTCTGTGCCAGCAGCAGCGGGGTCACCCCTTCACAAAGTCGGGCCAACGTCCTGACTTTCGGGGCC	CASSSGVTPSQSRANVLTF	3
CACCAACCAGACATCTATGTACCTCTGTGCCAGCAGTCTAGGGTCCGGTTTAAACATTCAGTACTTCGGCGCC	CASSLGSGLNIQYF	1
GACTCGGCCGTGTATGTCTGTGCCAGCAGTTCGGACAGGGGGCAACCGGGGAACACTGAAGCTTTCTTTGGACAA	CASSSDRGQPGNTEAFF	10
ATCCTGAAGACAGCAGCTTCTACATCTGCAGTGCTAGAGCGGGGGGGATGGGGACCGGGGAGCTGTTTTTTGGAGAA	CSARAGGMGTGELFF	7
ATCCTGAAGACAGCAGCTTCTACATCTGCAGTGCTAGGGATCAACAGAGATATAATTCACCCCTCCACTTTGGGAAC	CSARDQQRYNSPLHF	1
TYRGGRGACWCAGCWYKGTATTTCTGTGCCAGCAGCTCCTTAACTAGCGGGAGGGCCCCCTACGAGCAGTACTTCGGGCCG	CASSSLTSGRAPYEQYF	8
TGGGGGACTCAGCTTTGTATTTCTGTGCCACGACAAAAGGACAGGGTAACTATGGCTACACCTTCGGTTCG	CATTKGQGNYGYTF	4
CCCAACCAGACAGCTCTTTACTTCTGTGCCACCAGTGATTCCATTGTAGCGGGAGTTTCAGTCGAGCAGTTCTTCGGGCCA	CATSDSIVAGVSVEQFF	1
TGGRGGACTCAGCYWTGTAYTTCTGTGCCAGCAGTCCAACAGGGTTTGGCGAGCAGTACTTCGGGCCG	CASSPTGFGEQYF	8
CAAAAGAACCCGACAGCTTTCTATCTCTGTGCCAGTAGTATTGGAGGGGCAGGGGCCAAAAACATTCAGTACTTCGGCGCC	CASSIGGAGAKNIQYF	4
GCTCCCAGACATCTGTGTATTTCTGCGCCAGCAGCTACGGGACAGGGATCCGCACAGATACGCAGTATTTTGGCCCA	CASSYGTGIRTDTQYF	1
CGAGGAGATTCGGCAGCTTATTTCTGTGCCAGCTCACCTGGGACGGCCACTGAAGCTTTCTTTGGACAA	CASSPGTATEAFF	20
GACTCGGCCGTGTATGTCTGTGCCAGCAGCTTCGGGGGGGTGGCTACCTACGAGCAGTACTTCGGGCCG	CASSFGGVATYEQYF	1
GAGACACGGCACTGTATCTCTGCGCCAGCAGCCTCCTAGATCGGCAGCCCCAGCATTTTGGTGAT	CASSLLDRQPQHF	1
GACTCGGCCGTGTATGTCTGTGCCAGCAGCTTAGATCTGGTAGTCGGAAACACCATATATTTTGGAGAG	CASSLDLVVGNTIYF	15
TTCTCAGTGACTCTGGCTTCTATCTCTGTGCCTGGGCCTTTGGGGGCAGAGAGACCCAGTACTTCGGGCCA	CAWAFGGRETQYF	4
CCCAACCAGACAGCTCTTTACTTCTGTGCCACCAGTGATTTGGACAGGGTGAAGAGACCCAGTACTTCGGGCCA		3
CTCCCTCTCAGACTTCTGTTTACTTCTGTGCCAGCAGTTCCCCGGGCCGAAACTATGGCTACACCTTCGGTTCG	CASSSPGRNYGYTF	3
CCCTGAAGACAGCAGCATATATCTCTGCAGCGTGATTGGCGGTGGTTCCTACAATGAGCAGTTCTTCGGGCCA	CSVIGGGSYNEQFF	7
AACCCAGGGACTCAGCTGTGTAYTTYTGTGCCAGCAGCCCTACTCAGGGGGATGAGCAGTTCTTCGGGCCA	CASSPTQGDEQFF	11
CCTCCCAGACATCTGTGTACTTGTGTGCCAGCAGTAAACTAGCGGGGGGACCCAATGAGCAGTTCTTCGGGCCA	CASSKLAGGPNEQFF	6
CAAAAGAACCCGACAGCTTTCTATCTCTGTGCCAGTAGTATTGCCCCCGTCTCAAGGGGGTGGGAGACCCAGTACTTCGGGCCA	CASSIAPVSRGWETQYF	5
CCCAACCAGACAGCTCTTTACTTCTGTGCCACCAGTGGTCGGGTCAATGAGCAGTTCTTCGGGCCA	CATSGRVNEQFF	6
GAGACWCGGCMMTGTATCKCTGYGCCAGCAGACCGGACAGGGGGCAGGTCGGGACCCAGTACTTCGGGCCA	CASRPDRGQVGTQYF	1
GACTCGGCCGTGTATGTCTGTGCCAGCAGCCGGGGGCAGGGGGCATACGAGCAGTACTTCGGGCCG	CASSRGQGAYEQYF	1
GACTCGGCCGTGTATGTCTGTGCCAGAAGCTTGGGGAGGTACTCCAACTGAACACTGAAGCTTTCTTTGGACAA		3
TSRGGGACTCAGCTKTGTAYTTCTGTGCCAGCAGTGAGGTTTTACAAGAGACCCAGTACTTCGGGCCA	CASSEVLQETQYF	1
CCTCCCAGACATCTGTGTACTTGTGTGCCAGCACCCAAGGGGACAACTCCTACGAGCAGTACTTCGGGCCG	CASTQGDNSYEQYF	38
ATCCTGAAGACAGCAGCTTCTACATCTGCAGTGCTGAACTAGCGGGGGGGCCAGATACGCAGTATTTTGGCCCA	CSAELAGGPDTQYF	3
CACCAACCAGACATCTATGTACCTCTGTGCCAGCAGACCAACAGGGGCCGTTAACTATGGCTACACCTTCGGTTCG	CASRPTGAVNYGYTF	1
GACGCAGCCATGTACCTGTGTGCCACCAGCAGGGGGGGTGGGCGCAATCAGCCCCAGCATTTTGGTGAT	CATSRGGGRNQPQHF	3
ATCCTGAAGACAGCAGCTTCTACATCTGCAGTGCTAAGTGGGGACTAACCCAAGAGACCCAGTACTTCGGGCCA	CSAKWGLTQETQYF	3
GACTCGGCCGTGTATGTCTGTGCCAGCAGCTCGACAGGGATGAACACTGAAGCTTTCTTTGGACAA	CASSSTGMNTEAFF	5
CAAAAGAACCCGACAGCTTTCTATCTCTGTGCCAGCCGTGCGGTAAGCTCTGGAAACACCATATATTTTGGAGAG	CASRAVSSGNTIYF	1
CCTCCCAGACATCTGTGTACTTGTGTGCCAGCAGCCTGGAGGGGCCGGTTCTGAAGCTTTCTTTGGACAA		6
ATCCTGAAGACAGCAGCTTCTACATCTGCAGTGCTAGAGGGGATAGGAGGCTGGGTAGCACAGATACGCAGTATTTTGGCCCA	CSARGDRRLGSTDTQYF	1
CCCAACCAGACAGCTCTTTACTTCTGTGCCACCAGTGAGAGGTCTGGGGATACGCAGTATTTTGGCCCA	CATSERSGDTQYF	6
AAAAGAACCCGACAGCTTTCTATCTCTGTGCCAGTTCCATAGTCAGGGGGCGAGGGTCCGGAGAACACTGAAGCTTTCTTTGGACAA		1
CGAGGAGATTCGGCAGCTTATTTCTGTGCCAGCTCACCGGACGGACAGGGAAACTATGGCTACACCTTCGGTTCG	CASSPDGQGNYGYTF	1
AGCTTGGTGACTCTGCTGTGTATTTCTGTGCCAGCAGCCCCATGGCAGGGGGAGGGCGGACTGAAGCTTTCTTTGGACAA	CASSPMAGGGRTEAFF	4
CTGGAGTTTATTTCTGTGCCAGCAGCCAAGTATTTAGAAGCACCGGGAAGACTCCTACAATGAGCAGTTCTTCGGGCCA		1
CAAAAGAACCCGACAGCTTTCTATCTCTGTGCCAGTAGCCCCGGGACTAGGAACACCGGGGAGCTGTTTTTTGGAGAA	CASSPGTRNTGELFF	8
CGAGGAGATTCGGCAGCTTATTTCTGTGCCAGCTCACCGTCTGCAGGGGGCAAGACTGAAGCTTTCTTTGGACAA	CASSPSAGGKTEAFF	7
CACCAACCAGACATCTATGTACCTCTGTGCCAGCAGTTTGCCCCCGCCGTGGGACACTGAAGCTTTCTTTGGACAA	CASSLPPPWDTEAFF	42
CCCAACCAGACAGCTCTTTACTTCTGTGCCATCAAACGGGAAGGCGGCACTGAAGCTTTCTTTGGACAA	CAIKREGGTEAFF	1
CACCAACCAGACATCTATGTACCTCTGTGCCAGCAGTTTATGGCAGAACCCCTCTGGAAACACCATATATTTTGGAGAG	CASSLWQNPSGNTIYF	1
CGAGGAGATTCGGCAGCTTATTTCTGTGCCAGCTCCGCGGCAGTCAATCAGCCCCAGCATTTTGGTGAT	CASSAAVNQPQHF	1
TGGRGGACTCAGCYWTGTAYTTCTGTGCCAGCAGTCGACTTACAGGAAGCAATCAGCCCCAGCATTTTGGTGAT	CASSRLTGSNQPQHF	51
CCCAACCAGACAGCTCTTTACTTCTGTGCCAGCAGCTCACAGGGGGGCCTGGGCAAAAACATTCAGTACTTCGGCGCC	CASSSQGGLGKNIQYF	3
ATCCTGAAGACAGCAGCTTCTACATCTGCAGTGCTAGACAGTACTAGCGGTAAAAAGCTCCTACGAGCAGTACTTCGGGCCG		1
GCTCCCAGACATCTGTGTATTTCTGCGTCACCTTATTGGATATAGGATTAAATGCTGAAGCTTTCTTTGGACAA	CVTLLDIGLNAEAFF	2
TGGGGGACTCAGCTTTGTATTTCTGTGCCAGCAGCACACAGGGACAGGGGGCTTCCGAGCAGTACTTCGGGCCG	CASSTQGQGASEQYF	1
TTCTCAGTGACTCTGGCTTCTATCTCTGTGCCTGGAGTACCTCGGGTAGCAATCAGCCCCAGCATTTTGGTGAT	CAWSTSGSNQPQHF	3
TGGGGGACTCAGCTTTGTATTTCTGTGCCAGCAGTGAAAGGGGCCTTTCGGGAGATGAGCAGTTCTTCGGGCCA	CASSERGLSGDEQFF	3
CCCTGAAGACAGCAGCATATATCTCTGCAGCGTTGATCGGGCGGGAGGGTATGAGCAGTTCTTCGGGCCA	CSVDRAGGYEQFF	6
CCTCCCAGACATCTGTGTACTTGTGTGCCAGCAGTCCCGGACCGGTGAATGAAAAACTGTTTTTTGGCAGT	CASSPGPVNEKLFF	2
AGCTTGGTGACTCTGCTGTGTATTTCTGTGCCAGCAGCCAAGGATCGGGACCGCCCTCCGCTTTCTTTGGACAA	CASSQGSGPPSAFF	1
SGACTCRGCYRTGTATCKCTGTGCCAGCAGTTCCCCCGAGGGGAGGTGAGCAGTTCTTCGGGCCA		5
CACCAACCAGACATCTATGTACCTCTGTGCCAGCAGTTCCCCCGCAGCGAACACTGAAGCTTTCTTTGGACAA	CASSSPAANTEAFF	11
GACTCGGCCGTGTATGTCTGTGCCAGCAGCTCGCAGGGGGTTCGCACTGAAGCTTTCTTTGGACAA	CASSSQGVRTEAFF	102
AACCCAGGGACTCAGCTGTGTATTTTTGTGCCAGCAGTTCAAGGGGAAGGGACACTGAAGCTTTCTTTGGACAA	CASSSRGRDTEAFF	1
CCACGTTTGGTGCCAGCCAGACCTCTGTACCTCTGTGCCAGCAGCTCACAGGGGGGCCTGGGCAAAAACATTCAGTACTTCGGCGCC	CASSSQGGLGKNIQYF	1
CTCCCTCTCAGACTTCTGTTTACTTCTGTGCCAGCAGTTACAGGAAAAATAGCGGGAGAACAGATACGCAGTATTTTGGCCCA	CASSYRKNSGRTDTQYF	10
CAAAAGAACCCGACAGCTTTCTATCTCTGTGCCAGTATGATGAGGACGGGGATAGACAATCAGCCCCAGCATTTTGGTGAT	CASMMRTGIDNQPQHF	8
GACTCGGCCGTGTATGTCTGTGCCAGCAGCTTGGGAGGGGATTTCTACGAGCAGTACTTCGGGCCG	CASSLGGDFYEQYF	6
CAGAACTGGAGGATTCTGGAGTTTATTTCTGTGCCAGCAGCCAAGTACTTTTCGGCACAGATACGCAGTATTTTGGCCCA	CASSQVLFGTDTQYF	21
CCTCCCAGACATCTGTGTACTTGTGTGCCATCAAAGAACAGGGCCCTATTTACGAGCAGTACTTCGGGCCG	CAIKEQGPIYEQYF	24
CAGAAGACTCAGCCCTGTATCTCTGCGCCAGCAGCCAAGTGGGGGGGAACTATGGCTACACCTTCGGTTCG	CASSQVGGNYGYTF	5
GACTCGGCCGTGTATGTCTGTGCCAGCAGCGGACAGGGGGCGAACACCGGGGAGCTGTTTTTTGGAGAA	CASSGQGANTGELFF	4
TGGGGGACTCAGCTTTGTATTTCTGTGCCAGCAGGTACAGGGTGAACACTGAAGCTTTCTTTGGACAA	CASRYRVNTEAFF	2
CAGAAGACTCAGCCCTGTATCTCTGCGCCAGCAGCCCGGGACAGGGGGACCCGCTCATGAACACTGAAGCTTTCTTTGGACAA	CASSPGQGDPLMNTEAFF	6
CTCCCTCYCAGACWTCTGTKTACTTSTGTGCCAGCAGTTACTCGACAGGGGGCTCGGATGGCTACACCTTCGGTTCG	CASSYSTGGSDGYTF	7
TGGRGGACTCAGCYWTGTAYTTCTGTGCCAGCAGTGTGGAGTTGCGGCAGCCCCAGCATTTTGGTGAT	CASSVELRQPQHF	3
ATCCTGAAGACAGCAGCTTCTACATCTGCAGTGCTAGGGCCCGGGAGGGGACAGGGGGCGGCCAGCCCCAGCATTTTGGTGAT	CSARAREGTGGGQPQHF	1
ATCCTGAAGACAGCAGCTTCTACATCTGCAGTGGGGGGCAGGCTCGGTCCTTATCCTACGAGCAGTACTTCGGGCCG	CSGGQARSLSYEQYF	1
CCCTGAAGACAGCAGCATATATCTCTGCAGCGCCAGCCGGACAGGCGGAATATGGAATGAGCAGTTCTTCGGGCCA	CSASRTGGIWNEQFF	8
TCAGGAGACACAGCACGGTATTTCTGTGCCAGCAGCTTAGGCCGAGCGAGGGGGGGAGAGACCCAGTACTTCGGGCCA	CASSLGRARGGETQYF	2
TGGGGGACTCAGCTTTGTATTTCTGTGCCAGCAGTGAATGGTTATAGGGGTAGCGGGGGACAGATACGCAGTATTTTGGCCCA	CASSEWL*G*RGTDTQYF	1
GACTCGGCCGTGTATGTCTGTGCCAGCAGCTTACAGGGAGCTGAAGAAAAACTGTTTTTTGGCAGT	CASSLQGAEEKLFF	4
CACCAACCAGACATCTATGTACCTCTGTGCCAGCAGTGCTCCACTAGCGGGGCTGGGCGATACGCAGTATTTTGGCCCA	CASSAPLAGLGDTQYF	5
TGGGGGACTCAGCTTTGTATTTCTGTGCCAGCAGGGGACAGGGGGCGCCTGGAAACACCATATATTTTGGAGAG	CASRGQGAPGNTIYF	1
CCTCCCAGACATCTGTGTACTTGTGTGCCAGCAGTTACGCAGGCGGCCCTGGGGCCAACGTCCTGACTTTCGGGGCC	CASSYAGGPGANVLTF	1
GACTCGGCCGTGTATGTCTGTGCCAGCAGCTTCCCCCGGGACAGTTCCAAAGCTTTCTTTGGACAA	CASSFPRDSSKAFF	1
CGAGGAGATTCGGCAGCTTATTTCTGTGCCAGCTCACCATCAGGCCTCTCTGGAAACACCATATATTTTGGAGAG	CASSPSGLSGNTIYF	1
CCTCCCAGACATCTGTGTACTTGTGTGCCAGCAGTGGACAGGGATTCAGCTATGGCTACACCTTCGGTTCG	CASSGQGFSYGYTF	5
TSRGGGACTCAGCTKTGTAYTTCTGTGCCAGCAGTGAAACAGGGACCCCAGGGAACTATGGCTACACCTTCGGTTCG	CASSETGTPGNYGYTF	18
ACACGGCACTGTATCTCTGCGCCAGCAGCCAAGATACAACAAAGAGGGGTCTAGCGGGAGGCGCTGGAGACCCAGTACTTCGGGCCA		4
CGAGGAGATTCGGCAGCTTATTTCTGTGCCAGCTCACCGCAAGGTAGGGTGGGGGATGGCACTGAAGCTTTCTTTGGACAA	CASSPQGRVGDGTEAFF	2
GACTCGGCCGTGTATGTCTGTGCCAGCAGCCCCGGGACAGGGAGAAGAGAGCAGTACTTCGGGCCG	CASSPGTGRREQYF	4
CACCAACCAGACATCTATGTACCTCTGTGCCACCGTGACAGGGGGCCAAGAGACCCAGTACTTCGGGCCA	CATVTGGQETQYF	8
CAAAAGAACCCGACAGCTTTCTATCTCTGTGCCAGTAGTCACCGGGACTAGATCGTACAACGAGCAGTACTTCGGGCCG		7
GACTCGGCCGTGTATGTCTGTGCCAGCAGCTTAGGTGGCTAGCGGGAGGACCGGGGAGCTGTTTTTTGGAGAA		4
GACTCGGCCGTGTATCTCTGTGCCAGCAGCTTAGTATACACCGGGGAGCTGTTTTTTGGAGAA	CASSLVYTGELFF	3
CCTCACATACCTCTCAGTACCTCTGTGCCAGCAGTGAATTGGGCAGAACAGATACGCAGTATTTTGGCCCA	CASSELGRTDTQYF	5
GACTCGGCCGTGTATCTCTGTGCCAGCAGCTTAGGGTCAGATCAGCCCCAGCATTTTGGTGAT	CASSLGSDQPQHF	4
CCTCCCAGACATCTGTGTACTTGTGTGCCAGCAGTTACTCCGCTAGCAATCAGCCCCAGCATTTTGGTGAT	CASSYSASNQPQHF	16
GACTCGGCCGTGTATGTCTGTGCCAGCAGCCACCTCGGGGGTGACAGGGAGGAGGAGAAGAGACCCAGTACTTCGGGCCA		1
CCTCACATACCTCTCAGTACCTCTGTGCCAGCAGTTCAGGCGGGAGTCGATACGAGCAGTACTTCGGGCCG	CASSSGGSRYEQYF	25
GACGCAGCCATGTACCTGTGTGCCACCAGCAGCCACCCGGGACTAGCGGGGGTAAGAGACCCAGTACTTCGGGCCA		1
CACCAACCAGACATCTATGTACCTCTGTGCCAACAGTTTAGTTTGGAGGAGGGGATACGAGCAGTACTTCGGGCCG	CANSLVWRRGYEQYF	45
GACTCGGCCGTGTATGTCTGTGCCAGCAGTCCGACAGGGGACTCTGGAAACACCATATATTTTGGAGAG	CASSPTGDSGNTIYF	1
CCTCCCAGACATCTGTGTACTTGTGTGCCAGCAGTAGGTCCTCTGGCTATGGCTACACCTTCGGTTCG	CASSRSSGYGYTF	1
CACCAACCAGACATCTATGTACCTCTGTGCCAGCAGGAATCAGGGGGCGAAGACCCAGTACTTCGGGCCA	CASRNQGAKTQYF	2
CCTCCCAGACATCTGTGTACTTGTGTGCCAGCAGTGTGGGCGGCTATAGCAATCAGCCCCAGCATTTTGGTGAT	CASSVGGYSNQPQHF	3
GGACTCGGCCCTTTATCTTTGCGCCAGCAGCTCCCTCTCTGGGGCCAACGTCCTGACTTTCGGGGCC	CASSSLSGANVLTF	1
CCTCCCAGACATCTGTGTACTTGTGTGCCAGCAGTTACTCGATAGGGGCTACGGACACTGAAGCTTTCTTTGGACAA	CASSYSIGATDTEAFF	2
GACTCGGCCGTGTATGTCTGTGCCAGCAGCTTGACACAAGGGATGGCCACTGAAGCTTTCTTTGGACAA	CASSLTQGMATEAFF	7
CCTCCCAGACATCTGTGTACTTGTGTGCCACCGGGGCAGTTGGAAACACCATATATTTTGGAGAG	CATGAVGNTIYF	7
TSRGGGACTCAGCTKTGTAYTTCTGTGCCAGCGGGGGGGCGCACAGATACGCAGTATTTTGGCCCA		4
CTCCCTCTCAGACTTCTGTTTACTTCTGTGCCAGCAGTCCCCTGGAGACCCAGTACTTCGGGCCA	CASSPLETQYF	10
GCTCCCAGACATCTGTGTATTTCTGCGCCAGCAGTTCGGGACAGGGGGCTCATGACGAGCAGTACTTCGGGCCG	CASSSGQGAHDEQYF	6
CAAAAGAACCCGACAGCTTTCTATCTCTGTGCCGTACAGGGGGTGGCTCAGCCCCAGCATTTTGGTGAT	CAVQGVAQPQHF	6
CGAGGAGATTCGGCAGCTTATTTCTGTGCCAGCTCACCTAGGGACAGATCTAACTATGGCTACACCTTCGGTTCG	CASSPRDRSNYGYTF	4
ATCCTGAAGACAGCAGCTTCTACATCTGCAGTGGCCAACTGGGACTAGCGGGCCTCCAAGAGACCCAGTACTTCGGGCCA	CSGQLGLAGLQETQYF	14
CCTCCCAGACATCTGTGTACTTGTGTGCCAGCAGCCTAATCGGGCAGGGGCGTGAAAAACTGTTTTTTGGCAGT	CASSLIGQGREKLFF	5
GACTCGGCCGTGTATGTCTGTGCCAGCAGCCTGGGCTCCGGGACAGGGTAAGGCAGATACGCAGTATTTTGGCCCA		12
GGGGGACTYRGCTGTGTATCTCTGTGCCAGCAGCCCGACGGGGGGGCGAGCAGTACTTCGGGCCG		5
CTCCCTCYCAGACWTCTGTKTACTTSTGTGCCAGCAGTGCCCCTAGGACTAGCCTCAATGAGCAGTTCTTCGGGCCA	CASSAPRTSLNEQFF	8
ATCCTGAAGACAGCAGCTTCTACATCTGCAGTGCTATGAGGGGGCAAAATTCACCCCTCCACTTTGGGAAC	CSAMRGQNSPLHF	7
GACTCGGCCGTGTATGTCTGTGCCAGCAGCTTCGCAAGTAAAGAACTAAAAGAGCTCCTACGAGCAGTACTTCGGGCCG		1
GACTCGGCCGTGTATGTCTGTGCCAGCAGCTTAGTTTACAGGGACGTTCAGCCCCAGCATTTTGGTGAT	CASSLVYRDVQPQHF	4
GACTCGGCCGTGTATGTCTGTGCCAGCAGCTTGTTTGGAGGCTCCTGGGGGCAGTTCTTCGGGCCA	CASSLFGGSWGQFF	1
ATCCTGAAGACAGCAGCTTCTACATCTGCAGTGCTCGAAGGTACCAAGAGACCCAGTACTTCGGGCCA	CSARRYQETQYF	5
CCTCCCAGACATCTGTGTACTTGTGTGCCAGCAGTTTACCCGGGGAGGAGACCCAGTACTTCGGGCCA	CASSLPGEETQYF	1
GACTCGGCCGTGTATGTCTGTGCCAGCAGCTGTTACTAGCGGGAGGAATGATTGTTAACGCAGTATTTTGGCCCA	CASSCY*REE*LLTQYF	9
GACTCGGCCGTGTATGTCTGTGCCAGCAGCTTAGATGGCGGGAATGGTGAGCAGTTCTTCGGGCCA	CASSLDGGNGEQFF	2
CGAGGAGATTCGGCAGCTTATTTCTGTGCCAGCTCACCATGGGTCACAGATACGCAGTATTTTGGCCCA	CASSPWVTDTQYF	4
CCTCCCAGACATCTGTGTACTTGTGTGCCAGCAGGCAATCAGGGGCTGGCTACACCTTCGGTTCG	CASRQSGAGYTF	3
ATCCTGAAGACAGCAGCTTCTACATCTGCAGTGCTAGAGGAGACAGGAGCTCCTACGAGCAGTACTTCGGGCCG	CSARGDRSSYEQYF	3
GGRGGACTCMGCYGTGTATCTCTGTGCCAGCAGCTTCAACCTGAACACTGAAGCTTTCTTTGGACAA	CASSFNLNTEAFF	6
AGCTTGGTGACTCTGCTGTGTATTTCTGTGCCAGCAGCCAAGAGATTCAAGGAGACCCAGTACTTCGGGCCA		2
CAAAAGAACCCGACAGCTTTCTATCTCTGTGCCAGTGGGACAAAGGGGCCTCGCTCACCCCTCCACTTTGGGAAC	CASGTKGPRSPLHF	7
GACTCGGCCGTGTATGTCTGTGCCAGCAACACGGGACTTTTGGGTGGAAACACCATATATTTTGGAGAG	CASNTGLLGGNTIYF	6
AAGAAGACTCAGCTGCGTATCTCTGCACCAGCAGCCACAGGGGGATCAATCAGCCCCAGCATTTTGGTGAT	CTSSHRGINQPQHF	5
GGAGACACAGCACGGTATTTCTGTGCCAGCAGCCTGTCAGTCCCGGGACTAGCGGGAGGGCCCTCCGGGGAGCTGTTTTTTGGAGAA	CASSLSVPGLAGGPSGELFF	11
CCTCCCAGACATCTGTGTACTTGTGTGCCAGCAGTCCTGGGGACTTTAGAGGTGAAAAACTGTTTTTTGGCAGT	CASSPGDFRGEKLFF	2
GACTCGGCCGTGTATGTCTGTGCCAGCAGCTTGGGCAGGGTCCCAGATACGCAGTATTTTGGCCCA	CASSLGRVPDTQYF	2
CAAAAGAACCCGACAGCTTTCTATCTCTGTGCCAGTAGTATTCGTTCCTCCTACGAGCAGTACTTCGGGCCG	CASSIRSSYEQYF	14
CCTCCCAGACATCTGTGTACTTGTGTGCCAGCAGTGAAGCGAATGCGGCGGCCTCCTATGGCTACACCTTCGGTTCG	CASSEANAAASYGYTF	1
AACCCAGGGACTCAGCTGTGTAYTTYTGTGCCAGCAGTGCCGGTCCTAACACTGAAGCTTTCTTTGGACAA	CASSAGPNTEAFF	1
GACTCGGCCGTGTATGTCTGTGCCAGCAGCTTAGGCGGACTAGCGGGAGGTCACAATGAGCAGTTCTTCGGGCCA	CASSLGGLAGGHNEQFF	2
AACCCAGGGACTCRGCYGTGTATKTYTGTGCCAGCAGCTTACATCCTCTGACCAGGAGATATGAGACTGAAGCTTTCTTTGGACAA	CASSLHPLTRRYETEAFF	18
ATCCTGAAGACAGCAGCTTCTACATCTGCAGTGTCCTCAGGGTAGGAACTGAAGCTTTCTTTGGACAA	CSVLRVGTEAFF	1
CCTCCCAGACATCTGTGTACTTGTGTGCCAGCAGTGAGCAGGGGCTTTACTACTACGAGCAGTACTTCGGGCCG	CASSEQGLYYYEQYF	5
TGGGGGACTCAGCTTTGTATTTCTGTGCCAGCAGGCTGGACGGTTTGACCTACGAGCAGTACTTCGGGCCG	CASRLDGLTYEQYF	2
CRRRRGACTCAGCCSTGTATCTCTRCGCCAGCAGCCGGACTAGCGGCTACGAGCAGTACTTCGGGCCG	XASSRTSGYEQYF	10
CAAAAGAACCCGACAGCTTTCTATCTCTGTGCCAGTAGACCGACAGGGGCGCTGGGCGAAGCTTTCTTTGGACAA	CASRPTGALGEAFF	9
TGGGGGACTCAGCTTTGTATTTCTGTGCCAGCAGTGAAAGACAGTACAATGAGCAGTTCTTCGGGCCA	CASSERQYNEQFF	45
GACTCGGCCGTGTATGTCTGTGCCAGCAGCCCCCCCCCGGACTAGGGCGGGAGAGACCCAGTACTTCGGGCCA		23
CCCTGAAGACAGCAGCATATATCTCTGCAGCGTTGATGCGGCAGGGGGCGATCTAAACATTCAGTACTTCGGCGCC	CSVDAAGGDLNIQYF	34
CTCCCTCYCARACWTCTGTKTACTTCTGTGCCAGCAGTGACGGACAGGGCGCAGATACGCAGTATTTTGGCCCA	CASSDGQGADTQYF	5
GAGACACGGCACTGTATCTCTGCGCCAGCAGTCAATCGTACGGCGGAGGTAGGCATCAGCCCCAGCATTTTGGTGAT	CASSQSYGGGRHQPQHF	4
AACCCAGGGACTCAGCTGTGTATTTTTGTGCCAGCAGTCGAACAGGGGGGCTAGAGACCCAGTACTTCGGGCCA	CASSRTGGLETQYF	5
GACTCGGCCGTGTATGTCTGTGCCAGCAGCCCGGGGACGGGAGCTGATCAGCCCCAGCATTTTGGTGAT	CASSPGTGADQPQHF	3
CCTCCCAGACATCTGTGTACTTGTGTGCCATCAGCACTCGATTTAACGAACCGTCAGATACGCAGTATTTTGGCCCA	CAISTRFNEPSDTQYF	39
GACTCGGCCGTGTATGTCTGTGCTAGCAGCCCCCGACTAGATCTTCAAGAGACCCAGTACTTCGGGCCA	CASSPRLDLQETQYF	1
GACTCGGCCGTGTATGTCTGTGCCAGCAGCTATCCGGGGCACGGGGTAGGCTACACCTTCGGTTCG	CASSYPGHGVGYTF	4
GACTCGGCCGTGTATGTCTGTGCCAGCAGCTTATACGACGGTCTTACCGTCTATGCTCTGGGGCCAACGTCCTGACTTTCGGGGCC		44
CAGRAGACWCRGCMCTGTATCTCTGCGCCAGCAGCCAAGATCAGGAGGGGCGCGGAGCTTTCTTTGGACAA	CASSQDQEGRGAFF	1
GACTCGGCCGTGTATGTCTGTGCCAGCAGTGGAACCCAGACTAATCAGCCCCAGCATTTTGGTGAT	CASSGTQTNQPQHF	2
GACTCGGCCGTGTATGTCTGTGCCAGCAGCGGGCGGGTTGGCAGGAACACTGAAGCTTTCTTTGGACAA	CASSGRVGRNTEAFF	6
AACCCAGGGACTCAGCTGTGTATTTTTGTGCCAGCAGTTTGGGACAGGGGGCGTGGGTCCAAGCTTTCTTTGGACAA	CASSLGQGAWVQAFF	6
GAGACACGGCACTGTATCTCTGCGCCAGCAGCCAGGGACTAGCGGAAAACATTCAGTACTTCGGCGCC	CASSQGLAENIQYF	10
GACTCGGCCGTGTATGTCTGTGCCAGCAGCTCGCCATCCGGACAGGGCTACACTGAAGCTTTCTTTGGACAA	CASSSPSGQGYTEAFF	1
CCTCCCAGACATCTGTGTACTTGTGTGCCAGCAGTTACTCATCTGGGTCCTATGGCTACACCTTCGGTTCG	CASSYSSGSYGYTF	2
GACGCAGCCATGTACCTGTGTGCCACCAGCACCCGGGACACCCGTCGATGGCAGTATTTTGGCCCA	CATSTRDTRRWQYF	7
AACCCAGGGACTCAGCTGTGTATTTTTGTGCCAGCACCGAGCGGAGCTGGGAGACCCAGTACTTCGGGCCA	CASTERSWETQYF	1
GAGACACGGCACTGTATCTCTGCGCCAGGAACGATGGCAGCTTTACCTAGTACGAGCAGTACTTCGGGCCG	CARNDGSFT*YEQYF	10
AGCTTGGTGACTCTGCTGTGTATTTCTGTGCCAGCAGCCGTAGCGGGAGCTCCTACGAGCAGTACTTCGGGCCG	CASSRSGSSYEQYF	51
CCTCCCAGACATCTGTGTACTTGTGTGCCAGCAGATCTCAAGGGGGGACAGATACGCAGTATTTTGGCCCA	CASRSQGGTDTQYF	4
CAAAAGAACCCGACAGCTTTCTATCTCTGTGCCAGTACACAAACAAGGGGACTGAAGCTTTCTTTGGACAA		19
CGAGGAGATTCGGCAGCTTATTTCTGTGCCAGCTCGCCGGGGACAGGGGGCGCGGGCTATGGCTACACCTTCGGTTCG	CASSPGTGGAGYGYTF	1
GACTCGGCCGTGTATGTCTGTGCCAGCAGCTTAGCGCGGGGGGCCTACGAGCAGTACTTCGGGCCG	CASSLARGAYEQYF	4
AACCCAGGGACTCAGCTGTGTAYTTYTGTGCCAGCAGTTTAGGCGGGGGGCAAGGCGGGGAGCTGTTTTTTGGAGAA	CASSLGGGQGGELFF	10
GGACTCGGCCCTTTATCTTTGCGCCAGCAGCTTCGACGGGGACTCTGGAAACACCATATATTTTGGAGAG	CASSFDGDSGNTIYF	4
GACTCGGCCGTGTATGTCTGTGCCAGCAGCTTTGGGGTCCCGCGGCAATGAGCAGTTCTTCGGGCCA		40
CCTCCCAGACATCTGTGTACTTGTGTGCCATCACCCAGGATAACACTGTCTATGGCTACACCTTCGGTTCG	CAITQDNTVYGYTF	7
GACTCGGCCGTGTATGTCTGTGCCAGCAGCATAGGACAGGGGTAGGGAGACCCAGTACTTCGGGCCA		1
GGACTCGGCCCTTTATCTTTGCGCCAGCAGCGTCGGGACTCAGAGCAATCAGCCCCAGCATTTTGGTGAT	CASSVGTQSNQPQHF	6
GACTCGGCCGTGTATGTCTGTGCCAGCAGCTTGGACAGGGTTGGGAACATTCAGTACTTCGGCGCC	CASSLDRVGNIQYF	5
GACTCGGCCGTGTATGTCTGTGCCAGCAGACTCGGACAGGGGGTTACAATCAGCCCCAGCATTTTGGTGAT		1
GACTCGGCCGTGTATGTCTGTGCCAGCAGCACCCGGGGGGTGAGACAAGAGACCCAGTACTTCGGGCCA	CASSTRGVRQETQYF	27
CCTCCCAGACATCTGTGTACTTGTGTGCCAGCAGTTACTCGGGACAAGAAAAACTGTTTTTTGGCAGT	CASSYSGQEKLFF	2
MAGAAGACTCAGCYSYGTATCTCTGCGCCAGCAGCCCAGGGGTAGGGAGTTGGACAGATACGCAGTATTTTGGCCCA	CASSPGVGSWTDTQYF	4
AGCTTGGTGACTCTGCTGTGTATTTCTGTGCCAGCAGCCAAGGAGCGGACGGCTCCTACGAGCAGTACTTCGGGCCG	CASSQGADGSYEQYF	40
CAAAAGAACCCGACAGCTTTCTATCTCTGTGCCAGTAGTCCACAGGATCCGGGAGGCTACACCTTCGGTTCG	CASSPQDPGGYTF	6
GACTCGGCCRTGTATSKCTGTGCCAGCAGCTTAGGGCCGGGGGACACTGAAGCTTTTTTTGGACAA	CASSLGPGDTEAFF	4
CCTCCCAGACATCTGTGTACTTGTGTGCCAGCAGTGAAGGGACTAGAGTCGGTGAGCAGTTCTTCGGGCCA	CASSEGTRVGEQFF	5
ASCTCCCAGACATCTGTGTACTTSTGTGCCAGCAGTCTGGGGGGGGTGACTCCTACAATGAGCAGTTCTTCGGGCCA		1
AACCCAGGGACTCAGCTGTGTATTTTTGTGCCAGCACCCAACAGGGTTGGGGCTACACCTTCGGTTCG	CASTQQGWGYTF	6
CACCAACCAGACATCTATGTACCTCTGTGCCAGCAGTCGTGGACAGTTAGGGGAAAAACTGTTTTTTGGCAGT	CASSRGQLGEKLFF	7
GACTCGGCCGTGTATGTCTGTGCCAGCAGCTTGTCACTTAGTCTAAGCACAGATACGCAGTATTTTGGCCCA	CASSLSLSLSTDTQYF	11
CCCTGAAGACAGCAGCATATATCTCTGCAGCGTCGGAACTCCTGAAAACAGGGTAGGGTTCTTTGGACAA	CSVGTPENRVGFF	15
GACTCGGCCGTGTATGTCTGTGCCAGCAGGAAGGATGTAAGATCTGTCGAGCAGTACTTCGGGCCG	CASRKDVRSVEQYF	1
AACCCAGGGACTCAGCTGTGTATTTTTGTGCCAGCAGTCCATCGGGCAGGGTAAATCAGCCCCAGCATTTTGGTGAT	CASSPSGRVNQPQHF	6
CTCCCTCYCAGACWTCTGTKTACTTSTGTGCCAGCAAGGCAGGGGGTGAATCTGGAAACACCATATATTTTGGAGAG	CASKAGGESGNTIYF	8
CAGAACTGGAGGATTCTGGAGTTTATTTCTGTGCCAGCAGCCATATTAGGTATAATTCACCCCTCCACTTTGGGAAC	CASSHIRYNSPLHF	6
TGGGGGACTCAGCTTTGTATTTCTGTGCCAGCAGCGCCAGCGGGAACCAAGAGACCCAGTACTTCGGGCCA	CASSASGNQETQYF	2
GCTCCCAGACATCTGTGTATTTCTGCGCCAGCAGTGATGGACAGGGGCCCAATCAGCCCCAGCATTTTGGTGAT	CASSDGQGPNQPQHF	4
GACTCGGCCGTGTATGTCTGTGCCAGCAGCGCAGAGGACAGGGACAATGAGCAGTTCTTCGGGCCA	CASSAEDRDNEQFF	8
GACTCGGCCGTGTATGTCTGTGCCAGCAGCTGGATAGCGGGGGCACAAGAGACCCAGTACTTCGGGCCA	CASSWIAGAQETQYF	1
GACTCGGCCGTGTATGTCTGTGCCAGCAGCTTCGCGGGACAGGGGGCCGGGGAGCTGTTTTTTGGAGAA	CASSFAGQGAGELFF	10
GACGCAGCCATGTACCTGTGTGCCACCAGCTTAAGAGCGGGAGGGCTAGGCAATGAGCAGTTYTTCGGGCCA	CATSLRAGGLGNEQFF	6
ATCCTGAAGACAGCAGCTTCTACATCTGCAGTGCTAGGGGGGGGAACTATGGCTACACCTTCGGTTCG	CSARGGNYGYTF	1
CAAAAGAACCCGACAGCTTTCTATCTCTGTGCCAGTAGTCCATCTGGGGGTAAACCCTACGAGCAGTACTTCGGGCCG	CASSPSGGKPYEQYF	1
CTCCCTCYCAGACWTCTGTKTACTTSTGTGCCAGCAGGCCCACAGGGGTGAACACTGAAGCTTTCTTTGGACAA	CASRPTGVNTEAFF	1
TTCTCAGTGACTCTGGCTTCTATCTCTGTRCCTGGAGTGTACAGGTCAATGAGCAGTTCTTCGGGCCA	CXWSVQVNEQFF	4
ATCCTGAAGACAGCAGCTTCTACATCTGCAGTGCTAGAGCCTCAGGGGGCGCGGGATCACCCCTCCACTTTGGGAAC	CSARASGGAGSPLHF	13
GCTCCCAGACATCTGTGTATTTCTGCGCCAGCAGTGGAGTGGGAGAGCTGGACGGGGAGCTGTTTTTTGGAGAA	CASSGVGELDGELFF	3
AGGACTCCGCCGTGTATCTCTGTGCCAGCAGCTTAGCAGGGTACACTGAAGCTTTCTTTGGACAA	CASSLAGYTEAFF	1
CCTCCCAGACATCTGTGTACTTGTGTGCCAGCAGTTACGTTCAGGGGTCGGGGCAAGAGACCCAGTACTTCGGGCCA	CASSYVQGSGQETQYF	4
ATCCTGAAGACAGCAGCTTCTACATCTGCAGTGCTAGAGATGGTCGTTAGAGAGGCGCTCAGGGAGCAGTACTTCGGGCCG		3
CAAAAGAACCCGACAGCTTTCTATCTCTGTGCCAGTAGTCCACGGGACCGGGGTGGCTACACCTTCGGTTCG	CASSPRDRGGYTF	1
CTCCCTCTCAGACTTCTGTTTACTTCTGTGCCAGCAGTCGTTCAGGGGCGGGGGCGGTTGGCTACACCTTCGGTTCG	CASSRSGAGAVGYTF	2
CCCAACCAGACAGCTCTTTACTTCTGTGCCAGCCCAACTTGGTGAATGAAAAACTGTTTTTTGGCAGT		10
CCCAACCAGACAGCTCTTTACTTCTGTGCCACCAGTGATTTGCTGGGGGAGCAGTACTTCGGGCCG	CATSDLLGEQYF	1
GGACTCGGCCCTTTATCTTTGCGCCGGATGCACTTGTCCCTATCCTACGAGCAGTACTTCGGGCCG		1
TYCTCAGTGACTCTGGCTTCTATCTCTGTGCCTGGAGTGTACAGGGAGGGGGTACCGGGGAGCTGTTTTTTGGAGAA	CAWSVQGGGTGELFF	1
GACTCGGCCGTGTATGTCTGTGCCAGCAGCCACCGGGACAGTTATGGCTATGGCTACACCTTCGGTTCG	CASSHRDSYGYGYTF	1
ATCCTGAAGACAGCAGCTTCTACATCTGCAGTGCTAGTCCATACTAGCGGGAGAGTCCTACGAGCAGTACTTCGGGCCG		5
GACTCGGCCGTGTATGTCTGTGCCAGCAGCTCCACCCATAGCTCCTACGAGCAGTACTTCGGGCCG	CASSSTHSSYEQYF	2
CAGAAGACTCAGCCCTGTATCTCTGCGCCAGCAGCGACCGACTAGCGGCGGGGAATGAGCAGTTCTTCGGGCCA	CASSDRLAAGNEQFF	2
GACGCAGCCATGTACCTGTGTGCCACCAGCAGAGATTAAAGCGGGAGTTCCTACAAGCAGTACTTCGGGCCG	CATSRD*SGSSYKQYF	14
GACTCGGCCGTGTATGTCTGTGCCAGCAGTATGATGACAGGGGTATTACTTCCCAACGTCCTGACTTTCGGGGCC	CASSMMTGVLLPNVLTF	2
GAGACACGGCACTGTATCTCTGCGCCAGCAGCCAAGATCCCGGGACTAGCGGGAGGTACAATGAGCAGTTCTTCGGGCCA	CASSQDPGTSGRYNEQFF	3
GACTCGGCCGTGTATGTCTGTGCCAGCAGCCCTGGGGCCAGGAACACCGGGGAGCTGTTTTTTGGAGAA	CASSPGARNTGELFF	1
CCCAACCAGACAGCTCTTTACTTCTGTGCCACCAGTGAAGCGATAGCGGGACGGGGAGAGACCCAGTACTTCGGGCCA	CATSEAIAGRGETQYF	1
TGGGGGACTCAGCTTTGTATTTCTGTGCCAGCAGCTCGGAAGTCAGGACCGGGGAGCTGTTTTTTGGAGAA	CASSSEVRTGELFF	11
GCTCCCAGACATCTGTGTATTTCTGCGCCAGCAGTGGGACAGGGGAGTATGGCTACACCTTCGGTTCG	CASSGTGEYGYTF	7
CCCAACCAGACAGCTCTTTACTTCTGTGCCACCAGTGAGGGGTACGGTCGGGAAAAACTGTTTTTTGGCAGT	CATSEGYGREKLFF	14
GACTCGGCCGTGTATGTCTGTGCCAGCAGCCCCCCAAATAGCGGGGACAGGAATGAGCAGTTCTTCGGGCCA	CASSPPNSGDRNEQFF	10
TGGGGGACTCAGCTTTGTATTTCTGTGCCAGCAGTCACTACGGAACCAACTACAATGAGCAGTTCTTCGGGCCA	CASSHYGTNYNEQFF	1
GACTCGGCCGTGTATGTCTGTGCCAGCAGCATACCTTTCCGTGGCTCACCCCTCCACTTTGGGAAC	CASSIPFRGSPLHF	1
GACGCAGCCATGTACCTGTGTGCCACCAGTCCCGATGCAGGGGGGAGGACCGAGCAGTACTTCGGGCCG	CATSPDAGGRTEQYF	5
CCTCCCAGACATCTGTGTACTTGTGTGCCAGCAGTTGGACAGGGGGTATGGCTACACCTTCGGTTCG		1
AAGAAGACTCAGCTGCGTATCTCTGCACCAGCAGCCAAGAAAGGCGGGGGGCTCCTACAATGAGCAGTTCTTCGGGCCA		9
TGGGGGACTCAGCTTTGTATTTCTGTGCCAGCAGCGAAAGCGGGACTGATACGCAGTATTTTGGCCCA	CASSESGTDTQYF	7
CTCCCTCYCAGACWTCTGTKTACTTSTGTGCCAGCAGGCGGTACTTCTCTGGAAACACCATATATTTTGGAGAG	CASRRYFSGNTIYF	9
GGACTCGGCCCTCTATCTCTGTGCCAGCAGCCCTAGCGGAGATTTACAATGAGCAGTTCTTCGGGCCA		1
CAAAAGAACCCGACAGCTTTCTATCTCTGTGCCAGTAGTATGGCGGGGGGGGGCACTGAAGCTTTCTTTGGACAA	CASSMAGGGTEAFF	7
CAGAACTGGAGGATTCTGGAGTTTATTTCTGTGCCAGCAGCCGTCTAGGGACTAGGGACGAGCAGTACTTCGGGCCG	CASSRLGTRDEQYF	5
CACCAACCAGACATCTATGTACCTCTGTGCCACCGACGAGGCGTTTCAAGAGACCCAGTACTTCGGGCCA	CATDEAFQETQYF	3
CAAAAGAACCCGACAGCTTTCTATCTCTGTGCCAGTAGCGACCCTGGGGGGGCAGACCAACGATCGCATGGCTACACCTTCGGTTCG	CASSDPGGADQRSHGYTF	4
GACTCGGCCGTGTATGTCTGTGCCAGCAGCTTAGTCGCGGGCGCCGGAGATACGCAGTATTTTGGCCCA	CASSLVAGAGDTQYF	5
GGACTCGGCCSTSTATSTCTGTGCCAGCAGCTCCACCGCCGGGCCTTATAGCAATCAGCCCCAGCATTTTGGTGAT	CASSSTAGPYSNQPQHF	1
CGAGGAGATTCGGCAGCTTATTTCTGTGCCAGCTCACCAGGGACAGGGCGTCAGCCCCAGCATTTTGGTGAT	CASSPGTGRQPQHF	4
CCTCCCAGACATCTGTGTACTTGTGTGCCAGCAGTTACTCGGGACAGATCCAAGAGACCCAGTACTTCGGGCCA	CASSYSGQIQETQYF	7
AGCTTGGTGACTCTGCTGTGTATTTCTGTGCCAGCAGCCAAGACTCGGGGCGTCAAGAGACCCAGTACTTCGGGCCA	CASSQDSGRQETQYF	5
TGYWCCCTCTCAGACWTCTGTKTACTTCTGTGCCAGCAGTGAAAGGATGAAAAACTGTTTTTTGGCAGT		9
GAGACACGGCACTGTATCTCTGCGCCAGCAGCACCCCGGGGGGCCGGGAGCAGTTCTTCGGGCCA	CASSTPGGREQFF	6
TGGGGGACTCAGCTTTGTATTTCTGTGCCAGCAGTGAAACGAGGGACAGGGGGCGCTTCGGGCCA	CASSETRDRGRF	5
GACTCGGCCGTGTATGTCTGTGCCAGCAGCTCCAACAGGGGGGTAGGAACTAATGAAAAACTGTTTTTTGGCAGT	CASSSNRGVGTNEKLFF	5
GAGGGACTCAGCCGTGTATCTCTACGCCAGCAGCCAAGAAGGAGGTAGTGGCTACACCTTCGGTTCG	YASSQEGGSGYTF	47
CAAAAGAACCCGACAGCTTTCTATCTCTGTGCCAGTACCTCGACCCTCCGGGACAGGGTGTTGAGGGAGCTGTTTTTTGGAGAA	CASTSTLRDRVLRELFF	1
GACTCGGCCGTGTATGTCTGTGCCAGCAGACCAACAGCGGGCGCGAACACCGGGGAGCTGTTTTTTGGAGAA	CASRPTAGANTGELFF	11
AACCCAGGGACTCAGCTGTGTATTTTTGTGCCAGCAGTTTACGCGGAGTCTCTGGAAACACCATATATTTTGGAGAG	CASSLRGVSGNTIYF	1
GACTCGGCCGTGTATGTCTGTGCCAGCAGCTTAGAGGTCGCGGCGAAGGGAGATACGCAGTATTTTGGCCCA	CASSLEVAAKGDTQYF	1
AGCTTGGTGACTCTGCTGTGTATTTCTGTGCCAGCAGGGATAGCGGGGGGGAACCCGAGCAGTACTTCGGGCCG	CASRDSGGEPEQYF	5
CAAAAGAACCCGACAGCTTTCTATCTCTGTGCCAGTAAATACAGGGGGTATTTAGACACTGAAGCTTTCTTTGGACAA	CASKYRGYLDTEAFF	1
AACCCAGGGACTCAGCTGTGTATTTTTGTGCCAGCAAGATTGAGGGCACAGATACGCAGTATTTTGGCCCA	CASKIEGTDTQYF	3
CCTCCCAGACATCTGTGTACTTGTGTGCCAGCAGTTACTCGTTAGGGGAAGGTCAGCCCCAGCATTTTGGTGAT	CASSYSLGEGQPQHF	4
CCCAACCAGACAGCTCTTTACTTCTGTGCCAGCAGTCTCTATAGCAATCAGCCCCAGCATTTTGGTGAT	CASSLYSNQPQHF	6
CCCTGAAGACAGCAGCATATATCTCTGCAGCGTTGAAGACGGTACTGGGGGGACGACTACGAGCAGTACTTCGGGCCG		1
GCTCCCAGACATCTGTGTATTTCTGCGCCAGCAGTGGCCCGGGGGTCGGTGGCTACACCTTCGGTTCG	CASSGPGVGGYTF	1
CCTCCCAGACATCTGTGTACTTGTGTGCCAGCAGCCCTACAGGGAACTATGGCTACACCTTCGGTTCG	CASSPTGNYGYTF	1
GGACTCRGCCRTGTATSKCTGTGCCAGCAGCTCGGGGACAGGGCCCGGGGAGCTGTTTTTTGGAGAA	CASSSGTGPGELFF	4
GACTCGGCCGTGTATGTCTGTGCCAGCAGCTTAATCGACAGCACAGATACGCAGTATTTTGGCCCA	CASSLIDSTDTQYF	5
CAAAAGAACCCGACAGCTTTCTATCTCTGTGCCAGTAGTGTTCGATCGACAGATACGCAGTATTTTGGCCCA	CASSVRSTDTQYF	1
TGGGGGACTCAGCTTTGTATTTCTGTGCCAGCAGTGAAGCTGGGTATTAGCCCCAGCATTTTGGTGAT	CASSEAGY*PQHF	6
ATCCTGAAGACAGCAGCTTCTACATCTGCAGTGCCGGGAGCCAGATGAATTCACCCCTCCACTTTGGGAAC	CSAGSQMNSPLHF	1
AACCCAGGGACTCAGCTGTGTATTTTTGTGCCAGCAGCGGCGTTGCCGGGGCCAACGTCCTGACTTTCGGGGCC	CASSGVAGANVLTF	11
CAGAAGACTCAGCCCTGTATCTCTGCGCCAGCAGCCAATCCATTCAGGGTACTAATGAAAAACTGTTTTTTGGCAGT	CASSQSIQGTNEKLFF	1
CAAAAGAACCCGACAGCTTTCTATCTCTGTGCCAGTAGTACCGGACACGGTTCTGGGGTAGCCAAAAACATTCAGTACTTCGGCGCC	CASSTGHGSGVAKNIQYF	1
GACTCGGCCGTGTATSTCTGTGCCAGCAGCTTAGGGCTGATTAACACCGGGGAGCTGTTTTTTGGAGAA	CASSLGLINTGELFF	2
GACTCGGCCRTGTATSKCTGTGCCAGCAGCTTGTCCCTAGCGGCAGATACGCAGTATTTTGGCCCA	CASSLSLAADTQYF	6
TGGGGGACTCAGCTTTGTATTTCTGTGCCACCCCCAGGGGCTGAACACTGAAGCTTTCTTTGGACAA		1
CCCAACCAGACAGCTCTTTACTTCTGTGCCACCAGTACACTAGCGGGAGGTAACAATGAGCAGTTCTTCGGGCCA	CATSTLAGGNNEQFF	6
TCTATGTACCTCTGTGCCAGCAGTTTACTCCAAATCGTTACGACAGGGGGGTTGACACCGGGGAGCTGTTTTTTGGAGAA		1
CGAGGAGATTCGGCAGCTTATTTCTGTGCCAGCTCACCGGGGCGGGGTTACGAGCAGTACTTCGGGCCG	CASSPGRGYEQYF	1
CCTCCCAGACATCTGTGTACTTGTGTGCCATCACTCGTCTGGACTAGCGGGGGCCTACGAGCAGTACTTCGGGCCG		5
CTCCCTCTCAGACTTCTGTTTACTTCTGTGCCAGCACCCGACAGGCTATAATGAAAAACTGTTTTTTGGCAGT		1
CAAAAGAACCCGACAGCTTTCTATCTCTGTGCCAGCATAGGACTTTCCCCCACAGATACGCAGTATTTTGGCCCA	CASIGLSPTDTQYF	1
CCTCCCAGACATCTGTGTACTTGTGTGCCAGCATCAGGGGGCTGCGCACCGGGGAGCTGTTTTTTGGAGAA	CASIRGLRTGELFF	5
CCCTGAAGACAGCAGCATATATCTCTGCAGCGTTGAAGAGGTGACGGGACAGGAAAAACTGTTTTTTGGCAGT	CSVEEVTGQEKLFF	9
AACCCAGGGACTCAGCTGTGTATTTTTGTGCCAGCAGATTCAGGGGCTACGAGCAGTACTTCGGGCCG	CASRFRGYEQYF	39
AACCCAGGGACTCAGCTGTGTATTTTTGTGCCAGCAGCCAGTGCAGTCCAAAACGGGGAGCTGTTTTTTGGAGAA		1
AGCTTGGTGACTCTGCTGTGTATTTCTGTGCCAGCAGACGAAAGGGGGTCAGGGCTACACCTTCGGTTCG		12
CAGGAGACACAGCACGGTATTTCTGTGCCAGCAGCTTCCCCAGATGTTTGGGGGAGGGGCTCCTACAATGAGCAGTTCTTCGGGCCA		3
ATCCTGAAGACAGCAGCTTCTACATCTGCAGTGCTAGACCACCCCAGGGGCGGGGAACCGGGGAGCTGTTTTTTGGAGAA	CSARPPQGRGTGELFF	2
ASCTCCCAGACATCTGTGTACTTSTGTGCCATCAGTGAGGTTAATCAGCCCCAGCATTTTGGTGAT	CAISEVNQPQHF	27
GACTCGGCCGTGTATGTCTGTGCCAGCAGCTTAGATCTGACGCGGGAAGAGACCCAGTACTTCGGGCCA	CASSLDLTREETQYF	1
TTGGTGACTCTGCTGTGTATTTCTGTGCCAGCAGCCAAGATCGTTCCGGATCTAGCCTCTGGGGCCAACGTCCTGACTTTCGGGGCC		1
GACTCGGCCGTGTATGTCTGTGCCAGCAGCTTGGGAGGGATACAGAAGATGAACACTGAAGCTTTCTTTGGACAA	CASSLGGIQKMNTEAFF	5
GACTCGGCCGTGTATGTCTGTGCCAGCAGCTTAGTTATAGCGGATCCCTATACGAGCAGTACTTCGGGCCG		7
GCTCCCAGACATCTGTGTATTTCTGCGCCAGCAGTGAGTTCCGGGGGGATGGCGAGCAGTACTTCGGGCCG	CASSEFRGDGEQYF	2
CCTCCCAGACATCTGTGTACTTGTGTGCCAGCAGACGAGGATACAGTTCCTACGAGCAGTACTTCGGGCCG	CASRRGYSSYEQYF	1
TTCTCAGTGACTCTGGCTTCTATCTCTGTGCCTGGACCCGGGGAGGGGTTGCCTATGGCTACACCTTCGGTTCG	CAWTRGGVAYGYTF	6
GGGGGACTCRGCYGTGTATCTCTGTGCCAGCAGCTTAGGCCAGGGGCAGGGCTACACCTTCGGTTCG	CASSLGQGQGYTF	3
CCTCCCAGACATCTGTGTACTTGTGTGCCATCAGAGACTTCGACAGGGCACGGGCTGAAGCTTTCTTTGGACAA	CAIRDFDRARAEAFF	1
AACCCAGGGACTCAGCTGTGTATTTTTGTGCCAGCAGTCCCCGTGGAACCGGGGAGCTGTTTTTTGGAGAA	CASSPRGTGELFF	22
CAAAAGAACCCGACAGCTTTCTATCTCTGTGCCAGTAGCGGGACTAGCGGGCCCTGAGCTCCTACAATGAGCAGTTCTTCGGGCCA		1
TGGGGGACTCAGCTTTGTATTTCTGTGCCAGCAGTTTTGACTCCACTGGTTTGCACGAGCAGTACTTCGGGCCG	CASSFDSTGLHEQYF	8
AACCCAGGGACTCAGCTGTGTATTTTTGTGCTAGTGGTTTGGCCTCAGATACTAGCGGACAATGAGCAGTTCTTCGGGCCA		4
CCCAACCAGACAGCTCTTTACTTCTGTGCCAGCAGTCCCCGGGACCCGCGGCCGATGAGCAGTTCTTCGGGCCA		1
CACCAACCAGACATCTATGTACCTCTGTGCCAGCAGAGAGTTCGGGACTAGCGGAGACAATGAGCAGTTCTTCGGGCCA	CASREFGTSGDNEQFF	5
GACTCGGCCGTGTATGTCTGTGCCAGCAGCTCGACTAGCGGGGGCGAACCTACGAGCAGTACTTCGGGCCG		9
GACTCGGCCGTGTATGTCTGTGCCAGCAGCTTATAGCGGGGGGATACAATGAGCAGTTCTTCGGGCCA		2
CRRRRGACTCAGCCSTGTATCTCTRCGCCAGCAGCCATCCTGTGTTCGGGGGAAGCACTGAAGCTTTCTTTGGACAA	XASSHPVFGGSTEAFF	4
CCTCACATACCTCTCAGTACCTCTGTGCCAGCAGTGTCACAGGGGGCTTTGGCTACACCTTCGGTTCG	CASSVTGGFGYTF	6
ATCCTGAAGACAGCAGCTTCTACATCTGCAGTGCTGGTGGGACTAGCGCTAGCACAGATACGCAGTATTTTGGCCCA	CSAGGTSASTDTQYF	4
CCTCCCAGACATCTGTGTACTTGTGTGCCAGCAGTTACCGTCAGAACACTGAAGCTTTCTTTGGACAA	CASSYRQNTEAFF	1
CAAAAGAACCCGACAGCTTTCTATCTCTGTGCCAGTAGTGCTCAGTTTTTCTATGGCTACACCTTCGGTTCG	CASSAQFFYGYTF	7
MAGAAGACTCAGCYSYGTATCTCTGCGCCAGCAGCCAAGAGGCCGGGGGAGCTTTCTTTGGACAA	CASSQEAGGAFF	3
AACCCAGGGACTCAGCTGTGTATTTTTGTGCCAGCAGTCCCTCCCACGGGACGAGAAACACCGGGGAGCTGTTTTTTGGAGAA	CASSPSHGTRNTGELFF	1
CGAGGAGATTCGGCAGCTTATTTCTGTGCCAGCTCACCACCGGGCGGGCTTGGCGAGCAGTACTTCGGGCCG	CASSPPGGLGEQYF	6
CAGAACTGGAGGATTCTGGAGTTTATTTCTGTGCCAGCAGCCAAAGAGCTACGAGCAGTACTTCGGGCCG		1
GACTCGGCCGTGTATGTCTGTGCCAGCAGTTATACAGAGGGAGACTACGAGCAGTACTTCGGGCCG	CASSYTEGDYEQYF	3
AACCCAGGGACTCAGCTGTGTATTTTTGTGCCAGCAGTGCGGGGGGTCCGATCAGTGATGGCTACACCTTCGGTTCG	CASSAGGPISDGYTF	2
CAAAAGAACCCGACAGCTTTCTATCTCTGTGCCAGTAGTATAAGAGGGGGAATAGGAAATGAGCAGTTCTTCGGGCCA	CASSIRGGIGNEQFF	8
CACCAACCAGACATCTATGTACCTCTGTGCCAGCAGTTTTCCCCGTACTGGGGGTCAGCCCCAGCATTTTGGTGAT	CASSFPRTGGQPQHF	40
AGCTTGGTGACTCTGCTGTGTATTTCTGTGCCAGCAGCCAGGACCTAAACATTCAGTACTTCGGCGCC	CASSQDLNIQYF	8
CACCAACCAGACATCTATGTACCTCTGTGCCAGCAGTTCCGGACAGGGGGGTTACAATGAGCAGTTCTTCGGGCCA	CASSSGQGGYNEQFF	1
AACCCAGGGACTCAGCTGTGTATTTTTGTGCCAGCAGTTTAGGACAGGAAAACACTGAAGCTTTCTTTGGACAA	CASSLGQENTEAFF	2
ATCCTGAAGACAGCAGCTTCTACATCTGCAGTGCTAGAAGAAGTAGCGGGAGCTCCTACAATGAGCAGTTCTTCGGGCCA	CSARRSSGSSYNEQFF	3
CACCAACCAGACATCTATGTACCTCTGTGCCAGCAAACCTCACGTGAGGGGTGATGGCTACATCTTCGGTTCG	CASKPHVRGDGYIF	10
CAAAAGAACCCGACAGCTTTCTATCTCTGTGCCAGTAGTCAGGGAAGAAGCCATGAGCAGTTCTTCGGGCCA	CASSQGRSHEQFF	14
TGGGGGACTCAGCTTTGTATTTCTGTGCCAGCAGGTTACAGACCTACGAGCAGTACTTCGGGCCG	CASRLQTYEQYF	5
GACTCGGCCGTGTATGTCTGTGCCAGCAGTCGAGAGCGATTACGTTGGGGGCAAGATGAAGCTTTCTTTGGACAA	CASSRERLRWGQDEAFF	1
CAAAAGAACCCGACAGCTTTCTATCTCTGTGCCAGTAGTAGGTCTTACCAAGAGACCCAGTACTTCGGGCCA	CASSRSYQETQYF	2
TSRGGGACTCAGCTKTGTAYTTCTGTGCCAGCAGTCCGACTAGCGGGGGTGCAGATACGCAGTATTTTGGCCCA	CASSPTSGGADTQYF	3
TGGRGGACTCAGCYWTGTAYTTCTGTGCCAGCAGTGAAAATACAGGGAATCAGCCCCAGCATTTTGGTGAT	CASSENTGNQPQHF	18
GACTCGGCCGTGTATGTCTGTGCCAGCAGCTTAGGTTACGCGGGATCGAACACCGGGGAGCTGTTTTTTGGAGAA	CASSLGYAGSNTGELFF	6
CCTCACATACCTCTCAGTACCTCTGTGCCAGCGAGGCGGGTAATTCTGGTCAGCCCCAGCATTTTGGTGAT	CASEAGNSGQPQHF	5
AGCTTGGTGACTCTGCTGTGTATTTCTGTGCCAGCAGCCAGACGGGGATAGCCAAAAACATTCAGTACTTCGGCGCC	CASSQTGIAKNIQYF	16
CCTCCCAGACATCTGTGTACTTGTGTGCCAGCAGGCTAGGACAGGGCCCACACTATGGCTACACCTTCGGTTCG	CASRLGQGPHYGYTF	1
CAAAAGAACCCGACAGCTTTCTATCTCTGTGCCAGTAGTTCTAGATCTGGAGAGACCCAGTACTTCGGGCCA	CASSSRSGETQYF	23
CCCAACCAGACAGCTCTTTACTTCTGTGCCACCAGTGATTCTTGGAGCTTATAATTCACCCCTCCACTTTGGGAAC		1
TGGGGGACTCAGCTTTGTATTTCTGTGCCAGCAGCGTAGATACAGGGGCTTCCTACGAGCAGTACTTCGGGCCG	CASSVDTGASYEQYF	1
GCTCCCAGACATCTGTGTATTTCTGCGCCACCCGGACGGATACGAACACCGGGGAGCTGTTTTTTGGAGAA	CATRTDTNTGELFF	3
GACTCGGCCGTGTATGTCTGTGCCAGCAGCCCTGAAACAGGGAGGAGAGAGACCCAGTACTTCGGGCCA	CASSPETGRRETQYF	7
CCTCCCAGACATCTGTGTACTTGTGTGCCAGCAGGTCGCCTTCCTACGAGCAGTACTTCGGGCCG	CASRSPSYEQYF	3
CACCAACCAGACATCTATGTACCTCTGTGCCAGCAGTTTAATAGGAGCGGGAGGCCTCTACGAGCAGTACTTCGGGCCG	CASSLIGAGGLYEQYF	3
GACTCGGCCGTGTATGTCTGTGCCAGCAGCTTAGGGGACAGGCCCCACACTGAAGCTTTCTTTGGACAA	CASSLGDRPHTEAFF	17
CAAAAGAACCCGACAGCTTTCTATCTCTGTGCCAGTAGTATAGATCTGAGGGTGAACATTCAGTACTTCGGCGCC	CASSIDLRVNIQYF	1
CAAAAGAACCCGACAGCTTTCTATCTCTGTGCCAGTATTCACCCGAAGGGAGGACATCCCCTCGGGAGCAGTACTTCGGGCCG		1
GACGCAGCCATGTACCTGTGTGCCACCAGTATATTCGGTGGTAGCGGGAGCTCTACTGAGCAGTTCTTCGGGCCA	CATSIFGGSGSSTEQFF	2
AGCTTGGTGACTCTGCTGTGTATTTCTGTGCCAGCAGCCTACCTCACCCGAACACTGAAGCTTTCTTTGGACAA	CASSLPHPNTEAFF	8
CCTCCCAGACATCTGTGTACTTGTGTGCCAGTAGTTACGCGAGACTTAGAGCTTTCTTTGGACAA	CASSYARLRAFF	1
ATCCTGAAGACAGCAGCTTCTACATCTGCAGTGCTAGAGATCTAGGACAGAATAATTCACCCCTCCACTTTGGGAAC	CSARDLGQNNSPLHF	1
CCAACCAGACATCTATGTACCTCTGTGCCAGCAGTCTCTCCCTTCCTCTAGCGGGAGGGCCGATACAATGAGCAGTTCTTCGGGCCA		2
AAYCMRGRGACWCAGCWSKGTATTTYTGTGCCAGCAGTTTGCAGGGGGCCCGGGACACCATATATTTTGGAGAG	CASSLQGARDTIYF	6
CCCAACCAGACAGCTCTTTACTTCTGTGCCAGCAGTTTAGTGCACGGCCAGCCCCAGCATTTTGGTGAT	CASSLVHGQPQHF	1
CCTCCCAGACATCTGTGTACTTGTGTGCCAGCAGCTACAGGGGGAACACTGAAGCTTTCTTTGGACAA	CASSYRGNTEAFF	19
AACCCAGGGACTCAGCTGTGTATTTTTGTGCCAGCAGTTTCCACACTGAAGCTTTCTTTGGACAA	CASSFHTEAFF	4
CAAAAGAACCCGACAGCTTTCTATCTCTGTGCCAGTAGTATAGATGGACTAGCGGGGGCCAGTGGCTACGAGCAGTACTTCGGGCCG	CASSIDGLAGASGYEQYF	7
CCTCCCAGACATCTGTGTACTTGTGTGCCAGCAGCCCCCTTACGGGCTTTGGTCAGCCCCAGCATTTTGGTGAT	CASSPLTGFGQPQHF	1
GACTCGGCCGTGTATGTCTGTGCCAGCAGCTTAACTTTACAGGGTCCGTCTACAATGAGCAGTTCTTCGGGCCA		6
ATCCTGAAGACAGCAGCTTCTACATCTGCAGTGCTAGAGCGGGGGGTTTTAGAGATACGCAGTATTTTGGCCCA	CSARAGGFRDTQYF	4
GACTCGGCCGTGTATGTCTGTGCCAGCAGCTTCACCCGAGCCAGCCGGGACATTACCTACGAGCAGTACTTCGGGCCG	CASSFTRASRDITYEQYF	2
AACCCAGGGACTCAGCTGTGTATTTTTGTGCTAGTGGTCTCGGACAGGGCCATGAGCAGTTCTTCGGGCCA	CASGLGQGHEQFF	8
ACGTTTGGTGCCAGCCAGACCTCTGTACCTCTGTGCCATCAATGTTCGGGGGGGAGATCTGGGGCCAACGTCCTGACTTTCGGGGCC		3
AACCCAGGGACTCAGCTGTGTATTTTTGTGCTAGTGGTTATGAGGGTCAGCCCCAGCATTTTGGTGAT	CASGYEGQPQHF	17
CCCTGAAGACAGCAGCATATATCTCTGCAGCGCCCGAGGGGGGTCTGAGACTGAAGCTTTCTTTGGACAA	CSARGGSETEAFF	6
ACTCGGCCSTGTATSTCTGTGCCAGCAGCTTAGACCCTCTAGGGAATGTCCGGGAGGGCCGCCGGAGATACGCAGTATTTTGGCCCA		3
GACTCGGCCGTGTATGTCTGTGCCAGCAGCTTCGAGGCTGGGTCGGACGTCCTGACTTTCGGGGCC	CASSFEAGSDVLTF	2
ATCCTGAAGACAGCAGCTTCTACATCTGCAGTGCTACTGTGACGTCAACGAACACTGAAGCTTTCTTTGGACAA	CSATVTSTNTEAFF	4
GACTCGGCCGTGTATGTCTGTGCCAGCAGTTTTTGGTTTTGGGGCTCGGAGATACGCAGTATTTTGGCCCA		1
AGCTTGGTGACTCTGCTGTGTATTTCTGTGCCAGCAGCCCTGGGACAGCCTATGGCTACACCTTCGGTTCG	CASSPGTAYGYTF	5
CCTCCCAGACATCTGTGTACTTGTGTGCCAGCAGTCCCGGGGAGGATACCGGGGAGCTGTTTTTTGGAGAA	CASSPGEDTGELFF	2
CAAAAGAACCCGACAGCTTTCTATCTCTGTGCCAGTAGTATTCAGGTTTGGGGACAGGGCACCCAAGAGACCCAGTACTTCGGGCCA	CASSIQVWGQGTQETQYF	1
GACTCGGCCGTGTATGTCTGTGCCAGCAGCTCCACCACGGGTGGCCACGAGCAGTACTTCGGGCCG	CASSSTTGGHEQYF	4
GACTCGGCCGTGTATGTCTGTGCAAGTCGCCCCGGGATCGGGGCGGGGAGCTGTTTTTTGGAGAA		6
TSRGGGACTCAGCTKTGTAYTTCTGTGCCAGCAGTCCAGGGGACTCCTACGAGCAGTACTTCGGGCCG	CASSPGDSYEQYF	8
ATCCTGAAGACAGCAGCTTCTACATCTGCAGTGCTAGAGGCGGGGGCACTGAAGCTTTCTTTGGACAA	CSARGGGTEAFF	5
CGAGGAGATTCGGCAGCTTATTTCTGTGCCAGCTCACCCATACGACAGGCAGCAACTAATGAAAAACTGTTTTTTGGCAGT	CASSPIRQAATNEKLFF	10
CCCAACCAGACAGCTCTTTACTTCTGTGCCACCAGTGATAGGCGATACAGCACAGATACGCAGTATTTTGGCCCA	CATSDRRYSTDTQYF	2
GACTCGGCCRTGTATSKCTGTGCCAGCAGGCTTCAAGGAGGGTTAGCGGGACGCACAGATACGCAGTATTTTGGCCCA	CASRLQGGLAGRTDTQYF	1
CGACTCGGCTGTGTATCTCTGTGCCAGCAGGCGGAGGGACTAGCGGCTCAATGAGCAGTTCTTCGGGCCA	CASRRRD*RLNEQFF	9
GACTCGGCCGTGTATGTCTGTGCCAGCAGCTCCAATTCTTTAGGGCGAGCTAACTATGGCTACACCTTCGGTTCG	CASSSNSLGRANYGYTF	5
CCCAACCAGACAGCTCTTTACTTCTGTGCCAGAGACCCCCGGGGCCCACAATGAGCAGTTCTTCGGGCCA		3
GACTCGGCCGTGTATGTCTGTGCCAGCAGCTTGGCGGGGGGCTTTTCACCCCTCCACTTTGGGAAC	CASSLAGGFSPLHF	1
AAAGAACCCGACAGCTTTCTATCTCTGTGCCAGTAGTCCCTGACTAGCGGGAGGGCCTAGAACACCGGGGAGCTGTTTTTTGGAGAA		6
CCTCCCAGACATCTGTGTACTTGTGTGCCAGCAGTTATGGGGCTAGCGGGAGGGCCGCCTACGAGCAGTACTTCGGGCCG	CASSYGASGRAAYEQYF	8
ATCCTGAAGACAGCAGCTTCTACATCTGCAGTGCTAGAGATCTGGACGGATCTAACTATGGCTACACCTTCGGTTCG	CSARDLDGSNYGYTF	5
AACYSRGGGACTCAGCTKTGTATTTYTGTGCCAGCAGCCGGTGGGACCGGCTGGGGGGCTACACCTTCGGTTCG	CASSRWDRLGGYTF	9
CAGAACTGGAGGATTCTGGAGTTTATTTCTGTGCCAGCAGCCAAGACAGGGGAGGCTGATCAGCCCCAGCATTTTGGTGAT		5
CCTCCCAGACATCTGTGTACTTGTGTGCCAGCAGCTGGGGACAGGGATATCGACGGGGCTACACCTTCGGTTCG	CASSWGQGYRRGYTF	1
CAAAAGAACCCGACAGCTTTCTATCTCTGTGCCAGTAGTAAAGAGCTATACACTGAAGCTTTCTTTGGACAA	CASSKELYTEAFF	3
GACTCGGCCGTGTATGTCTGTGCCAGCAGCAGTCGGGACTTTGACAATGAGCAGTTCTTCGGGCCA	CASSSRDFDNEQFF	18
CCTCCCAGACATCTGTGTACTTGTGTGCCAGCAAAACCTCCCGACAGTCGCTCACAGAGACCCAGTACTTCGGGCCA	CASKTSRQSLTETQYF	2
AGCTTGGTGACTCTGCTGTGTATTTCTGTGCCAGCAGCCAAGAGGGACAGAACACTGAAGCTTTCTTTGGACAA	CASSQEGQNTEAFF	47
GCTCCCAGACATCTGTGTATTTCTGCGCCAGCATGAGGGTTTCCTCACCCCTCCACTTTGGGAAC	CASMRVSSPLHF	2
GACTCGGCCGTGTATGTCTGTGCCAGCAGCAAGTTCAATATTTATGAAAAACTGTTTTTTGGCAGT	CASSKFNIYEKLFF	7
GGACTCGGCCCTTTATCTTTGCGCCAGCAGCTTGGGAGGGACTACTAACACCGGGGAGCTGTTTTTTGGAGAA	CASSLGGTTNTGELFF	1
GACTCGGCCGTGTATGTCTGTGCCAGCAGCTTGGCACATATGAACACTGAAGCTTTCTTTGGACAA	CASSLAHMNTEAFF	1
CCCAACCAGACAGCTCTTTACTTCTGTGCCACCAGTGCCGCGACAGGGGGCACTGAAGCTTTCTTTGGACAA	CATSAATGGTEAFF	1
AGCTTGGTGACTCTGCTGTGTATTTCTGTGCCAGCAGCCCTCGAGTGAGGGGCACTAATGAAAAACTGTTTTTTGGCAGT	CASSPRVRGTNEKLFF	49
TGGGGGACTCAGCTTTGTATTTCTGTGCCAGCAGCGGATCGGACAGGGGGATCAGCCCCAGCATTTTGGTGAT		4
GACTCGGCCGTGTATGTCTGTGCCAGCAGCTTAGTGCATAGCGGGGGTTACAATGAGCAGTTCTTCGGGCCA	CASSLVHSGGYNEQFF	1
CCTCCCAGACATCTGTGTACTTGTGTGCCATCAGTGAACAGGAGACCAATTCACCCCTCCACTTTGGGAAC	CAISEQETNSPLHF	1
CGAGGAGATTCGGCAGCTTATTTCTGTGCCAGCTCACCAAGTGCATTAGGCCTCTACACCTTCGGTTCG	CASSPSALGLYTF	3
CCTCCCAGACATCTGTGTACTTGTGTGCCAGCAGTTCAACTCACAGATACGCAGTATTTTGGCCCA		1
GCTCCCAGACATCTGTGTATTTCTGCGCCAGCAGTGAGAATCTGGGGTTCGGTTCACCCCTCCACTTTGGGAAC	CASSENLGFGSPLHF	4
CCCTGAAGACAGCAGCATATATCTCTGCAGCGTTGAAGGGGCAGGGGGGACCGCCTACGAGCAGTACTTCGGGCCG	CSVEGAGGTAYEQYF	25
CCCTGAAGACAGCAGCATATATCTCTGCAGCGCTGTCTTAGGGGACGGCACAGATACGCAGTATTTTGGCCCA	CSAVLGDGTDTQYF	37
CRRRRGACTCAGCCSTGTATCTCTRCGCCAGCAGCCCGGGACAGGCAGATACGCAGTATTTTGGCCCA	XASSPGQADTQYF	8
GACTCGGCCGTGTATGTCTGTGCCAGCAGCCGGGACAGGGGGCGTAATTCACCCCTCCACTTTGGGAAC	CASSRDRGRNSPLHF	4
CAAAAGAACCCGACAGCTTTCTATCTCTGTGCCAGTAGACAGGGTTATAGTGGCGGCTACACCTTCGGTTCG	CASRQGYSGGYTF	3
AGCTTGGTGACTCTGCTGTGTATTTCTGTGCCTCGAGGGGCGGGACGTACGAGCAGTACTTCGGGCCG	CASRGGTYEQYF	6
AACCCAGGGACTCAGCTGTGTATTTTTGTGCCAGCAGTCCGGGACAGACGAACACTGAAGCTTTCTTTGGACAA	CASSPGQTNTEAFF	1
CGAGGAGATTCGGCAGCTTATTTCTGTGCCAGCTCACAAACAAACACTGAAGCTTTCTTTGGACAA	CASSQTNTEAFF	1
CTCCCTCTCAGACTTCTGTTTACTTCTGTGCCAGCAGTGAATTGTCTTACGAGCATTACTTCGGGCCG	CASSELSYEHYF	3
ATCCTGAAGACAGCAGCTTCTACATCTGCAGTGCTTGGGACGGGGCAGACTACGAGCAGTACTTCGGGCCG	CSAWDGADYEQYF	8
AACCCAGGGACTCAGCTGTGTATTTTTGTGCCAGCACCCTGGGACAGGCTAACACCGGGGAGCTGTTTTTTGGAGAA	CASTLGQANTGELFF	10
GCTCCCAGACATCTGTGTATTTCTGCGCCAGCAGTGGGGGGACAGGGGTCTCTAATGAAAAACTGTTTTTTGGCAGT	CASSGGTGVSNEKLFF	9
AGCTTGGTGACTCTGCTGTGTATTTCTGTGCCAGCAGCCATTTGACCGGGACAGGCACAGATACGCAGTATTTTGGCCCA	CASSHLTGTGTDTQYF	4
CCTCCCAGACATCTGTGTACTTGTGTGCCAGCAGTTACTCGAGAGGGTGGGAGACCCAGTACTTCGGGCCA	CASSYSRGWETQYF	21
GACTCGGCCRTGTATSKCTGTGCCAGCAGCCCTCAGGGTTGGAACACTGAAGCTTTCTTTGGACAA	CASSPQGWNTEAFF	1
CCCTGAAGACAGCAGCATATATCTCTGCAGCGTTGGGTACGGGACTAGAGAGACCCAGTACTTCGGGCCA	CSVGYGTRETQYF	5
CCCAACCAGACAGCTCTTTACTTCTGTGCCACCAGTGATTCCCGCCCAGCCCTTGGGCAGTATTTTGGCCCA	CATSDSRPALGQYF	2
GACTCGGCCGTGTATGTCTGTGCCAGCAGCTTGGCGGAGGGTATGAACACTGAAGCTTTCTTTGGACAA	CASSLAEGMNTEAFF	2
CAGAAGACTCAGCCCTGTATCTCTGCGCCAGCAGCCATCCCGTGCGGATACGGGACACGGGAACACTGAAGCTTTCTTTGGACAA		2
CACCAACCAGACATCTATGTACCTCTGTGCCAGCAGTCTTCCAGAGAGGAGGACCGGGGAGCTGTTTTTTGGAGAA	CASSLPERRTGELFF	22
CCCTGAAGACAGCAGCATATATCTCTGCAGCGTTGAAATTAATAGCAATCAGCCCCAGCATTTTGGTGAT	CSVEINSNQPQHF	3
CCTCCCAGACATCTGTGTACTTGTGTGCCATCAGTGAGGCTGGTCCGGGGCCAGATACGCAGTATTTTGGCCCA	CAISEAGPGPDTQYF	2
CAGAACTGGAGGATTCTGGAGTTTATTTCTGTGCCAGCAGCCACAATCAGGGCCTAAACACTGAAGCTTTCTTTGGACAA	CASSHNQGLNTEAFF	5
GACTCGGCCGTGTATGTCTGTGCCAGCAGGCCCAATCTAGCGGGCGCTTCCTACGAGCAGTACTTCGGGCCG	CASRPNLAGASYEQYF	4
AACCCAGGGACTCAGCTGTGTATTTTTGTGCCAGCAGTCCCGGGACAAAGGGAGGCTACACCTTCGGTTCG	CASSPGTKGGYTF	12
CCTCCCAGACATCTGTGTACTTGTGTGCCAGCAGTTACTCGGTTGCAAACACTGAAGCTTTCTTTGGACAA	CASSYSVANTEAFF	5
ATCCTGAAGACAGCAGCTTCTACATCTGCAGTGCAGTAGCGGGAAGACCAGGGACCCAGTACTTCGGGCCA	CSAVAGRPGTQYF	3
CAAAAGAACCCGACAGCTTTCTATCTCTGTGCCAGTAGTACCCGGACTAGCGGGGATCCTGATACGCAGTATTTTGGCCCA	CASSTRTSGDPDTQYF	4
GCTCCCAGACATCTGTGTATTTCTGCGCCAGCAGTGAGGATAGCGGGGGCGAGAGCTCCTACAATGAGCAGTTCTTCGGGCCA	CASSEDSGGESSYNEQFF	1
CGAGGAGATTCGGCAGCTTATTTCTGTGCCAGCTCACGACAGGATCAAGAGACCCAGTACTTCGGGCCA	CASSRQDQETQYF	15
TGYWCCCTCTCAGACWTCTGTKTACTTCTGTGCCATCAGGGAAGGTTACGAGCAGTACTTCGGGCCG	CAIREGYEQYF	1
CCCAACCAGACAGCTCTTTACTTCTGTGCCAGCAGACTCTCTAGCGGGGCTACCCTCGTTCTTGGCCCA	CASRLSSGATLVL	5
TGGGGGACTCAGCTTTGTATTTCTGTGCCAGCAGTGACGGGGACAGGGAGGCCTCTTTCGGGCCG	CASSDGDREASF	6
AGCTTGGTGACTCTGCTGTGTATTTCTGTGCCAGCAGCCAAGTTTGACAGGAGTACAAGAGACCCAGTACTTCGGGCCA		5
CCCAACCAGACAGCTCTTTACTTCTGTGCCAGCATGATCGTTGGGGGCTGAAGCTTTCTTTGGACAA		6
AACCCAGGGACTCAGCTGTGTATTTTTGTGCTAGCAGTTCGGGGGGATGGACCGGGGAGCTGTTTTTTGGAGAA	CASSSGGWTGELFF	7
GACTCGGCCGTGTATGTCTGTGCCAGCAGCCCGGACAGTCTAGGAACAGATACGCAGTATTTTGGCCCA	CASSPDSLGTDTQYF	7
ATCCTGAAGACAGCAGCTTCTACATCTGCAGTGCTAGAGGGCCTAGCGGGAGGACCCAAGAGACCCAGTACTTCGGGCCA	CSARGPSGRTQETQYF	161
GCTCCCAGACATCTGTGTATTTCTGCGCCAGCAGTGGAAAGGAAGAAGGGGGCTATTCCTGACCGGGGAGCTGTTTTTTGGAGAA		1
CAGAACTGGAGGATTCTGGAGTTTATTTCTGTGCCAGCAGCCAAGGCGACGGGGGCGATGAGCAGTTCTTCGGGCCA	CASSQGDGGDEQFF	10
GGACTCGGCCCTTTATCTTTGCGCCAGCAGCTTTGAGCGCTTAGGGGATGAGCAGTTCTTCGGGCCA	CASSFERLGDEQFF	7
ATCCTGAAGACAGCAGCTTCTACATCTGCAGTGCTCCGAGACGGTCTCTTAGTGGCGGGAGTCTTAATGAGCAGTTCTTCGGGCCA	CSAPRRSLSGGSLNEQFF	3
GAGACACGGCACTGTATCTCTGCGCCAGCAGTCAATCAGGGTGCGATACGCAGTATTTTGGCCCA	CASSQSGCDTQYF	4
CAAAAGAACCCGACAGCTTTCTATCTCTGTGCCAGTAGTAATAGCGGGGGGAGCACAGATACGCAGTATTTTGGCCCA	CASSNSGGSTDTQYF	14
CAAAAGAACCCGACAGCTTTCTATCTCTGTGCCAGTAGCAAGGACAGGGGGTACTACACTGAAGCTTTCTTTGGACAA	CASSKDRGYYTEAFF	19
CCCTGAAGACAGCAGCATATATCTCTGCAGCGTGGTTGGAGGGGGGGGCTCTAATGAAAAACTGTTTTTTGGCAGT	CSVVGGGGSNEKLFF	9
TGGGGGACTCAGCTTTGTATTTCTGTGCCAGCAGCTTAGGTGGAAGCCGGGGAGCTGTTTTTTGGAGAA		1
TTCTCAGTGACTCTGGCTTCTATCTCTGTGCCTGGAGTGTACATGGGGGCCCTGAAGCTTTCTTTGGACAA	CAWSVHGGPEAFF	5
AACCCAGGGACTCAGCTGTGTAYTTYTGTGCCAGCAGTTGGGGAGGATCGGGAGGCCTACGGGGCTACACCTTCGGTTCG	CASSWGGSGGLRGYTF	2
CACCAACCAGACATCTATGTACCTCTGTGCCAGCAGTTTACAGGGGGCCCCCAACACCATATATTTTGGAGAG	CASSLQGAPNTIYF	1
TGGRGGACTCAGCYWTGTAYTTCTGTGCCAGCAGTGATAGCGGGGGGTGACCACAGATACGCAGTATTTTGGCCCA		5
AGCTTGGTGACTCTGCTGTGTATTTCTGTGCCAGCAGTTCGAGAGGCGGGCCTACCACAGATACGCAGTATTTTGGCCCA	CASSSRGGPTTDTQYF	2
CAAAAGAACCCGACAGCTTTCTATCTCTGTGCCAGTAGTAAGACCCGGACCAGCTACAATGAGCAGTTCTTCGGGCCA	CASSKTRTSYNEQFF	18
ATCCTGAAGACAGCAGCTTCTACATCTGCAGTGCTAGCCTACAGGGGACCTATGGCTACACCTTCGGTTCG	CSASLQGTYGYTF	1
AACCCAGGGACTCAGCTGTGTATTTTTGTGCCAACACAAAGGGGACCGGGGAGCTGTTTTTTGGAGAA	CANTKGTGELFF	3
TYRGGRGACWCAGCWYKGTATTTCTGTGCCAGCAGCGTCGGGACAGGCCAGCCCCAGCATTTTGGTGAT	CASSVGTGQPQHF	7
CAGGGACTCAGCTGTGTACTTCTGTGCCAGCAGTTTGGCAGGGCCCTATAATTCACCCCTCCACTTTGGGAAC	CASSLAGPYNSPLHF	6
CGAGGAGATTCGGCAGCTTATTTCTGTGCCAGCTCACCAGCCGGGACAATCGCACAGCCCCAGCATTTTGGTGAT	CASSPAGTIAQPQHF	14
CCCAACCAGACAGCTCTTTACTTCTGTGCCACCAGTGATAGACAGCCCTTCAGCGTCCTGACTTTCGGGGCC	CATSDRQPFSVLTF	5
CACCAACCAGACATCTATGTACCTCTGTGCCAGCGGGTCAGGGGGTGCGGGCTACACCTTCGGTTCG	CASGSGGAGYTF	1
CCTCCCAGACATCTGTGTACTTGTGTGCCATAAAAAGGGACAGTGCCTCCTACGAGCAGTACTTCGGGCCG	CAIKRDSASYEQYF	3
CAAAAGAACCCGACAGCTTTCTATCTCTGTGCCAGTAATATAGATCCCGGGGCCGAGCAGTACTTCGGGCCG	CASNIDPGAEQYF	21
CCCAACCAGACAGCTCTTTACTTCTGTGCCAGCAGTAGGCTAGCGGGAGGGCCGATGAGCAGTTCTTCGGGCCA		1
GACTCGGCCGTGTATGTCTGTGCCAGCAGCCCTTCTCGCGGGACAGGGATGTGGGAGCAGTACTTCGGGCCG	CASSPSRGTGMWEQYF	3
CCTCACATACCTCTCAGTACCTCTGTGCCAGCAGTGCGTATGACAATGAGCAGTTCTTCGGGCCA	CASSAYDNEQFF	5
CAAAAGAACCCGACAGCTTTCTATCTCTGTGCCAGTAGTCAGGACTAGCGGAAACAATGAGCAGTTCTTCGGGCCA		2
CCCAACCAGACAGCTCTTTACTTCTGTGCCAGCCACCAAAGCGGCACAGATACGCAGTATTTTGGCCCA	CASHQSGTDTQYF	2
CAAAAGAACCCGACAGCTTTCTATCTCTGTGCCAGTAGTATAGTTGTGAGGACTGAAGCTTTCTTTGGACAA	CASSIVVRTEAFF	7
CCTCCCAGACATCTGTGTACTTGTGTGCCAGCAATATACAGGGGAGCACTGAAGCTTTCTTTGGACAA	CASNIQGSTEAFF	2
TTCTCAGTGACTCTGGCTTCTATCTCTGTGCCTGGAGCCCGGACAGGGGGCTTGGCTACACCTTCGGTTCG	CAWSPDRGLGYTF	1
CAAAAGAACCCGACAGCTTTCTATCTCTGTGCCACCAACCGGGAGGAGGGGCGGGCGAGACCCAGTACTTCGGGCCA		39
CAGCTTTCTATCTCTGTGCCAGTAGTACACAAAAACCAGGGGACAGATTACGCTCCTACAATGAGCAGTTCTTCGGGCCA	CASSTQKPGDRLRSYNEQFF	1
CAAAAGAACCCGACAGCTTTCTATCTCTGTGCCAGTAGTCGACAGGGGGGGGAGAAACAGTTCTTCGGGCCA	CASSRQGGEKQFF	1
CCTCCCAGACATCTGTGTACTTGTGTGCCAGCAGGGGGACTAGCGGGAGGCGCTGATACGCAGTATTTTGGCCCA		7
CCTCACATACCTCTCAGTACCTCTGTGCCAGCAGTTCTCAGGGGAGGGGCCCTGAAGCTTTCTTTGGACAA	CASSSQGRGPEAFF	1
CCCAACCAGACAGCTCTTTACTTCTGTGCCACCAGTGATTCCGGGACAGGGGACACCGGGGAGCTGTTTTTTGGAGAA	CATSDSGTGDTGELFF	7
CACCAACCAGACATCTATGTACCTCTGTGCCAGCAGTTTCTCGGACAGGGGGGGCGAGCAGTACTTCGGGCCG	CASSFSDRGGEQYF	1
TGGGGGACTCAGCTTTGTATTTCTGTGCCAGCAGGTAATTGTCGGGAGGCCCTTATCGGCCACTGAAGCTTTCTTTGGACAA		7
AGCTTGGTGACTCTGCTGTGTATTTCTGTGCCAGCAGCCAAGATGGAGGGATGTTGGAAGCTTTCTTTGGACAA	CASSQDGGMLEAFF	1
CCTCCCAGACATCTGTGTACTTGTGTGCCAGCACCGACAGGGGGCTGGATCTATGGCTACACCTTCGGTTCG		1
TGGGGGACTCAGCTTTGTATTTCTGTGCCAGCAGTTGGGACGGATCCAACTATGGCTACACCTTCGGTTCG	CASSWDGSNYGYTF	8
CAGAACTGGAGGATTCTGGAGTTTATTTCTGTGCCAGCAGCCACAACAGGGGGTACGAGCAGTACTTCGGGCCG	CASSHNRGYEQYF	39
CCCTGAAGACAGCAGCATATATCTCTGCAGCGTTGAAGGGGCGAACACTGAAGCTTTCTTTGGACAA	CSVEGANTEAFF	2
AACCCAGGGACTCAGCTGTGTATTTTTGTGCCAGCAGTTTAGCCAGGAGTGGCAATCAGCCCCAGCATTTTGGTGAT	CASSLARSGNQPQHF	6
CCCAACCAGACAGCTCTTTACTTCTGTGCCAGCAGTTCAGCAGAGGGAGGGGGGATGAGCAGTTCTTCGGGCCA		6
CAAAAGAACCCGACAGCTTTCTATCTCTGTGCCAGTAGTCCGTCCCAGACCCTGAGCAATCAGCCCCAGCATTTTGGTGAT	CASSPSQTLSNQPQHF	2
ATCCTGAAGACAGCAGCTTCTACATCTGCAGTGCTAGGCCGTTCGAGCGGGGGGGCAGAGATACGCAGTATTTTGGCCCA	CSARPFERGGRDTQYF	1
GACGCAGCCATGTACCTGTGTGCCACCAGCGGGACAGTTGGGAATCAGCCCCAGCATTTTGGTGAT	CATSGTVGNQPQHF	1
GAGACACGGCACTGTATCTCTGCGCCAGCAGCCGGGGGGAGGGCACCGGGGAGCTGTTTTTTGGAGAA	CASSRGEGTGELFF	2
GACTCGGCCGTGTATGTCTGTGCCAGCAGCTTGTTTGTAACTCTCAATCAGCCCCAGCATTTTGGTGAT	CASSLFVTLNQPQHF	4
GACTCGGCCGTGTATGTCTGTGCCAGCAGCCCCCGACAACGATTGAATTCACCCCTCCACTTTGGGAAC	CASSPRQRLNSPLHF	9
CCTCCCAGACATCTGTGTACTTGTGTGCCAGCACCCCCACCGGGACAGCCTACGAGCAGTACTTCGGGCCG	CASTPTGTAYEQYF	1
ATCCTGAAGACAGCAGCTTCTACATCTGCAGTGCGGCGGGGGGGACAGGGGGATGGAACGCTGAAGCTTTCTTTGGACAA	CSAAGGTGGWNAEAFF	1
CCCAACCAGACAGCTCTTTACTTCTGTGCCACCAGTGATCCGGGGACAGGGGGCTGTGAAAAACTGTTTTTTGGCAGT	CATSDPGTGGCEKLFF	3
AACCCAGGGACTCAGCTGTGTATTTTTGTGCCAGCAGTCACGAACTAGCGGATAACTCCTACAATGAGCAGTTCTTCGGGCCA	CASSHELADNSYNEQFF	1
CGAGGAGATTCGGCAGCTTATTTCTGTGCCAGCTCACTTCAGGACGGCTACGAGCAGTACTTCGGGCCG	CASSLQDGYEQYF	1
AGCTTGGTGACTCTGCTGTGTATTTCTGTGCCAGCAAGGCTAGCGGGGGGGGCTACGAGCAGTACTTCGGGCCG	CASKASGGGYEQYF	9
AGGACTCRGCCMTGTATCKCTGTGCCAGCAGCTTTTCGGGTAAATCTCACAAAGTCGGGCCAACGTCCTGACTTTCGGGGCC		6
CAAAAGAACCCGACAGCTTTCTATCTCTGTGCCAGTAGTGACCTTAAGCCAGGGAGGGTAAGCTACACCTTCGGTTCG	CASSDLKPGRVSYTF	9
CGAGGAGATTCGGCAGCTTATTTCTGTGCCAGCTCACCAACAATAAGCACGGCGGGAGAAAAACTGTTTTTTGGCAGT	CASSPTISTAGEKLFF	1
CACCAACCAGACATCTATGTACCTCTGTGCCATATTTCAGGCAGGGGGTAGGGATGAGCAGTTCTTCGGGCCA	CAIFQAGGRDEQFF	1
CTCCCTCTCAGACTTCTGTTTACTTCTGTGCCAGCAGTTATGCCGTGGGACAGGGTTTTAGGTCAGCCCCAGCATTTTGGTGAT		21
AACCCAGGGACTCAGCTGTGTATTTTTGTGCCAGCAGGGAGGGCGGGATCCAAGAGACCCAGTACTTCGGGCCA	CASREGGIQETQYF	1
TGGGGGACTCAGCTTTGTATTTCTGTGCCAGCAGCGTATCCCCCAAGGATTCACCCCTCCACTTTGGGAAC	CASSVSPKDSPLHF	3
CACCAACCAGACATCTATGTACCTCTGTGCCAGCAGTTCCTCGGGGAGTTCGCAGTATTTTGGCCCA	CASSSSGSSQYF	18
ATCCTGAAGACAGCAGCTTCTACATCTGCAGTGCTAGAGATCGGGGGAGGGGCCAGGGCGCTGAAGCTTTCTTTGGACAA	CSARDRGRGQGAEAFF	1
GACTCGGCCGTGTATGTCTGTGCCAGCAGCTTAGACGCGGGGTTTACAGATACGCAGTATTTTGGCCCA	CASSLDAGFTDTQYF	5
CAAAAGAACCCGACAGCTTTCTATCTCTGTGCCAGTACACAGGGGCCGAACTCCTATAATTCACCCCTCCACTTTGGGAAC	CASTQGPNSYNSPLHF	1
AGCTTGGTGACTCTGCTGTGTATTTCTGTGCCAGCAGCCAAGGGGACCGCACAGATACGCAGTATTTTGGCCCA	CASSQGDRTDTQYF	8
CCTCCCAGACATCTGTGTACTTGTGTGCCAGCAGTGAAAGGGTGGATGGCTACACCTTCGGTTCG	CASSERVDGYTF	4
GCTCCCAGACATCTGTGTATTTCTGCGCCATCCAGAGAGACATTTAACTACACTGAAGCTTTCTTTGGACAA		4
CAAAAGAACCCGACAGCTTTCTATCTCTGTGCCAGTAGTATAGAAAGCGGGAGGGAGACCCAGTACTTCGGGCCA	CASSIESGRETQYF	4
CGAGGAGATTCGGCAGCTTATTTCTGTGCCAGCTCAATCAGACAGTCCGAGACCCAGTACTTCGGGCCA	CASSIRQSETQYF	1
GCTCCCAGACATCTGTGTATTTCTGCGCCAACAGTGATTATAAGAACTATGGCTACACCTTCGGTTCG	CANSDYKNYGYTF	5
ATCCTGAAGACAGCAGCTTCTACATCTGCAGTGCTAGAAGCAGGGGAGATACGCAGTATTTTGGCCCA	CSARSRGDTQYF	4
CAGAACTGGAGGATTCTGGAGTTTATTTCTGTGCCAGCAGCCTCCGGGACCTAAAACATTCAGTACTTCGGCGCC		4
AGCTTGGTGACTCTGCTGTGTATTTCTGTGCCAGCAGCTTTCTCTCTGGCTACACCTTCGGTTCG	CASSFLSGYTF	1
CCTCCCAGACATCTGTGTACTTGTGTGCCAGCAGTTACGCGGCTATCTCCTACGAGCAGTACTTCGGGCCG	CASSYAAISYEQYF	6
ATCCTGAAGACAGCAGCTTCTACATCTGCAGTGTTAACGCCGGGCAGGGTACAATTAACTATGGCTACACCTTCGGTTCG	CSVNAGQGTINYGYTF	2
GACTCGGCCGTGTATGTCTGTGCCAGCAGCCGGGGAGGACGCCCAGATACGCAGTATTTTGGCCCA	CASSRGGRPDTQYF	1
CACCAACCAGACATCTATGTACCTCTGTGCCAGCAGTTTACTCTTCGGCCCGGGCCGGGGCAATCAGCCCCAGCATTTTGGTGAT	CASSLLFGPGRGNQPQHF	5
CGAGGAGATTCGGCAGCTTATTTCTGTGCCAGCTCACTGGGACTAGCGGGAGGGCACAATGAGCAGTTCTTCGGGCCA	CASSLGLAGGHNEQFF	23
TSRGGGACTCAGCTKTGTAYTTCTGTGCCAGCAGTGAAGGGTCCCGCTATGGCTACACCTTCGGTTCG	CASSEGSRYGYTF	5
CAAAAGAACCCGACAGCTTTCTATCTCTGTGCCAGTAGCCGAGACCCCTCTGGGGCCAACGTCCTGACTTTCGGGGCC	CASSRDPSGANVLTF	15
AACCCAGGGACTCAGCTGTGTATTTTTGTGCCAGCAGTTTAGTAGGGCTCGGAACCGGGGAGCTGTTTTTTGGAGAA	CASSLVGLGTGELFF	2
GACTCGGCCGTGTATGTCTGTGCAAGTCGCTTAGTTATTGCGGGGGGCCGAAATGCTACGAGCAGTACTTCGGGCCG		3
GACTCGGCCGTGTATGTCTGTGCCAGCAGCGGCGGGTCAGTTAATTCACCCCTCCACTTTGGGAAC	CASSGGSVNSPLHF	1
TGGGGGACTCAGCTTTGTATTTCTGTGCCAGCAGCGCCCTCCCTAGCGGGAAGATCTACGAGCAGTACTTCGGGCCG	CASSALPSGKIYEQYF	1
CAAAAGAACCCGACAGCTTTCTATCTCTGTGCCAGTAGTATAAGTGGTTACGAGCAGTACTTCGGGCCG	CASSISGYEQYF	9
GGACTCGGCCCTTTATCTTTGCGCCAGCAGCTTTCAGGGGCGGGACAACGAAGCTTTCTTTGGACAA	CASSFQGRDNEAFF	11
TYCTCAGTGACTCTGGCTTCTATCTCTGTGCCTGGTCTAATATTAGGGGAGGAAGCCAGCCCCAGCATTTTGGTGAT	CAWSNIRGGSQPQHF	4
CCAACCAGACAGCTCTTTACTTCTGTGCCAGCAATCAAACTACAGGGGGAGGATGTAGAAGGCAATCAGCCCCAGCATTTTGGTGAT		1
CAAAAGAACCCGACAGCTTTCTATCTCTGTGCCAGTAGTACTCAAAGAGAGGGGGAGACCCAGTACTTCGGGCCA	CASSTQREGETQYF	31
CCTCCCAGACATCTGTGTACTTGTGTGCCATCAGTGGTACAGGGGAGACTGAAGCTTTCTTTGGACAA	CAISGTGETEAFF	1
CCCTGAAGACAGCAGCATATATCTCTGCAGCGCGTCCATCCTCCGGGGACAGGGTAATGAAAAACTGTTTTTTGGCAGT	CSASILRGQGNEKLFF	4
TGGGGGACTCAGCTTTGTATTTCTGTGCCAGCCGGGACTTGCTCTACGAGCAGTACTTCGGGCCG	CASRDLLYEQYF	8
ATCCTGAAGACAGCAGCTTCTACATCTGCAGTGCGACGAGTTCCGGGACGGACGCCCTTGGCTATGGCTACACCTTCGGTTCG	CSATSSGTDALGYGYTF	5
CCTCCCAGACATCTGTGTACTTGTGTGCCATCGCCCAGGCCGGCCACTGAAGCTTTCTTTGGACAA		1
CACCAACCAGACATCTATGTACCTCTGTGCCAGCAGTCCTAGCGGGAGCCCGACCTACGAGCAGTACTTCGGGCCG	CASSPSGSPTYEQYF	1
AACCCAGGGACTCAGCTGTGTATTTTTGTGCCAGCAGTGGAGGACAGGGTGTGAATTCACCCCTCCACTTTGGGAAC	CASSGGQGVNSPLHF	6
CCTCCCAGACATCTGTGTACTTGTGTGCCATCAGGAGCGCCGAAAGGGGTTCTTACAATGAGCAGTTCTTCGGGCCA	CAIRSAERGSYNEQFF	1
CCTCCCAGACATCTGTGTACTTGTGTGCCAGCAGTATGGCAGGATGGAACACTGAAGCTTTCTTTGGACAA	CASSMAGWNTEAFF	3
GACTCGGCCGTGTATGTCTGTGCCAGCAGGAAAAGATTTCAGAACACTGAAGCTTTCTTTGGACAA	CASRKRFQNTEAFF	1
GACTCGGCCGTGTATSTCTGTGCCAGAAGCCGGACCCCCGAAGTAGGGCCTGGGGCCAACGTCCTGACTTTCGGGGCC	CARSRTPEVGPGANVLTF	1
CCTCCCAGACATCTGTGTACTTGTGTGCCAGCATCGTGGCGGGGGGTCTCCAAGAGACCCAGTACTTCGGGCCA	CASIVAGGLQETQYF	26
ATCCTGAAGACAGCAGCTTCTACATCTGCAGTGCCATTCGTGGCTAACGGGGGGGCATCCAGATACGCAGTATTTTGGCCCA		10
CCTCCCAGACATCTGTGTACTTGTGTGCCAGCAGTTACTCTGGGGTGGTGAATTCACCCCTCCACTTTGGGAAC	CASSYSGVVNSPLHF	7
CAGAACTGGAGGATTCTGGAGTTTATTTCTGTGCCAGCAGCCAACAGGGGGCGACCGGGGAGCTGTTTTTTGGAGAA	CASSQQGATGELFF	5
GACTCGGCCGTGTATGTCTGTGCCAGCAGCTACAATGGGTGGCAAGAGACCCAGTACTTCGGGCCA	CASSYNGWQETQYF	300
CCCTGAAGACAGCAGCATATATCTCTGCAGCGTTGTGGGATCGGCTAACTATGGCTACACCTTCGGTTCG	CSVVGSANYGYTF	9
CAAAAGAACCCGACAGCTTTCTATCTCTGTGCCAGTAGTATGCGTCCGGGTGAGGGCACTGAAGCTTTCTTTGGACAA	CASSMRPGEGTEAFF	24
CACCAACCAGACATCTATGTACCTCTGTGCCAGCAGTTTCGACACAACCTACTCAAACTATGGCTACACCTTCGGTTCG	CASSFDTTYSNYGYTF	14
CCTCACATACCTCTCAGTACCTCTGTGCCAGCAGTGAAGAGGGTTGGAGCTATGGCTACACCTTCGGTTCG	CASSEEGWSYGYTF	11
GCTCCCAGACATCTGTGTATTTCTGCGCCAGCAGGGGTCAGAGGAAGGACAGCACAGATACGCAGTATTTTGGCCCA	CASRGQRKDSTDTQYF	2
CACCAACCAGACATCTATGTACCTCTGTGCCAGCAGTAGAGGGGGCTCTGGAAACACCATATATTTTGGAGAG	CASSRGGSGNTIYF	3
TCAGGAGACACAGCACGGTATTTCTGTGCCAGCAGCCCGCGGCTGTAGACCCCTCCACTTTGGGAAC		9
CGAGGAGATTCGGCAGCTTATTTCTGTGCCAGCTCACTAAACACCGGGACAGCAAACTACGAGCAGTACTTCGGGCCG	CASSLNTGTANYEQYF	5
ATCCTGAAGACAGCAGCTTCTACATCTGCAGTGCAGGGGACCGCACAGGGAGCAGTACTTCGGGCCG		5
CTCCCTCYCAGACWTCTGTKTACTTSTGTGCCAGCAGTGAACAGGGGCGCTACAATCAGCCCCAGCATTTTGGTGAT	CASSEQGRYNQPQHF	3
CRRRRGACTCAGCCSTGTATCTCTRCGCCAGCAGCCAAGGGAGCACTTCTATCCGGGGCCAACGTCCTGACTTTCGGGGCC		1
GACTCGGCCGTGTATGTCTGTGCCAGCAGTAAAGGCCAGGAGACTCCTACGAGCAGTACTTCGGGCCG		1
ATCCTGAAGACAGCAGCTTCTACATCTGCAGTTCTCCCCCGGGACTAGACCCCCCAGATACGCAGTATTTTGGCCCA	CSSPPGLDPPDTQYF	9
ATCCTGAAGACAGCAGCTTCTACATCTGCAGTGCTAGCAACAGGGAGGCCACTGAAGCTTTCTTTGGACAA	CSASNREATEAFF	63
AACCCAGGGACTCAGCTGTGTATTTTTGTGCCAGCGGATTAACAGGTTTGGTCCTACGAGCAGTACTTCGGGCCG		4
GACTCGGCCGTGTATGTCTGTGCCAGCAGCCCGGGGGGCAGGGTGACCTACGAGCAGTACTTCGGGCCG	CASSPGGRVTYEQYF	1
CCTCCCAGACATCTGTGTACTTGTGTGCCAGCAGTCCTCTTAGGACAGGGCGGATTCCCTACTTCGGGCCG	CASSPLRTGRIPYF	5
GACTCGGCCGTGTATGTCTGTGCCAGCAGCCGCCGATTTAGCGGGGGCACAGATACGCAGTATTTTGGCCCA	CASSRRFSGGTDTQYF	7
GACTCGGCCGTGTATGTCTGTGCCAGCAGCTTGGCACAGGGGGCGTACGAGCAGTACTTCGGGCCG	CASSLAQGAYEQYF	2
ATCCTGAAGACAGCAGCTTCTACATCTGCAGTGCTAGGGAGCAGCAGCGTGAGCAGTTCTTCGGGCCA	CSAREQQREQFF	14
TCAGGAGACACAGCACGGTATTTCTGTGCCAGCAGCGCTTGGACAGAAGAATCAGCCCCAGCATTTTGGTGAT		1
TGGGGGACTCAGCTTTGTATTTCTGTGCCAGCAGTGGGGGAAATGAAAAACTGTTTTTTGGCAGT	CASSGGNEKLFF	2
GACTCGGCCGTGTATGTCTGTGCCAGCAGCAGAGAATCGGGAAACACTGAAGCTTTCTTTGGACAA	CASSRESGNTEAFF	3
CCTCCCAGACATCTGTGTACTTGTGTGCCAGCAGTCACCTCTTTCCGGGACAGCGTAGCAATCAGCCCCAGCATTTTGGTGAT	CASSHLFPGQRSNQPQHF	6
GACTCGGCCGTGTATGTCTGTGCCAGCAGCTTGACCCGACTAGCGGGGGGGTAGCCTACAATGAGCAGTTCTTCGGGCCA		26
CCCAACCAGACAGCTCTTTACTTCTGTGCCACCCGATGACAGGGGGAAGACTGAAGCTTTCTTTGGACAA		1
CAAAAGAACCCGACAGCTTTCTATCTCTGTGCCAGTAGTATTATGGCGAATGAGCAGTTCTTCGGGCCA	CASSIMANEQFF	3
CCCAACCAGACAGCTCTTTACTTCTGTGYCAGCAGTCCCTGGGGAGGGGGCCCCTACGAGCAGTACTTCGGGCCG	CXSSPWGGGPYEQYF	4
GGACTCGGCCCTTTATCTTTGCGCCAGCCTTCTCCGGTTCGAAAGACCTATGGCTACACCTTCGGTTCG		8
TSRGGGACTCAGCTKTGTAYTTCTGTGCCAGCAGTGAATATGGGGTTAGCACAGATACGCAGTATTTTGGCCCA	CASSEYGVSTDTQYF	1
CCCTGAAGACAGCAGCATATATCTCTGCAGCGTATACCACCGAGGAAATCGAACACTGAAGCTTTCTTTGGACAA		2
ATCCTGAAGACAGCAGCTTCTACATCTGCAGTGCTAGCCACAAGGGGTTACGGGGAGCTGTTTTTTGGAGAA		4
GAGACACGGCACTGTATCTCTGCGCCAGCAGTCACCTTAGGGAGGGGCACTGAAGCTTTCTTTGGACAA		2
GACTCGGCCGTGTATGTCTGTGCCAGCAGCTTAGCACCGGGAGTGGCTGAGCAGTACTTCGGGCCG	CASSLAPGVAEQYF	1
ATCCTGAAGACAGCAGCTTCTACATCTGCAGTGCTAGAGAGAACGCGGGGGGCGATTTTGGGGAGCTGTTTTTTGGAGAA	CSARENAGGDFGELFF	1
ATCCTGAAGACAGCAGCTTCTACATCTGCAGTGCTAGAGATCAAGCAGGGGAAGGCTACACCTTCGGTTCG	CSARDQAGEGYTF	2
CCCAACCAGACAGCTCTTTACTTCTGTGCCACCAGTGATTATGAAACTAGCACAGATACGCAGTATTTTGGCCCA	CATSDYETSTDTQYF	6
GACTCGGCCGTGTATGTCTGTGCCAGCAGCCCCTGGGGGGCAGGCGAAAAACTGTTTTTTGGCAGT	CASSPWGAGEKLFF	4
CCTCCTCCCAGACATCTGTATATTTCTGCGCCAGCAGTGCGGGGGATACGCAGTATTTTGGCCCA	CASSAGDTQYF	9
ATCCTGAAGACAGCAGCTTCTACATCTGCAGTGCTAGAGCTGGACAGGCCGCAGGAGGCTACACCTTCGGTTCG	CSARAGQAAGGYTF	13
CCTCCCAGACATCTGTGTACTTGTGTGCCAGCAGTGAAGGGGAGCGTCCCACGTGGAGTAACGAGCAGTACTTCGGGCCG	CASSEGERPTWSNEQYF	1
CCTCCCAGACATCTGTGTACTTGTGTGCCAGCAGCTAATCGGGACTAGCCGTAAGGACAGATACGCAGTATTTTGGCCCA	CASS*SGLAVRTDTQYF	6
CAGAAGACTCAGCCCTGTATCTCTGCGCCAGCAGCCCCGGGACAGGGGTAGCTAACTATGGCTACACCTTCGGTTCG	CASSPGTGVANYGYTF	1
GACTCGGCCGTGTATGTCTGTGCCAGCAGCCCGAATCGGGACAGGGAGGGAGGCTACACCTTCGGTTCG	CASSPNRDREGGYTF	6
CTCCCTCTCAGACTTCTGTTTACTTCTGTGCCAGCAGCTCGATGGTTGGCTACACCTTCGGTTCG	CASSSMVGYTF	8
ATCCTGAAGACAGCAGCTTCTACATCTGCAGTGCTAGGGGATAGCGATCCTACGAGCAGTACTTCGGGCCG	CSARG*RSYEQYF	7
ATCCTGAAGACAGCAGCTTCTACATCTGCAGTGCCAGAGATAACCGTCAGGTTCAGTACTTCGGGCCA	CSARDNRQVQYF	5
CGACTCGGCYGTGTATSTCTGTGCCAGCAGCCTTTCTTTGAGGGACAAGGGGAGTTCACCCCTCCACTTTGGGAAC	CASSLSLRDKGSSPLHF	2
CAAAAGAACCCGACAGCTTTCTATCTCTGTGCCAGTAGGCCCCCAGGCACTGAAGCTTTCTTTGGACAA	CASRPPGTEAFF	1
CAGAAGACTCAGCCCTGTATCTCTGCGCCAGCAGCCAAGAGTCGGGCCCCCAGCATTTTGGTGAT	CASSQESGPQHF	1
CCTCCCAGACATCTGTGTACTTGTGTGCCATCAGCCGGACAGGGTCTTCCTACGAGCAGTACTTCGGGCCG	CAISRTGSSYEQYF	2
GCTCCCAGACATCTGTGTATTTCTGCGCCAGTGGGACTAGCGGGGGCAAGAGCAGTACTTCGGGCCG		9
AACCCAGGGACTCAGCTGTGTATTTTTGTGCCAGCAGTGTGGACAGCTCCTACGAGCAGTACTTCGGGCCG	CASSVDSSYEQYF	2
CCCAACCAGACAGCTCTTTACTTCTGTGCCAGCAGACCCCAAGGGACAGGCGGCGAGCAGTACTTCGGGCCG	CASRPQGTGGEQYF	28
CCTCCCAGACATCTGTGTACTTGTGTGCCAGCGGTCATTTGGGGAACGGAGATCAGCCCCAGCATTTTGGTGAT	CASGHLGNGDQPQHF	9
GACTCGGCCGTGTATGTCTGTGCCAGCAGCTTAGGACAGGGGCCCCTGGAGCAGTTCTTCGGGCCA	CASSLGQGPLEQFF	1
ATCCTGAAGACAGCAGCTTCTACATCTGCAGTGCGAGGGCGGGCACCGGGGAGCTGTTTTTTGGAGAA	CSARAGTGELFF	3
CCCAACCAGACAGCTCTTTACTTCTGTGCCAGCAGTCCGAGCCCCTCTCCTGCCTCTAACTATGGCTACACCTTCGGTTCG	CASSPSPSPASNYGYTF	1
GACTCGGCCGTGTATGTCTGTGCCAGCAGCTCCGGGGCAGGGGGCGCGGCTGGGGCCAACGTCCTGACTTTCGGGGCC	CASSSGAGGAAGANVLTF	9
GAGACWCGGCMSTGTATSTCTGYGCCAGCAGCTCGGGACAGGGTAACCCGGATAATGAAAAACTGTTTTTTGGCAGT	CASSSGQGNPDNEKLFF	1
CAGAACTGGAGGATTCTGGAGTTTATTTCTGTGCCAGCAGCCAAGGTAGGGAAAAGGGTGAAAGCAGATACGCAGTATTTTGGCCCA		3
CCTCCCAGACATCTGTGTACTTGTGTGCCAGCAGTGAAGCGGGAGGGACTAATGAAAAACTGTTTTTTGGCAGT	CASSEAGGTNEKLFF	2
CCCTGAAGACAGCAGCATATATCTCTGCAGCGTACTGGGACAGGCGAGGAACACTGAAGCTTTCTTTGGACAA	CSVLGQARNTEAFF	1
AACCCAGGGACTCAGCTGTGTATTTTTGTGCCAGCAGTGGGACAAGGAACTATGGCTACACCTTCGGTTCG	CASSGTRNYGYTF	4
CAGCCAGACCTATCTGTACCACTGTGGCAGTGTCATCCATGAGCCGAAAGACCTATGGCTACACCTTCGGTTCG		2
CGAGGAGATTCGGCAGCTTATTTCTGTGCCAGCTCACCAGGGGACAATCAGCCCCAGCATTTTGGTGAT	CASSPGDNQPQHF	4
GCTCCCAGACATCTGTGTATTTCTGCGCCAGCAACGCCGGGGTTCAATGAGCAGTTCTTCGGGCCA		2
CCCAACCAGACAGCTCTTTACTTCTGTGCCAGCAGTTTAGCAGGGGCAGGGAGCACCGGGGAGCTGTTTTTTGGAGAA	CASSLAGAGSTGELFF	3
AACCCAGGGACTCAGCTGTGTATTTTTGTGCCAGCAGTTTAGCCCCGGGGTCCAGCGAGCAGTACTTCGGGCCG	CASSLAPGSSEQYF	7
TGGGGGACTCAGCTTTGTATTTCTGTGCCAGCAGTGGCCAGGCAACGGAGGCCAACGTCCTGACTTTCGGGGCC	CASSGQATEANVLTF	17
CGAGGAGATTCGGCAGCTTATTTCTGTGCCAGCTCACGGACGACAGGGGCAGGCAATCAGCCCCAGCATTTTGGTGAT	CASSRTTGAGNQPQHF	3
CAAAAGAACCCGACAGCTTTCTATCTCTGTGCCAGTAGTATTTTCGGAGGGGTAGATACGCAGTATTTTGGCCCA	CASSIFGGVDTQYF	1
GACTCGGCCRTGTATSKCTGTGCCAGCAGCAGGACAGGGGGCCCCTACAATGAGCAGTTCTTCGGGCCA	CASSRTGGPYNEQFF	3
CAAAAGAACCCGACAGCTTTCTATCTCTGTGCCAGTAGTCCTCATAGGGGCCGTAGGCTTGAAGCTTTCTTTGGACAA	CASSPHRGRRLEAFF	1
TSRGGGACTCAGCTKTGTAYTTCTGTGCCAGCAGTGCTGAGAAATCCTATAATTCACCCCTCCACTTTGGGAAC	CASSAEKSYNSPLHF	2
TTCTCAGTGACTCTGGCTTCTATCTCTGTGCCTGGACCCTAGGGACAGGGGGAGATGAAAAACTGTTTTTTGGCAGT	CAWTLGTGGDEKLFF	3
CAGAAGACTCAGCCCTGTATCTCTGCGCCAGCAGCCAAGTGGGGAAAGGACTCCCATACACCTTCGGTTCG	CASSQVGKGLPYTF	1
CCTCCCAGACATCTGTGTACTTGTGTGCCAGCATCCAAAGGGGGCAGGGACATCAGCCCCAGCATTTTGGTGAT	CASIQRGQGHQPQHF	5
ATCCTGAAGACAGCAGCTTCTACATCTGCAGTCTCCGGGACAGGGATGGCTACACCTTCGGTTCG	CSLRDRDGYTF	5
CAGGGACTCAGCTGTGTACTTCTGTGCCAGCAGTTCGCCAGGCTGGAGCTATGGCTACACCTTCGGTTCG	CASSSPGWSYGYTF	4
ATCCTGAAGACAGCAGCTTCTACATCTGCAGTGCTCCAGAGGTCGACAATGAGCAGTTCTTCGGGCCA	CSAPEVDNEQFF	5
ATCCTGAAGACAGCAGCTTCTACATCTGCAGTGCTAGGACAGGGAATGGGAGACCCAGTACTTCGGGCCA		1
CCTCCCAGACATCTGTGTACTTGTGTGCCAGCAGCCAGGGGCGCTATGGCTACACCTTCGGTTCG	CASSQGRYGYTF	6
CAAGCCACGTTTGGTGCGCTCCCAGACATCTTGTATTTCTGCGCCAGCAGTGAGTTCCGGGGGGATGGCGAGCAGTACTTCGGGCCG	CASSEFRGDGEQYF	9
AGCTTGGTGACTCTGCTGTGTATTTCTGTGCCAGCAGCGGCAGGTTAGCGAACACCGGGGAGCTGTTTTTTGGAGAA	CASSGRLANTGELFF	8
GACTCGGCCGTGTATCTCTGTGCCAGCAGCTTAGCAGGGGAAGAGACCCAGTACTTCGGGCCA	CASSLAGEETQYF	1
TGGGGGACTCAGCTTTGTATTTCTGTGCCAGCAGCGTATCACCCCTCAGGGTGGACGGTTACGAGCAGTACTTCGGGCCG	CASSVSPLRVDGYEQYF	5
CCCTGAAGACAGCAGCATATATCTCTGCAGCGTTGTGGAGGTCGTGCAGAGGTTTCACCGCGGCAATGAGCAGTTCTTCGGGCCA	CSVVEVVQRFHRGNEQFF	1
GACTCGGCCGTGTATGTCTGTGCCAGCAGCAAGGGGGCGTATAATTCACCCCTCCACTTTGGGAAC	CASSKGAYNSPLHF	2
CCTCCCAGACATCTGTGTACTTGTGTGCCAGCAGTCCTACCCAGGGGGACACTGAAGCTTTCTTTGGACAA	CASSPTQGDTEAFF	2
GACTCGGCCGTGTATGTCTGTGCCAGCAGCTCGAGGGGGGTCTACACAGATACGCAGTATTTTGGCCCA	CASSSRGVYTDTQYF	2
AGCTTGGTGACTCTGCTGTGTATTTCTGTGCCAGCAGCCCCGGGACCGCCTGGCAGTTCTTCGGGCCA	CASSPGTAWQFF	9
CGACTCGGCYGTGTATSTCTGTGCCAGCAGCTCCAGAGGCCTGGATTTTGCAACTAATGAAAAACTGTTTTTTGGCAGT	CASSSRGLDFATNEKLFF	4
CRRRRGACTCAGCCSTGTATCTCTRCGCCAGTGGAGCCCCGGGTCGGGGGACCCAAGAGACCCAGTACTTCGGGCCA	XASGAPGRGTQETQYF	6
GACTCGGCCGTGTATGTCTGTGCCAGCAACAAAACAGGGGGTCGGTAACTATGGCTACACCTTCGGTTCG		6
CCCTGAAGACAGCAGCATATATCTCTGCAGCGTTGAAGCAGGTAATGAAGGCTACACCTTCGGTTCG	CSVEAGNEGYTF	1
CCCAACCAGACAGCTCTTTACTTCTGTGCCAGCAGTTGACATCCCGGGACAGGGACCACTGAAGCTTTCTTTGGACAA	CASS*HPGTGTTEAFF	1
CAAAAGAACCCGACAGCTTTCTATCTCTGTGCCAGCCTTAAAAGCGGGAGGAACAATGAGCAGTTCTTCGGGCCA	CASLKSGRNNEQFF	10
TTCTCAGTGACTCTGGCTTCTATCTCTGTGCCTGGAACCCTTCGGGGGGAACAGATACGCAGTATTTTGGCCCA	CAWNPSGGTDTQYF	4
ATCCTGAAGACAGCAGCTTCTACATCTGCAGTGCTAGAGAACCGGGACTCATAGAAAATTTTGGCCCA	CSAREPGLIENF	3
CCTCCCAGACATCTGTGTACTTGTGTGCCATCAGTGAGTCAATGGACAGGGGCCACGAGCAGTACTTCGGGCCG	CAISESMDRGHEQYF	1
CCTCCCAGACATCTGTGTACTTGTGTGCCATCTCCTCGACAGGGGCCACTGAAGCTTTCTTTGGACAA	CAISSTGATEAFF	6
CCTCCCAGACATCTGTGTACTTGTGTGCCAGCCAAAGAGGGGTAGGATCACCCCTCCACTTTGGGAAC	CASQRGVGSPLHF	1
CAGAAGACTCAGCCCTGTATCTCTGCGCCAGCAGCCAACCAGGGCACTCCTACGAGCAGTACTTCGGGCCG	CASSQPGHSYEQYF	6
TSRGGGACTCAGCTKTGTAYTTCTGTGCCAGCAGGAGGGGACAGGGGACAGATACGCAGTATTTTGGCCCA	CASRRGQGTDTQYF	6
GACTCGGCCGTGTATGTCTGTGCCAGCAGCTCAGCGTCCACGGACAGAGGGCACAGATACGCAGTATTTTGGCCCA		4
TGGGGGACTCAGCTTTGTATTTCTGTGCCAGCAGTCCCAGAACAAACACGGGGACCGGGGAGCTGTTTTTTGGAGAA	CASSPRTNTGTGELFF	3
CCCAACCAGACAGCTCTTTACTTCTGTGCCACTAAACCGGGACTAGCGGGAGTAGCCACAGATACGCAGTATTTTGGCCCA	CATKPGLAGVATDTQYF	10
CAAAAGAACCCGACAGCTTTCTATCTCTGTGCCAGTAGTATCCTAGCGGGAGTGGGAGAGCAGTACTTCGGGCCG	CASSILAGVGEQYF	4
GACTCGGCCGTGTATGTCTGTGCCAGCAGTCGGACATATTATAGCAATCAGCCCCAGCATTTTGGTGAT	CASSRTYYSNQPQHF	1
TCAGGAGACACAGCACGGTATTTCTGTGCCAGCAGCCGGGGACCCACACGACTATGAACACTGAAGCTTTCTTTGGACAA		1
GACTCGGCCGTGTATGTCTGTGCCAGCAGCTTAGAGGTCTCCGTCTATGGCTACACCTTCGGTTCG	CASSLEVSVYGYTF	4
CAAAAGAACCCGACAGCTTTCTATCTCTGTGCCACACAGGAAAACACTGAAGCTTTCTTTGGACAA	CATQENTEAFF	3
CCCTGAAGACAGCAGCATATATCTCTGCAGCGTTGAGGGGGACAGGCTCTCACCCCTCCACTTTGGGAAC	CSVEGDRLSPLHF	8
GCTCCCAGACATCTGTGTATTTCTGCGCCAGCAGTGAGTCGTCTGGGAACACTGAAGCTTTCTTTGGACAA	CASSESSGNTEAFF	3
CCTCCCAGACATCTGTGTACTTGTGTGCCAGCAGTAGGGGGCCTGGCTATGGCTACACCTTCGGTTCG	CASSRGPGYGYTF	1
CCCTGAAGACAGCAGCATATATCTCTGCAGCGTCCGGACAGGGGACACCGGGGAGCTGTTTTTTGGAGAA	CSVRTGDTGELFF	1
GAAGACTCAGCCCTGTATCTCTGCACCAGCAGCCAAGATCTTATCGGGAGCGGGGGGGCGGGCACCGGGGAGCTGTTTTTTGGAGAA	CTSSQDLIGSGGAGTGELFF	30
CACCAACCAGACATCTATGTACCTCTGTGCCAGCAGTCTCGCCTCGACTCCCTACGAGCAGTACTTCGGGCCG	CASSLASTPYEQYF	1
GACTCGGCCGTGTATGTCTGTGCCAGCAGCCGCTCTGGACAGTGGGGTGGCTACACCTTCGGTTCG	CASSRSGQWGGYTF	7
CGAGGAGATTCGGCAGCTTATTTCTGTGCCAGCTCACGGCAAGGAGAGACCCAGTACTTCGGGCCA	CASSRQGETQYF	6
CCCAACCAGACAGCTCTTTACTTCTGTGCCAGCAGTTCCTCCCGCAGAGACAGCGCCACTGAAGCTTTCTTTGGACAA	CASSSSRRDSATEAFF	20
CCCAACCAGACAGCTCTTTACTTCTGTGCCACAGAAGGGGACAGCTATCAGCCCCAGCATTTTGGTGAT	CATEGDSYQPQHF	8
CACCAACCAGACATCTATGTACCTCTGTGCCAGCAGTTTAAGGGACAGAGTCTCTTTCTACCTACGAGCAGTACTTCGGGCCG		5
CCCTGAAGACAGCAGCATATATCTCTGCAGCGTTGCCCATGCGGCAGATACGCAGTATTTTGGCCCA	CSVAHAADTQYF	1
GACTCGGCCGTGTATGTCTGTGCCAGCAGTTTCAGGCTCGGGACTAGCGGTACGGGGACCCAGTACTTCGGGCCA	CASSFRLGTSGTGTQYF	4
GCTCCCAGACATCTGTGTATTTCTGCGCCAGCAGTGCAGGGGGCATGCCTGAAGCTTTCTTTGGACAA	CASSAGGMPEAFF	3
TCAGGAGACACAGCACGGTATTTCTGTGCCAGCAGTCTGGGCGTCCCGGGACTAGCGGACCGAGAAAACATTCAGTACTTCGGCGCC	CASSLGVPGLADRENIQYF	3
ATCCTGAAGACAGCAGCTTCTACATCTGCAGTGCTGTTAAACGCATGAACACTGAAGCTTTCTTTGGACAA	CSAVKRMNTEAFF	1
CCTCCCAGACATCTGTGTACTTGTGTGCCAGCATCCCCTCCGGGACACAGGCCTCTGGAAACACCATATATTTTGGAGAG	CASIPSGTQASGNTIYF	9
CCCTGAAGACAGCAGCATATATCTCTGCAGCGGGACGGGGGGACTAGCGGTGGATACGCAGTATTTTGGCCCA	CSGTGGLAVDTQYF	1
GACTCGGCCGTGTATGTCTGTGCCAGCTCCGGGGGGGCGCGACAAGAGACCCAGTACTTCGGGCCA	CASSGGARQETQYF	4
CACCAACCAGACATCTATGTACCTCTGTGCCAGCAGCCAGGGACTAGGGGGCTACAATGAGCAGTTCTTCGGGCCA	CASSQGLGGYNEQFF	1
CCTCCCAGACATCTGTGTACTTGTGTGCCAGCAGTGTTTACGGACAGCTAGGCACTGAAGCTTTCTTTGGACAA	CASSVYGQLGTEAFF	6
CTCCCTCYCAGACWTCTGTKTACTTSTGTGCCAGCAGTCAAGAGGGGACCGGCGGCTACACCTTCGGTTCG	CASSQEGTGGYTF	21
GCTCCCAGACATCTGTGTATTTCTGCGCCAGCAGCCCTAGCGGGGGGAACACCGGGGAGCTGTTTTTTGGAGAA	CASSPSGGNTGELFF	2
GACTCGGCCGTGTATGTCTGTGCCAGCAGCTTCGGGGGACTAGCTGTGCATACGCAGTATTTTGGCCCA	CASSFGGLAVHTQYF	1
TGGGGGACTCAGCTTTGTATTTCTGTGCCAGCAGTAGATCCGGGACCCAAGAGACCCAGTACTTCGGGCCA	CASSRSGTQETQYF	4
CCTCCCAGACATCTGTGTACTTGTGTGCCAGCAGAAGGGGGGGCGGGGAAATGAGCAGTTCTTCGGGCCA		8
GACTCGGCCGTGTATGTCTGTGCCAGCAACCCAGTGAGCTCTGGGGCCAACGTCCTGACTTTCGGGGCC	CASNPVSSGANVLTF	43
GGACTCGGCCRTGTATSTCTGTGCCAGCAGCTTAATGCGGGGACAGGGGAGATCAGATACGCAGTATTTTGGCCCA	CASSLMRGQGRSDTQYF	2
CCCAACCAGACAGCTCTTTACTTCTGTGCCAGCAGTTTCGGGCGTAGCACTGAAGCTTTCTTTGGACAA	CASSFGRSTEAFF	1
AAGRAGACWCRGCWSYGTATCTCTGCGCCAGCAGCCGAGGGGGCAACTAATGAAAAACTGTTTTTTGGCAGT		21
CCTCCCAGACATCTGTGTACTTGTGTGCCATCAGTGACCTCGCCTACGAGCAGTACTTCGGGCCG	CAISDLAYEQYF	1
GAGACACGGCACTGTATCTCTGCGCCAGCAGCCAACTGGGAGCGCAGCCCCAGCATTTTGGTGAT	CASSQLGAQPQHF	5
TGYWCCCTCTCAGACWTCTGTKTACTTCTGTGCCAGCTGGGGGGCCGGGGAGCTGTTTTTTGGAGAA	CASWGAGELFF	8
AGCTTGGTGACTCTGCTGTGTATTTCTGTGCCAGCAGCCAAGACTGGAAAGGCGGGAGTAGCAGTACTTCGGGCCG		1
TGGGGGACTCAGCTTTGTATTTCTGTGCCAGCAGCGTTAGCCCGGAGCCCCAAGAGACCCAGTACTTCGGGCCA	CASSVSPEPQETQYF	19
GAGRGACWCRGCMSTGTATCTCTRCGCCAGCAGCCAAGATTGGAGGGCTGCTCATCAGCCCCAGCATTTTGGTGAT	XASSQDWRAAHQPQHF	8
AGCTTGGTGACTCTGCTGTGTATTTCTGTGCCAGCAGCTTCCTACAGGGTGGGGGAGCTGAAGCTTTCTTTGGACAA	CASSFLQGGGAEAFF	2
GCTCCCAGACATCTGTGTATTTCTGCGCCAGCAGTCCCAGGGATAGAAACACCATATATTTTGGAGAG	CASSPRDRNTIYF	1
CCCAACCAGACAGCTCTTTACTTCTGTGCCAGCACCTCGGGGACAGGCGACACTGAAGCTTTCTTTGGACAA	CASTSGTGDTEAFF	3
CCCTGAAGACAGCAGCATATATCTCTGCAGCGTCGCAAGAGGGGGGGGTGAAAAACTGTTTTTTGGCAGT	CSVARGGGEKLFF	4
CGAGGAGATTCGGCAGCTTATTTCTGTGCCAGCTCCCCGACGGCTACCCTGGGTACGCTTCGATCGGGCGAGCAGTACTTCGGGCCG	CASSPTATLGTLRSGEQYF	1
CGAGGAGATTCGGCAGCTTATTTCTGTGCCAGCTCACCACCGCCGAACAGATTCACCGGGGAGCTGTTTTTTGGAGAA	CASSPPPNRFTGELFF	5
GGACTCGGCCSTSTATSTCTGTGCCAGCAGCCACCGCGGACAGGGGGCTGGAGATACGCAGTATTTTGGCCCA	CASSHRGQGAGDTQYF	2
GACGCAGCCATGTACCTGTGTGCCACCAGCAGAGATACGGGTGATGGGGAGCAGTTCTTCGGGCCA	CATSRDTGDGEQFF	7
AGCTTGGTGACTCTGCTGTGTATTTCTGTGCCAGCAGCCCCCGGGACAGGGATCGACACCGGGGAGCTGTTTTTTGGAGAA		8
CAGGGACTCAGCTGTGTACTTCTGTGCCAGCAGTTGGGACAGGGCATCAACTGGAAACACCATATATTTTGGAGAG	CASSWDRASTGNTIYF	5
CCCWGAAGACWSMRSCMTRTATCTCTGCGCCAGCAGCCAAGTAGCCAGTCAAAACTATGGCTACACCTTCGGTTCG	CASSQVASQNYGYTF	1
CGACTCGGCYGTGTATSTCTGTGCCAGCAGCCCTTACGACAGGGCCGCTGAAGCTTTCTTTGGACAA	CASSPYDRAAEAFF	2
CCCAACCAGACAGCTCTTTACTTCTGTGCCACCAGTGCCAGGGGGGGTCAGCCCCAGCATTTTGGTGAT	CATSARGGQPQHF	1
ATCCTGAAGACAGCAGCTTCTACATCTGCAGTGCTAGGGAGGGGCAGGGTGGTATTAGACGCGGCTACACCTTCGGTTCG	CSAREGQGGIRRGYTF	3
GACTCGGCCGTGTATGTCTGTGCCAGCAGCTTAGTAGGGGCGACAGGGGGATTCCAGCCCCAGCATTTTGGTGAT	CASSLVGATGGFQPQHF	6
CAAAAGAACCCGACAGCTTTCTATCTCTGTGCCAGTAGCCCCCAAAGAGGGAGTCAGCATGAAAAACTGTTTTTTGGCAGT	CASSPQRGSQHEKLFF	50
GACTCGGCCGTGTATGTCTGTGCCAGCAGCACTAGGGACAGTTATGCTGGTTACACCTTCGGTTCG	CASSTRDSYAGYTF	5
CTCCCTCYCAGACWTCTGTKTACTTSTGTGCCAGCAGTTACTACGGTGGGAAAGAGACCCAGTACTTCGGGCCA	CASSYYGGKETQYF	8
CTCCCTCTCAGACTTCTGTTTACTTCTGTGCTCCAGCGGGTCTGGGGGAATCAGCCCCAGCATTTTGGTGAT		5
TYRGGRGACWCAGCWYKGTATTTCTGTGCCAGCAGCGTAGATCTAGCGGGAGGTAGAGATACGCAGTATTTTGGCCCA	CASSVDLAGGRDTQYF	7
CCTCCCAGACATCTGTGTACTTGTGTGCCATCAGTATGGACGTGAATTCACCCCTCCACTTTGGGAAC	CAISMDVNSPLHF	11
GCTCCCAGACATCTGTGTATTTCTGCGCCAGCAGTGACCCCCCCCGGACAGGGGGCATTAGCGGCACTGAAGCTTTCTTTGGACAA	CASSDPPRTGGISGTEAFF	1
GACTCGGCCGTGTATGTCTGTGCCAGCAGCTGGTGGACAGGTTCCCCCTACGAGCAGTACTTCGGGCCG	CASSWWTGSPYEQYF	1
TGGGGGACTCAGCTTTGTATTTCTGTGCCAGCAGAGAGCCCGGACAGGGCTACGAGCAGTACTTCGGGCCG	CASREPGQGYEQYF	6
CGAGGAGATTCGGCAGCTTATTTCTGTGCCAGCTCACCACGGACAGCTTACGAGCAGTACTTCGGGCCG	CASSPRTAYEQYF	1
CAAAAGAACCCGACAGCTTTCTATCTCTGTGCCAGTAGTGTCGACAGGGGGACTGAAGCTTTCTTTGGACAA	CASSVDRGTEAFF	1
ATCCTGAAGACAGCAGCTTCTACATCTGCAGTGCTAGATATGTAGGGGAGGGTCGCTACAATGAGCAGTTCTTCGGGCCA	CSARYVGEGRYNEQFF	1
CCTCCCAGACATCTGTGTACTTGTGTGCCAGCAGTAGTGTGGGGGGCTCCCATAATTCACCCCTCCACTTTGGGAAC	CASSSVGGSHNSPLHF	1
AAGAACCCGACAGCTTTCTATCTCTGTGCCAGTAGTATCCGGACTAGCGGGGGGGCAATGAGTATAGATACGCAGTATTTTGGCCCA	CASSIRTSGGAMSIDTQYF	2
GACTCGGCCGTGTATGTCTGTGCCAGCAGCACGTTGACAGGGACCTTGGATGGCTACACCTTCGGTTCG	CASSTLTGTLDGYTF	2
CCTCCTCCCAGACATCTGTATATTTCTGCGCCAGCGGGTCGGGAGATACGCAGTATTTTGGCCCA	CASGSGDTQYF	5
GACTCGGCCGTGTATGTCTGTGCCAGCAGCCCAAGAGGACAGGGAGGGTTCACTGAAGCTTTCTTTGGACAA	CASSPRGQGGFTEAFF	1
AAAAGAACCCGACAGCTTTCTATCTCTGTGCCAGTATCCATGGAGGAGGACAGGGACTGGGCTAATGAAAAACTGTTTTTTGGCAGT		2
AACCCAGGGACTCAGCTGTGTATTTTTGTGCCAGCAGTTTTACTAGCGGGGGGATCCAAGAGACCCAGTACTTCGGGCCA	CASSFTSGGIQETQYF	1
CCCAACCAGACAGCTCTTTACTTCTGTGCCAGCAGTCCAGACAGGTACTATGGCTACACCTTCGGTTCG	CASSPDRYYGYTF	1
AACCCAGGGACTCAGCTGTGTATTTTTGTGCCAGCAGTTACGTTTCAGATACGCAGTATTTTGGCCCA	CASSYVSDTQYF	3
CGAGGAGATTCGGCAGCTTATTTCTGTGCCAGCTCAAAGAAGCACTTTTAACACTGAAGCTTTCTTTGGACAA		1
AGCTTGGTGACTCTGCTGTGTATTTCTGTGCCAGCAGCCGGCAGGGCGTATCAACTAATGAAAAACTGTTTTTTGGCAGT	CASSRQGVSTNEKLFF	1
AACCCAGGGACTCAGCTGTGTATTTTTGTGCTAGTGGTTTGCCGGACGGAACACTGAAGCTTTCTTTGGACAA		3
CAAAAGAACCCGACAGCTTTCTATCTCTGTGCCAGTAAGACAGACTGGAGTTTAGGGTGGCAGTATTTTGGCCCA	CASKTDWSLGWQYF	8
CCTCCCAGACATCTGTGTACTTGTGTGCCAGCAGTGTGCAGGGAGGAGATACGCAGTATTTTGGCCCA	CASSVQGGDTQYF	2
GACTCGGCCGTGTATGTCTGTGCCAGCACCCATGGACAGGCCATGAACACTGAAGCTTTCTTTGGACAA	CASTHGQAMNTEAFF	1
GACTCGGCCGTGTATGTCTGTGCCAGCAGCTTGGCTTTCTCCTACAATGAGCAGTTCTTCGGGCCA	CASSLAFSYNEQFF	5
GAGGGACTCAGCCGTGTATCTCTACGCCAGCAGCCAAGACCCAGGGTGAACACCGGGGAGCTGTTTTTTGGAGAA		2
GACTCGGCCGTGTATGTCTGTGCCAGCAGCTTAGTAATTGGGGGTGACCACCAAAGCAATCAGCCTCAGCATTTTGGTGAT	CASSLVIGGDHQSNQPQHF	4
AGCTTGGTGACTCTGCTGTGTATTTCTGTGCCGGCTTAACAGCTGGAAACACCATATATTTTGGAGAG	CAGLTAGNTIYF	1
CCTCCCAGACATCTGTGTACTTGTGTGCCAGCAGTTACTTGGGAGAGCCGTCCGAAAAACTGTTTTTTGGCAGT	CASSYLGEPSEKLFF	11
CACCAACCAGACATCTATGTACCTCTGTGCCAGCAGTTTAACCGGGGATGGCTACACCTTCGGTTCG	CASSLTGDGYTF	5
CCTCCCAGACATCTGTGTACTTGTGTGCCAGCAGGCCCGGACAGACCACTGAAGCTTTCTTTGGACAA	CASRPGQTTEAFF	2
CCTCCCAGACATCTGTGTACTTGTGTGCCAGCAGAGCGGGACGGACCCCCCCTACCGAGCAGTACTTCGGGCCG	CASRAGRTPPTEQYF	29
GCCACGTTTGGTGCCAGAAGACTCAGCCTGTATCTCTGCGCCAGCAGCCATTCATCCGGGTCCTCAGATACGCAGTATTTTGGCCCA	CASSHSSGSSDTQYF	1
GGACTCGGCCCTTTATCTTTGCGCCAGCAGCTTGGGGGACGAGCGGGAGGGAGCAGATACGCAGTATTTTGGCCCA	CASSLGDEREGADTQYF	4
CCTCCCAGACATCTGTGTACTTGTGTGCCAGCAGCAGACAGGGTGGTATGGCTGAAGCTTTCTTTGGACAA	CASSRQGGMAEAFF	1
CAAAAGAACCCGACAGCTTTCTATCTCTGTGCCAGTAGGACAGGGAACGGAGACAATCAGCCCCAGCATTTTGGTGAT	CASRTGNGDNQPQHF	2
GGACTCGGCCCTTTATCTTTGCGCCAGCAGCCGAACGAGAACAGGGGGAAGGGGGAGTGAAAAACTGTTTTTTGGCAGT	CASSRTRTGGRGSEKLFF	1
GGACTCGGCCMTSTATCKCTGTGCCAGCACCGCAGGTATGGCCAAAAACATTCAGTACTTCGGCGCC	CASTAGMAKNIQYF	1
GACTCGGCCGTGTATGTCTGTGCCAGCAGCTCACAGGGGATACCAACTAATGAAAAACTGTTTTTTGGCAGT	CASSSQGIPTNEKLFF	1
GACTCGGCCGTGTATGTCTGTGCCAGCAGCCCACCCCGGGGGGGGAACTATGGCTACACCTTCGGTTCG	CASSPPRGGNYGYTF	1
GGACTCGGCCSTSTATSTCTGTGCCAGCAGCTTAGGGGTAGGGGGAAACACCATATATTTTGGAGAG	CASSLGVGGNTIYF	3
ATCCTGAAGACAGCAGCTTCTACATCTGCAGTGCTAACAGGAAACCTTATGGCTACACCTTCGGTTCG	CSANRKPYGYTF	1
GACTCGGCCGTGTATGTCTGTGCCAGCAGCTCGGGACAGGGGGCGTACACCGGGGAGCTGTTTTTTGGAGAA	CASSSGQGAYTGELFF	19
AACCCAGGGACTCAGCTGTGTATTTTTGTGCCAGCAGTTTACAGGGGGTAGGCTACACCTTCGGTTCG	CASSLQGVGYTF	7
CCTCCCAGACATCTGTGTACTTGTGTGCCATCAGTGAGTCGGGCAGGGCGAACACTGAAGCTTTCTTTGGACAA	CAISESGRANTEAFF	1
CAAAAGAACCCGACAGCTTTCTATCTCTGTGCCAGTAATAGACAGGGCGGGGGCACTGAAGCTTTCTTTGGACAA	CASNRQGGGTEAFF	13
AACCCAGGGACTCAGCTGTGTAYTTYTGTGCCAGCAGTCAACAGGGAGCCATGAACACTGAAGCTTTCTTTGGACAA	CASSQQGAMNTEAFF	2
GACTCGGCCGTGTATGTCTGTGCCAGCAGCACGACTGCAACTAATGAAAAACTGTTTTTTGGCAGT	CASSTTATNEKLFF	7
CAAAAGAACCCGACAGCTTTCTATCTCTGTGCCAGTAGACGGGACTTTGCAACTAATGAAAAACTGTTTTTTGGCAGT	CASRRDFATNEKLFF	9
GACTCGGCCGTGTATGTCTGTGCCAGCAGCACCACGACTCGGGCGAGGGCTGAAGCTTTCTTTGGACAA	CASSTTTRARAEAFF	2
CCTCCCAGACATCTGTGTACTTGTGTGYCACCATGACTAGCGGGAGGGCAGATACGCAGTATTTTGGCCCA	CXTMTSGRADTQYF	8
CCTCACATACCTCTCAGTACCTCTGTGCCAGCAGTGAAGGTGGGGGAGGGAGGGCCAACGAGCAGTACTTCGGGCCG	CASSEGGGGRANEQYF	1
CAAAAGAACCCGACAGCTTTCTATCTCTGTGCCAGTAGTATAGGGGCTAGCGGGAGCATGACTGAGCAGTTCTTCGGGCCA	CASSIGASGSMTEQFF	4
GAGACACGGCACTGTATCTCTGCGCCAGCAGTCACTTCAGGGCCCTCGGACGAGCAATACTTCGGGCCG		3
GACTCGGCCGTGTATGTCTGTGCCAGCAACGAAAACAGGGAAGCCTACGAGCAGTACTTCGGGCCG	CASNENREAYEQYF	8
ATCCTGAAGACAGCAGCTTCTACATCTGCAGTGCTAGTTCGGGGGGCGGCGAGCAGTACTTCGGGCCG	CSASSGGGEQYF	1
ATCCTGAAGACAGCAGCTTCTACATCTGCAGTGCTAGAGATCCACGGGTTCCCGGGGAGCTGTTTTTTGGAGAA	CSARDPRVPGELFF	2
CCTCCCAGACATCTGTGTACTTGTGTGCCAGCAGGCAACAGCTAACTATGGCTACACCTTCGGTTCG		5
CAAAAGAACCCGACAGCTTTCTATCTCTGTGCCAGTAGTAACCACAGGGAGACAGATACGCAGTATTTTGGCCCA	CASSNHRETDTQYF	8
CCTCCCAGACATCTGTGTACTTGTGTGCCATCAGTGGGACCTTAGGCACAGATACGCAGTATTTTGGCCCA	CAISGTLGTDTQYF	9
TTCTCAGTGACTCTGGCTTCTATCTCTGTGCCTGGCCCCCCCGTCGGGGAGCTGTTTTTTGGAGAA		1
AGCTYRGKGACTCWGCTGTGTAYTTCTGTGCCAGCAGAGGACAGTCTAGTTCGTTATAGCAATCAGCCCCAGCATTTTGGTGAT		6
AGCTTGGTGACTCTGCTGTGTATTTCTGTGCCAGCAGCCAAAACAGGGGGTGCCTACGAGCAGTACTTCGGGCCG		1
CAAAAGAACCCGACAGCTTTCTATCTCTGTGCCAGTAGTATCCCGGGGGCCCTTGCAACTAATGAAAAACTGTTTTTTGGCAGT	CASSIPGALATNEKLFF	4
CAGAAGACTCAGCCCTGTATCTCTGCGCCAGCAGCCAAGATTTGAGGAGGGCATCGGGGTGGGCTAGCCCCAGCATTTTGGTGAT		1
CAGCTTTCTATCTCTGTGCCAGTAGTATTGGACCCACGGGACAGGGGTTCTCCTCCTACAATGAGCAGTTCTTCGGGCCA	CASSIGPTGQGFSSYNEQFF	1
CGAGGAGATTCGGCAGCTTATTTCTGTGCCAGCTCACCCAGACAGGGGAGGAACACTGAAGCTTTCTTTGGACAA	CASSPRQGRNTEAFF	22
AACCCAGGGACTCAGCTGTGTAYTTYTGTGCCAGCAGTGCTCGTGGCGCGGGGGGAGGGACCCAGTACTTCGGGCCA	CASSARGAGGGTQYF	7
AACYSRGGGACTCAGCTKTGTATTTYTGTGCCAGCGGCAGACGGAATACTAGGGGACAGATACGCAGTATTTTGGCCCA		3
CACCAACCAGACATCTATGTACCTCTGTGCCAGCAGTCCATGGCGGGGAAACCTCGAACACCGGGGAGCTGTTTTTTGGAGAA		5
CCCAACCAGACAGCTCTTTACTTCTGTGCCAGCAGTTATGGGAGCGGGATGGGGGTGGAGACCCAGTACTTCGGGCCA	CASSYGSGMGVETQYF	9
GACTCGGCCGTGTATGTCTGTGCCAGCAGCTTGTATAGCGGCTACTACAATGAGCAGTTCTTCGGGCCA	CASSLYSGYYNEQFF	6
AGCTTGGTGACTCTGCTGTGTATTTCTGTGCCAGCAGCCAAGATAGTGGGGGAAATAACTATGGCTACACCTTCGGTTCG	CASSQDSGGNNYGYTF	13
GACTCGGCCGTGTATGTCTGTGCCAGCAGCTTCGGTCGGGGCCAGAACACCGGGGAGCTGTTTTTTGGAGAA	CASSFGRGQNTGELFF	3
CAGGGACTCAGCTGTGTACTTCTGTGCCAGCAGACAAAAACCGGGACAGGGAAACACTGAAGCTTTCTTTGGACAA	CASRQKPGQGNTEAFF	5
