nucleotide	aminoAcid	estimatedNumberGenomes
TCCACTCTGACAGTGACCAGTGCCCATCCTGAAGACAGCAGCTTCTACATCTGCAGTGCTCCGCGGGGGAGGCAGTTCTTCGGGCCA	CSAPRGRQFF	1
GGAGTCAGGGGACACAGCACTGTATTTCTGTGCCAGCAGCAAACAAAGGGACAGGGGGTGCGGGTCAATGAGCAGTTCTTCGGGCCA		3
TCTCAGACATCTGTGTACTTCTGTGCCAGCAGTGACTGCTGACTAGCGGGGGAATACTCTGGGGCCAACGTCCTGACTTTCGGGGCC	CASSDC*LAGEYSGANVLTF	1
ACCTTGGAGCTGGGGGACTCGGCCCTTTATCTTTGCGCCAGCAGCCCGACTCCGGGACAGGGAGGTGAAAAACTGTTTTTTGGCAGT	CASSPTPGQGGEKLFF	1
CGGTCCACAAAGCTGGAGGACTCAGCCATGTACTTCTGTGCCAGCAGTGGGATCCCGTACAGGAATAGAGGCTACACCTTCGGTTCG	CASSGIPYRNRGYTF	1
TGCCTCCTCCCAGACATCTGTATATTTCTGCGCCAGTTACAGCCCCGGACTAGCGGGAATTGCATCGGGGAGCTGTTTTTTGGAGAA		1
CACACCCTGCAGCCAGAAGACTCGGCCCTGTATCTCTGTGCCAGCAGCCAAGCCGGGACAGCTAATTCACCCCTCCACTTTGGGAAC	CASSQAGTANSPLHF	1
CAGCGCACAGAGCAGGGGGACTCGGCCATGTATCTCTGTGCCAGCAGCTTAACTAGCGGGGTCAGGGACGAGCAGTACTTCGGGCCG	CASSLTSGVRDEQYF	1
TCGCTCAGGCTGGAGTCGGCTGCTCCCTCCCAGACATCTGTGTACTTCTGTGCCAGCAGGGCGGCCAACGTCCTGACTTTCGGGGCC	CASRAANVLTF	1
AGTGACTCTGGCTTCTATCTCTGTGCCTGGAGTGTACGACTCGGGGTAGCGGGAGGACCAGTCCAAGAGACCCAGTACTTCGGGCCA	CAWSVRLGVAGGPVQETQYF	1
GTGAACGCCTTGTTGCTGGGGGACTCGGCCCTCTATCTCTGTGCCAGCAACCCCCAGGGACTAGTGGGGGTTCAGTACTTCGGCGCC	CASNPQGLVGVQYF	1
CACACCCTGCAGCCAGAAGACTCGGCCCTGTATCTCTGCGCCAGCAGCCAAGGAGTAGGGGAAGGCTATGGCTACACCTTCGGTTCG	CASSQGVGEGYGYTF	1
CTGGAGTTGGCTGCTCCCTCCCAGACATCTGTGTACTTCTGTGCCAGCAGTTACCAGGACCGCACAGATACGCAGTATTTTGGCCCA	CASSYQDRTDTQYF	1
GTGAGCACCTTGGAGCTGGGGGACTCGGCCCTTTATCTTTGCGCCAGCAGCTTTCAGAGCGGGGGCTACGAGCAGTACTTCGGGCCG	CASSFQSGGYEQYF	3
AAGATCCGGTCCACAAAGCTGGAGGACTCAGCCATGTACTTCTGTGCCAGCGTCAGAGGGCTTCATTCACCCCTCCACTTTGGGAAC	CASVRGLHSPLHF	1
CAGGTAGTGCGAGGAGATTCGGCAGCTTATTTCTGTGCCAGCTCACCCGGACAGCGGACATCCGGAAACACCATATATTTTGGAGAG	CASSPGQRTSGNTIYF	1
ACCCTGCAGCCAGAAGACTCGGCCCTGTATCTCTGTGCCAGCAGCCAAGAGTTGATGGGACAGCTCTATGGCTACACCTTCGGTTCG	CASSQELMGQLYGYTF	1
ACTCTGAAGATCCAGCCCTCAGAACCCAGGGACTCAGCTGTGTACTTCTGTGCCAGCAGTTCGGAAGAGACCCAGTACTTCGGGCCA	CASSSEETQYF	1
AACCTGAGCTCTCTGGAGCTGGGGGACTCAGCTTTGTATTTCTGTGCCAGTGCACAGGGGGCGGGAGATACGCAGTATTTTGGCCCA	CASAQGAGDTQYF	1
CTGGAGTCCGCCAGCACCAACCAGACATCTATGTACCTCTGTGCCAGCAGGCCTACGGGGGTTACTCATGGCTACACCTTCGGTTCG	CASRPTGVTHGYTF	1
ATCCAGCGCACACAGCAGGAGGACTCGGCCGTGTATCTCTGTGCCAGCAGCTCCGACAGGGGTAACTATGGCTACACCTTCGGTTCG	CASSSDRGNYGYTF	1
ATCCAGCCCTCAGAACCCAGGGACTCAGCTGTGTACTTCTGTGCCAGCACCAAAGGGGACGGGTCCTACGAGCAGTACTTCGGGCCG	CASTKGDGSYEQYF	1
CTGACGATCCAGCGCACAGAGCAGCGGGACTCGGCCATGTATCGCTGTGCCAGCAGCTCACAGGGTCTCGAGCAGTACTTCGGGCCG	CASSSQGLEQYF	1
CAGCCCTCAGAACCCAGGGACTCAGCTGTGTACTTCTGTGCCAGCAGTCTGGGGGGGGGCGGGAATTCACCCCTCCACTTTGGGAAC	CASSLGGGGNSPLHF	1
GCCCTGCAGCCAGAAGACTCAGCCCTGTATCTCTGCGCCAGCAGCCCTCCAGCGGGAGTGAGAGGCGATGAGCAGTTCTTCGGGCCA	CASSPPAGVRGDEQFF	1
CCTGGAGCTTGGTGACTCTGCTGTGTATTTCTGTGCCAGCAGCCAAGAACATCGGGACACCGAAATCAGCCCCAGCATTTTGGTGAT		1
CTGTCGGCTGCTCCCTCCCAGACATCTGTGTACTTCTGTGCCAGCTGCTCCCAGGCAGGTTTATGCTACGAGCAGTACTTCGGGCCG	CASCSQAGLCYEQYF	1
CCAGACCTCTCTGTACTTCTGTGCCAGCAGTTACCCAAGGTGAGTAGCGGGGGCATTACCTCCTACAATGAGCAGTTCTTCGGGCCA		1
TCGGCCCAAAAGAACCCGACAGCTTTCTATCTCTGTGCCAGTAGTTCAAGGGGCCCGAAGCGGAATCAGCCCCAGCATTTTGGTGAT	CASSSRGPKRNQPQHF	1
TTCTGGAGTCCGCCAGCACCAACCAGACATCTATGTACCTCTGTGCCAGCGCGGGGGGGGGCCCTGCGGGAGCAGTACTTCGGGCCG		3
AAGATCCGGTCCACAAAGCTGGAGGACTCAGCCATGTACTTCTGTGCCAGCAGTGAAGGGATGCAAGAGACCCAGTACTTCGGGCCA	CASSEGMQETQYF	1
ACTGTGAGCAACATGAGCCCTGAAGACAGCAGCATATATCTCTGCAGCGCTAAAGAGGCCCCTGAGCGGACCCAGTACTTCGGGCCA	CSAKEAPERTQYF	1
TTCACTCTGAAGATCCGGTCCACAAAGCTGGAGGACTCAGCCATGTACTTCTGTGCCAGCAGTGAACAGGGGACTTTCTTTGGACAA	CASSEQGTFF	1
CAATTCCCTGGAGCTTGGTGACTCTGCTGTGTATTTCTGTGCCAGCAGCCAAGATCACTAGCGCCCGGGGAGCTGTTTTTTGGAGAA		3
CTGAGCTCTCTGGAGCTGGGGGACTCAGCTTTGTATTTCTGTGCCAGCAGCGGTAGACAGGGCTCAACTGAAGCTTTCTTTGGACAA	CASSGRQGSTEAFF	1
AGCACCTTGGAGCTGAGGGACTCGGCCCTTTATCTTTGCGCCAGCAGCTTGAAGCAGGGGACCTACAATGAGCAGTTCTTCGGGCCA	CASSLKQGTYNEQFF	1
AGCACCTTGGAGCTGGGGGACTCGGCCCTTTATCTTTGCGCCAGCAGCTTGGGACAGACGAGCACCGGGGAGCTGTTTTTTGGAGAA	CASSLGQTSTGELFF	1
AATGTGAACGCCTTGTTGCTGGGGGACTCGGCCCTCTATCTCTGTGCCAGCAGCTTGGCGGGCGGGGAGACCCAGTACTTCGGGCCA	CASSLAGGETQYF	1
AGATCCAGCGCACAGAGCAGGGGGACTCAGCCGCGTATCTCCGTGCCAGCAGCTTAAATTCATGCCAAGCCCCAGCATTTTGGTGAT		2
CAGCAGGTAGTGCGAGGAGATTCGGCAGCTTATTTCTGTGCCAGCTCACTTCTCAGCTCGAATGTGGAAAAACTGTTTTTTGGCAGT	CASSLLSSNVEKLFF	1
ATCCTGAGTTCTAAGAAGCTCCTTCTCAGTGACTCTGGCTTCTATCTCTGTGCCTGGACCTTGGGGGAAGAGCAGTTCTTCGGGCCA	CAWTLGEEQFF	1
TGACATCGGCCCAAAAGAACCCGACAGCTTTCTATCTCTGTGCCACCATGGGACGGAACGGTCAATCAGCCCCAGCATTTTGGTGAT		1
GCCCTGCAGCCAGAAGACTCAGCCCTGTATCTCTGCGCCAGCAGCCAAGCGACTTCGGTGGGCAATCAGCCCCAGCATTTTGGTGAT	CASSQATSVGNQPQHF	1
GAGTCGGCTGCTCCCTCCCAAACATCTGTGTACTTCTGTGCCAGCAGTTCCGACAGGGGTTATAATTCACCCCTCCACTTTGGGAAC	CASSSDRGYNSPLHF	1
GTGAGCACCTTGGAGCTGGGGGACTCGGCCCTTTATCTTTGCGCCAGCGGCTATTCAGTGGAAGGAAGTGGCTACACCTTCGGTTCG	CASGYSVEGSGYTF	5
AAGATCCGGTCCACAAAGCTGGAGGACTCAGCCATGTACTTCTGTGCCAGCAGTGAAACTGGGGCCAACGTCCTGACTTTCGGGGCC	CASSETGANVLTF	1
AAGATCCAACCTGCAAAGCTTGAGGACTCGGCCGTGTATCTCTGTGCCAGCAGCTTACAAACAGCTTACGAAGCTTTCTTTGGACAA	CASSLQTAYEAFF	2
AATGTGAGCACCTTGGAGCTGGGGGACTCGGCCCTTTATCTTTGCGCCAGCAGCCCGACGATCAGGAATGAGCAGTTCTTCGGGCCA	CASSPTIRNEQFF	1
ACAGTGACCAGTGCCCATCCTGAAGACAGCAGCTTCTACATCTGCAGTGCGGCACAGAATACGCCAGATACGCAGTATTTTGGCCCA	CSAAQNTPDTQYF	1
ACTCTGACAGTGACCAGTGCCCATCCTGAAGGCAGCAGCTTCTACATCTGCAGTGCTAGAGATACAAGGGAGCAGTTCTTCGGGCCA	CSARDTREQFF	1
ATCCAGCAGGTAGTGCGAGGAGATTCGGCAGCTTATTTCTGTGCCAGCTCACCAGGGGAGGGCAATCAGCCCCAGCATTTTGGTGAT	CASSPGEGNQPQHF	1
GTCGGCTGCTCCCTCCCAGACATCTGTGTACTTCTGTGCCAGCAGTCTGGGGGGGGTGACTCCTACAATGAGCAGTTCTTCGGGCCA		1
ACCAGTGCCCATCCTGAAGACAGCAGCTTCTACATCTGCAGTGCTAGAGATACGACTAGCGGGAGATACGAGCAGTACTTCGGGCCG	CSARDTTSGRYEQYF	3
CTGGAGTCTGCCAGGCCCTCACATACCTCTCAGTACCTCTGTGCCAGCAGTGAATTCACCGGGAATTATGGCTACACCTTCGGTTCG	CASSEFTGNYGYTF	1
ATTCTGGAGTCCGCCAGCACCAACCAGACATCTATGTACCTCTGTGCCAGCACCGACGGGACTAGCATTGCGCAGTTCTTCGGGCCA	CASTDGTSIAQFF	1
CTGGAGTCTGCCAGGCCCTCACATACCTCTCAGTACCTCTGTGCCAGCAGTGAGGCGGGGAGAGGGACTGAAGCTTTCTTTGGACAA	CASSEAGRGTEAFF	1
CAGCCTGCAAAGCTTGAGGACTCGGCCGTGTATCTCTGTGCCAGCAGCCGACAGGGAGCGGGGGCCAACGTCCTGACTTTCGGGGCC	CASSRQGAGANVLTF	1
CGCACAGAGCAGGGGGACTCGGCCATGTATCTCTGTGCCAGCACCGACTAGCGGGCGAAACCTCTTTGGGAGCAGTACTTCGGGCCG	CASTD*RAKPLWEQYF	1
CCAGAAGACTCAGCCCTGTATCTCTGCGCCAGCAGCTTAAGATCCGATCGGCCGGATAGAGCATCGGAGACCCAGTACTTCGGGCCA	CASSLRSDRPDRASETQYF	1
CAGCCCTCAGAACCCAGGGACTCAGCTGTGTACTTCTGTGCCAGCAGTATTAACAGGGCGGGTAACTATGGCTACACCTTCGGTTCG	CASSINRAGNYGYTF	1
ATTCTGGAGTCCGCCAGCACCAACCAGACATCTATGTACCTCTGTGCCAGTCATCTGGGCTCAGGGGCTGAAGCTTTCTTTGGACAA	CASHLGSGAEAFF	1
AGCTCTCTGGAGCTGGGGGACTCAGCTTTGTATTTCTGTGCCAGCAGCTTATACCGTGGGGGTCAAGAGACCCAGTACTTCGGGCCA	CASSLYRGGQETQYF	2
CACCTACACACCCTGCAGCCAGAAGACTCGGCCCTGTATCTCTGTGCCAGCAGCCAAGGGAACGACAATGAGCAGTTCTTCGGGCCA	CASSQGNDNEQFF	1
ACCAGTGCCCATCCTGAAGACAGCAGCTTCTACATCTGCAGTGCTCCCGGGACTAGCTCTTCACTGGGTGAGCAGTTCTTCGGGCCA	CSAPGTSSSLGEQFF	1
TCGGCCCAAAAGAACCCGACAGCTTTCTATCTCTGTGCCAGTAGTATTGGAGGGGACGTCTATCCCGGGGAGCTGTTTTTTGGAGAA	CASSIGGDVYPGELFF	1
GAGTCGGCTGCTCCCTCCCAGACATCTGTGTACTTCTGTGCCAGCAGTGAAGGGGCAGGGGATGGAAACACCATATATTTTGGAGAG	CASSEGAGDGNTIYF	2
ACAGTGACCAGTGCCCATCCTGAAGACAGCAGCTTCTACATCTGCAGTGCTAGAGCCTTCCTGTTGGATGAGCAGTTCTTCGGGCCA	CSARAFLLDEQFF	1
CTGGAGTCCGCTACCAGCTCCCAGACATCTGTGTACTTCTGTGCCACGGGCACAGCGGGAGGGCCCTACGAGCAGTACTTCGGGCCG	CATGTAGGPYEQYF	1
AGCCCCAACCAGACCTCTCTGTACTTCTGTGCCAGCAGTTTAGCCCCACCTTCCTTCTATAGCAATCAGCCCCAGCATTTTGGTGAT	CASSLAPPSFYSNQPQHF	1
GTGACCAGTGCCCATCCTGAAGACAGCAGCTTCTACATCTGCAGTGCTAGGCGACAGGGGGGCCAAGAGACCCAGTACTTCGGGCCA	CSARRQGGQETQYF	1
GCAGAGCTTGGGGACTCGGCCATGTATCTCTGTGCCAGCAGCTCCAGACGGACAGGGTTTAAGAACACTGAAGCTTTCTTTGGACAA	CASSSRRTGFKNTEAFF	1
AAGATCCAGCCCTCAGAACCCAGGGACTCAGCTGTGTACTTCTGTGCCAGCAGTTTTCAGGGAGCGACTGAAGCTTTCTTTGGACAA	CASSFQGATEAFF	1
GACATCCGCTCACCAGGCCTGGGGGACGCAGCCATGTACCTGTGTGCCACCAGTGGCTCAGGGAATCAGCCCCAGCATTTTGGTGAT	CATSGSGNQPQHF	1
CAGCCAGAAGACTCAGCCCTGTATCTCTGCGCCAGCAGCCAGACCGGGACAGGGAAAGCTGGGGCCAACGTCCTGACTTTCGGGGCC	CASSQTGTGKAGANVLTF	1
AGGCTGGAGTTGGCTGCTCCCTCCCAGACATCTGTGTACTTCTGTGCCAGCAGGCGGGGGCCAAATGAAAAACTGTTTTTTGGCAGT	CASRRGPNEKLFF	1
CACATCAATTCCCTGGAGCTTGGTGACTCTGCTGTGTATTTCTGTGCCAGCAGCCCCTCCCTGGGAAACACCATATATTTTGGAGAG	CASSPSLGNTIYF	1
ACAGAGCAGCGGGACTCGGCCATGTATCGCTGTGCCAGCAGCTTAGAGGTATCAAACTCTGGGGCCAACGTCCTGACTTTCGGGGCC	CASSLEVSNSGANVLTF	1
CTGTCGGCTGCTCCCTCCCAGACATCTGTGTACTTCTGTGCCAGCAGTTCGGACAGGCAAGCCAAAAACATTCAGTACTTCGGCGCC	CASSSDRQAKNIQYF	1
CGCACAGAGCAGGGGGACTCGGCCATGTATCTCTGTGCCAGCAGCCCCATGGGCGGGGGGGCCCTAGCCGAGCAGTACTTCGGGCCG	CASSPMGGGALAEQYF	1
CTGACTGTGAGCAACATGAGCCCTGAAGACAGCAGCATATATCTCTGCAGCGTTGGAGAGGAGAGGCAAGGCTACACCTTCGGTTCG	CSVGEERQGYTF	1
GAGTCCGCCAGCACCAACCAGACATCTATGTACCTCTGTGCCAGCAGCCAGACTAAGAGCTCCTACAATGAGCAGTTCTTCGGGCCA	CASSQTKSSYNEQFF	1
ATCCAGCGCACACAGCAGGAGGACTCGGCCGTGTATCTCTGTGCCAGCAGCGCGAGCTCCTATAATGAAAAACTGTTTTTTGGCAGT	CASSASSYNEKLFF	1
GCTGCTCCCTCCCAAACATCTGTGTACTTCTGTGCCAGCAGTTACACACGGGGGCTAGCGGGAAGCAATGAGCAGTTCTTCGGGCCA	CASSYTRGLAGSNEQFF	1
CTCAGGCTGCTGTCGGCTGCTCCCTCCCAGACATCTGTGTACTTCTGTGCCAGCAGTTACTCGGGTAGGGGGCAGTACTTCGGGCCG	CASSYSGRGQYF	1
CAAAGCTTGAGGACTCGGCCGTGTATCTCTGTGCCAGCAGCTTCAATGGACAGGGGGGGCTCTGGAAACACCATATATTTTGGAGAG		1
TCTGCTGCCTCCTCCCAGACATCTGTATATTTCTGCGCCAGCAGTGACGGGCAAGCGGGATCGGTCGGGGAGCTGTTTTTTGGAGAA	CASSDGQAGSVGELFF	1
AATGTGAGCACCTTGGAGCTGGGGGACTCGGCCCTTTATCTTTGCGCCAGCAGCTTGTTAGCGGAAGAGACCCAGTACTTCGGGCCA	CASSLLAEETQYF	1
AGTTCTAAGAAGCTCCTTCTCAGTGACTCTGGCTTCTATCTCTGTGCCTGGAGCGGGCCAACATGGGATGGCTACACCTTCGGTTCG	CAWSGPTWDGYTF	1
CACCAGGCCTGGGGGACGCAGCCATGTACCTGTGTGCCACCAGCAGAGATTCGGTCTCCCGGGGGGGAGACCCAGTACTTCGGGCCA		1
AATTCCCTGGAGCTTGGTGACTCTGCTGTGTATTTCTGTGCCAGCAGCCAATGGGACAGTGAGCACAATGAGCAGTTCTTCGGGCCA	CASSQWDSEHNEQFF	1
TCCGCCAGCACCAACCAGACATCTATGTACCTCTGTGCCAGCAGTCCTGCTAGCGGGACTTCCTACAATGAGCAGTTCTTCGGGCCA	CASSPASGTSYNEQFF	1
CTAGAGTCTGCCATCCCCAACCAGACAGCTCTTTACTTCTGTGCCACCAGTGACCGATGGACGGAGAATGAGCAGTTCTTCGGGCCA	CATSDRWTENEQFF	1
AATGTGAGCACCTTGGAGCTGGGGGACTCGGCCCTTTATCTTTGCGCCAGCAGCTTGGTGGCTAACTATGGCTACACCTTCGGTTCG	CASSLVANYGYTF	1
ATCCGCTCACCAGGCCTGGGGGACGCAGCCATGTACCTGTGTGCCACCAGCAGAGATCGGCTAAACACTGAAGCTTTCTTTGGACAA	CATSRDRLNTEAFF	1
TCAATTCCCTGGAGCTTGGTGACTCTGCTGTGTATTTCTGTGCCAGCAGCCTTCTCAATGCACCGCTACGAGCAGTACTTCGGGCCG		1
CTGAGTTCTAAGAAGCTCCTTCTCAGTGACTCTGGCTTCTATCTCTGTGCCTGGAGCGTCCAAGGAGAGACCCAGTACTTCGGGCCA	CAWSVQGETQYF	1
AAGAAGCTCCTTCTCAGTGACTCTGGCTTCTATCTCTGTGCCTGGACAAAGTTTGGCACTGGCACAGATACGCAGTATTTTGGCCCA	CAWTKFGTGTDTQYF	1
CTGGGGTTGGAGTCGGCTGCTCCCTCCCAAACATCTGTGTACTTCTGTGCCAGCAGGACAGGGGGAGGTGGCTACACCTTCGGTTCG	CASRTGGGGYTF	2
CAGCCCATGGAACCCAGGGACTTGGGCCTATATTTCTGTGCCAGCAGCTTCCGGGACTAGCGGCTCAATGAGCAGTTCTTCGGGCCA	CASSFRD*RLNEQFF	1
TCCCTGGAGCTTGGTGACTCTGCTGTGTATTTCTGTGCCAGCAGCCAAGTACTAGCGGGAGGCCCAGATACGCAGTATTTTGGCCCA	CASSQVLAGGPDTQYF	1
GGGTTGGAGTCGGCTGCTCCCTCCCAAACATCTGTGTACTTCTGTGCCAGCATTAAGCGGCAGTCCTACGAGCAGTACTTCGGGCCG	CASIKRQSYEQYF	1
AAGAAGCTCCTTCTCAGTGACTCTGGCTTCTATCTCTGTGCCTGGATTGGGAGCGGGAGGGCCGGTGAGACCCAGTACTTCGGGCCA	CAWIGSGRAGETQYF	1
CTCAGGCTGGAGTCGGCTGCTCCCTCCCAGACATCTGTGTACCTCTGTGCCAGCGGGGGGGCGTCCTACGAGCAGTACTTCGGGCCG	CASGGASYEQYF	1
CAGCGCACAGAGCAGCGGGACTCGGCCATGTATCGCTGTGCCAGCAGCTTAGGTCAGGGTTTTAGTACTGAAGCTTTCTTTGGACAA	CASSLGQGFSTEAFF	1
AAGATCCAACCTGCAAAGCTTGAGGACTCGGCCGTGTATCCCTGTGCCAGCAGCTTAGATCCTGGAGATACGCAGTATTTTGGCCCA	CASSLDPGDTQYF	1
CAGCAGGTAGTGCGAGGAGATTCGGCAGCTTATTTCTGTGCCAGCTCACAGCGGACAGGGGTTGGTGAAAAACTGTTTTTTGGCAGT	CASSQRTGVGEKLFF	1
CTGGAGTCGCCCAGCCCCAACCAGACCTCTCTGTACTTCTGTGCCAGCAGTTTAGCAGGGACGGGAGATACGCAGTATTTTGGCCCA	CASSLAGTGDTQYF	4
ACTCTGAAGATCCAGCCCTCAGAACCCAGGGACTCAGCTGTGTACTTCTGTGCCAGCAGCCGGAGATACGAGCAGTACTTCGGGCCG	CASSRRYEQYF	1
ACTGTGAGCAACATGAGCCCTGAAGACAGCAGCATATATCTCTGCAGCGCCGCGGGCAGCCTGAACACTGAAGCTTTCTTTGGACAA	CSAAGSLNTEAFF	1
GTCCGCCAGCACCAACCAGACATCTATGTACCTCTGTGCCAGCCATTCACTTCAATGTCTACTAATTCACCCCTCCACTTTGGGAAC		1
GAGCTGGGGGACTCGGCCCTTTATCTTTGCGCCAGCAGCCACATCAGCACAGGGGGCACTGGGGCCAACGTCCTGACTTTCGGGGCC	CASSHISTGGTGANVLTF	2
CTGAAGATCCAGCCCTCAGAACCCAGGGACTCAGCTGTGTACTTCTGTGCCTCTTCGGGGGGTGGCAATGAGCAGTTCTTCGGGCCA	CASSGGGNEQFF	1
ACAGTGACCAGTGCCCATCCTGAAGACAGCAGCTTCTACATCTGCAGTGCTCTGCGGACTGTCTCCTACGAGCAGTACTTCGGGCCG	CSALRTVSYEQYF	1
ATTCTGGAGTCCGCCAGCACCAACCAGACATCTATGTACCTCTGTGCCAGCAGTTTCTCGGACAGGGGGATAGCTTTCTTTGGACAA	CASSFSDRGIAFF	1
CAGCGCACAGAGCAGGGGGACTCGGCCATGTATCTCTGTGCCAGCAGCCCCCGACAGGGCTTGAACACTGAAGCTTTCTTTGGACAA	CASSPRQGLNTEAFF	1
CTTCACATCAATTCCCTGGAGCTTGGTGACTCTGCTGTGTATTTCTGTGCCAGCAGCCCTACTCGGAATGAGCAGTTCTTCGGGCCA	CASSPTRNEQFF	1
TGTGAGCACCTTGGAGCTGGGGGACTCGGCCCTTTATCTTTGCGCCAGCACCTGAGGACACTTGTCTACGAGCAGTACTTCGGGCCG		1
CTGCTGTCGGCTGCTCCCTCCCAGACATCTGTGTACTTCTGTGCCAGCAGCTCCGGACAGGGGAGGGCTGAAGCTTTCTTTGGACAA	CASSSGQGRAEAFF	1
GTGACCAGTGCCCATCCTGAAGACAGCAGCTTCTACATCTGCAGTGCTAGAGTGCGCGGGGCGTCCGGGGAGCAGTACTTCGGGCCG	CSARVRGASGEQYF	1
GTGACATCGGCCCAAAAGAACCCGACAGCTTTCTATCTCTGTGCCAGTAGTCTCCTCGGGGCAGGTGGACCCCAGCATTTTGGTGAT	CASSLLGAGGPQHF	1
AAGATCCAGCCTGCAAAGCTTGAGGACTCGGCCGTGTATCTCTGTGCCAGCAGCCTCGGGGGGATCGGGGAGCTGTTTTTTGGAGAA	CASSLGGIGELFF	1
AAGATCCAGCCCTCAGAACCCAGGGACTCAGCTGTGTACTTCTGTGCCAGCAGTTTAATGGCTCGAGATGGGGCGTTCTTCGGGCCA	CASSLMARDGAFF	1
TGAACGCCTTGGAGCTGGACGACTCGGCCCTGTATCTCTGTGCCAGCAGCTTGGATACAAGGGTCAGATACGCAGTATTTTGGCCCA		1
AGGCTGGAGTCGGCTGCTCCCTCCCAGACATCTGTGTACTTCTGTGCCAGCAGGGACCAGGGTGGCTATGGCTACACCTTCGGTTCG	CASRDQGGYGYTF	1
GCAGAGCTTGGGGACTCGGCCGTGTATCTCTGTGCCAGCAGCCCCGGGGAACTAGCGGGATATAGGGAGACCCAGTACTTCGGGCCA	CASSPGELAGYRETQYF	1
GAGCTGGAGGACTCGGCCCTGTATCTCTGTGCCAGCAGCTCAAAGTATTATGGACTAGCGGAAAGCGAGACCCAGTACTTCGGGCCA	CASSSKYYGLAESETQYF	1
CGCACACAGCAGGAGGACTCCGCCGTGTATCTCTGTGCCAGCAGCCCCCTCGGGGGTGATCACCACTATGGCTACACCTTCGGTTCG	CASSPLGGDHHYGYTF	1
GTGACATCGGCCCAAAAGAACCCGACAGCTTTCTATCTCTGTGCCAGTAAATTCGGGGAGCTGAACTATGGCTACACCTTCGGTTCG	CASKFGELNYGYTF	2
AATTCCCTGGAGCTTGGTGACTCTGCTGTGTATTTCTGTGCCAGCAGCCAAGGGCGGGGGGGCGGAGCTGGGCAGTATTTTGGCCCA	CASSQGRGGGAGQYF	1
CAGCTACCCGCTCCCAGACATCTGTGTATTTCTGCGCCAGCAGAAATCCCGGGGGCGGTCGGCAACCAGCCCCAGCATTTTGGTGAT		1
ACCAGTGCCCATCCTGAAGACAGCAGCTTCTACATCTGCAGTGCTAGAGATCGGACTAGCGGGCCCAACGAGCAGTACTTCGGGCCG	CSARDRTSGPNEQYF	1
CTGACAGTGACCAGTGCCCATCCTGAAGACAGCAGCTTCTACATCTGCAGTGCGAGGGCGGGCACCGGGGAGCTGTTTTTTGGAGAA	CSARAGTGELFF	1
TTGGCTGCTCCCTCCCAGACATCTGTGTACTTCTGTGCCAGCAGTTATAGGACAGGGGGCTCCTACAATGAGCAGTTCTTCGGGCCA	CASSYRTGGSYNEQFF	1
TCAGAACCCAGGGACTCAGCTGTGTACTTCTGTGCCAGCAGTTTATTCCCTAGCGGGGGAACTAGCAATGAGCAGTTCTTCGGGCCA	CASSLFPSGGTSNEQFF	1
CGGAGTCAGGGGACACAGCACTGTATTTCTGTGCCAGCAGCAAAGCGGGGACTAGCGAGGGGTGGAAACACCATATATTTTGGAGAG		1
CTCAAGATCCAACCTGCAAAGCTTGAGGACTCGGCCGTGTATCTCTGTGCCAGCAGCTCCGACGGCTATGGCTACACCTTCGGTTCG	CASSSDGYGYTF	1
TGCAGCCTGCAGAACTGGAGGATTCTGGAGTTTATTTCTGTGCCAGCAGCCAAGACACGGTTGAACACTGAAGCTTTCTTTGGACAA		1
ACCAGTGCCCATCCTGAAGACAGCAGCTTCTACATCTGCAGTGCCAGATCACTGACCCAAACGGGAAACATTCAGTACTTCGGCGCC	CSARSLTQTGNIQYF	1
CACCTACACACCCTGCAGCCAGAAGACTCGGCCCTGTATCTCTGCGCCAGCAGCCAAGAGCTCAATCAGCCCCAGCATTTTGGTGAT	CASSQELNQPQHF	1
GCCAGCACCAACCAGACATCTATGTACCTCTGTGCCATCGGAGAGGCCTCGAAGATTTGGAGCAATCAGCCCCAGCATTTTGGTGAT	CAIGEASKIWSNQPQHF	1
GTGAGCAACATGAGCCCTGAAGACAGCAGCATATATCTCTGCAGCGTTGGGAAGGGACTAGACACAGATACGCAGTATTTTGGCCCA	CSVGKGLDTDTQYF	1
GTGAGCACCTTGGAGCTGGGGGACTCGGCCCTTTATCTTTGCGCCAGCAGTTATCCGGACATCACCGGGGAGCTGTTTTTTGGAGAA	CASSYPDITGELFF	1
AGTGCCCATCCTGAAGACAGCAGCTTCTACATCTGCAGTGCTAGAATTAGGGCCGACCCCTATAATTCACCCCTCCACTTTGGGAAC	CSARIRADPYNSPLHF	1
AGCTCTCTGGAGCTGGGGGACTCAGCTTTGTATTTCTGTGCCAGCAGCGTAGGCTCCCTAGCGGGAGTGGAGCAGTTCTTCGGGCCA	CASSVGSLAGVEQFF	1
TCCGCTACCAGCTCCCAGACATCTGTGTACTTCTGTGCCATCAGTGAGCCGATCGGGCATAACACCGGGGAGCTGTTTTTTGGAGAA	CAISEPIGHNTGELFF	1
ACTCTGACGATCCAGCGCACACAGCAGGAGGACTCGGCCGTGTATCTCTGTGCCAGCAGCTCTGCAGATACGCAGTATTTTGGCCCA	CASSSADTQYF	1
ACAGTGACCAGTGCCCATCCTGAAGACAGCAGCTTCTACATCTGCAGTGCTCCCGAATCAGTCCGGTACGAGCAGTACTTCGGGCCG	CSAPESVRYEQYF	1
GTGAACGCCTTGGAGCTGGACGACTCGGCCCTGTATCTCTGTGCCAGCAGCAGGGGACTAGCGAGCTACGAGCAGTACTTCGGGCCG	CASSRGLASYEQYF	1
ATCCAGCGCACACAGCAGGAGGACTCGGCCGTGTATCTCTGTGCCAGCAACAAGGGACAGCTGAACACTGAAGCTTTCTTTGGACAA	CASNKGQLNTEAFF	1
CTGGAGTCGCCCAGCCCCAACCAGACCTCTCTGTACTTCTGTGCCAGCAGTCCGGCCCGGGGTAATTCACCCCTCCACTTTGGGAAC	CASSPARGNSPLHF	1
AGTGCCCATCCTGAAGACAGCAGCTTCTACATCTGCAGTGTCCCGACTAGCGGGAGGCTCCCTTCCTACGAGCAGTACTTCGGGCCA	CSVPTSGRLPSYEQYF	1
CAGCGCACACAGCAGGAGGACTCCGCCGTGTATCTCTGTGCCAGCAGCCAGGGACAGGGGAGAGGAGAAAAACTGTTTTTTGGCAGT	CASSQGQGRGEKLFF	1
TCGGCCCAAAAGAACCCGACAGCTTTCTATCTCTGTGCCAGTAGTCCGCGGACTAGCGGGGGGGAGTACGAGCAGTACTTCGGGCCG	CASSPRTSGGEYEQYF	1
GAGTCGGCTGCTCCCTCCCAGACATCTGTGTACTTCTGTGCCAGCATTCTAGATTTGACAGCTAACTATGGCTACACCTTCGGTTCG	CASILDLTANYGYTF	1
AGTGCCCATCCTGAAGACAGCAGCTTCTACATCTGCAGTGCTAGAGCGGGCGGGGGCGGGTCTGGAGAGACCCAGTACTTCGGGCCA	CSARAGGGGSGETQYF	1
GAGTCGGCTGCTCCCTCCCAGACATCTGTGTACTTCTGTGCCAGCAGTGAAGGGTGGGGGATTCAAGAGACCCAGTACTTCGGGCCA	CASSEGWGIQETQYF	1
AACGCCTTGGAGCTGGACGACTCGGCCCTGTATCTCTGTGCCAGCAGCTTGCCAGGGACTTCCTACAATGAGCAGTTCTTCGGGCCA	CASSLPGTSYNEQFF	1
TTGGAGCTGGACGACTCGGCCCTGTATCTCTGTGCCAGCAGCTACAGGTACTCCGGGACAGAGTACAATGAGCAGTTCTTCGGGCCA	CASSYRYSGTEYNEQFF	1
AATTCCCTGGAGCTTGGTGACTCTGCTGTGTATTTCTGTGCCAGCAGCCACACCGGGGCCGGGGGAGCTGAAGCTTTCTTTGGACAA	CASSHTGAGGAEAFF	1
CCCTCAGAACCCAGGGACTCAGCTGTGTACTTCTGTGCCAGCAGTTTCGGGGTACGAGGTGGGGAGGACGAGCAGTACTTCGGGCCG	CASSFGVRGGEDEQYF	1
ACATGAGCCCTGAAGACAGCAGCATATATCTCTGCAGCGGCCCTCTGACTAGCGGGAGCGAGGATTGAGACCCAGTACTTCGGGCCA		1
GCGCACACAGCAGGAGGACTCGGCCGTGTATCTCTGTGCCAGCAGGCCAGACTAGCGGGAGTGGTCGAGACCCAGTACTTCGGGCCA		2
ACCTTGGAGCTGGGGGACTCGGCCCTTTATCTTTGCGCCAGCAGCTTGGCCACTGCAACTTCCTACAATGAGCAGTTCTTCGGGCCA	CASSLATATSYNEQFF	1
GTGACCAGTGCCCATCCTGAAGACAGCAGCTTCTACATCTGCAGTGCTAGAGAAGGGGGGGGCGTCACTGAAGCTTTCTTTGGACAA	CSAREGGGVTEAFF	1
GAGTCTGCTGCCTCCTCCCAGACATCTGTATATTTCTGCGCCAGCAGTGATGGGGGAGGGGGGGTCAATGAGCAGTTCTTCGGGCCA	CASSDGGGGVNEQFF	1
CCCAGCCCCAACCAGACCTCTCTGTACTTCTGTGCCAGCAGCAGGGACCGGGACAACTCGAACACCGGGGAGCTGTTTTTTGGAGAA	CASSRDRDNSNTGELFF	1
AAGATCCAGCCCTCAGAACCCAGGGACTCAGCTGTGTACTTCTGTGCCAGCAGCCGGACAGGGGCTGGGGAGCTGTTTTTTGGAGAA	CASSRTGAGELFF	1
TCGGCTGCTCCCTCCCAGACATCTGTGTACTTCTGTGCCAGCAGTTACGGCAGGGGAGTTATAGGAAACACCATATATTTTGGAGAG	CASSYGRGVIGNTIYF	1
GCAAAGCTTGAGGACTCGGCCGTGTATCTCTGTGCCAGCAGCCACCGGGGGAGCGGTAGAACCTACAATGAGCAGTTCTTCGGGCCA	CASSHRGSGRTYNEQFF	1
CAGTGCCCATCCTGAAGACAGCAGCTTCTACATCTGCAGTGCTAGGACTGTACGAGCCTAGCCAAAAACATTCAGTACTTCGGCGCC		1
ATTCTGGAGTCCGCCAGCACCAACCGGACATCTATGTACCTCTGTGCCAGCAGTTTAAAATTACGTGAAAAACTGTTTTTTGGCAGT	CASSLKLREKLFF	1
TCGGCTGCTCCCTCCCAGACATCTGTGTACTTCTGTGCCAGCACTCCGACGGTGGGACAGCTATCCTACGAGCAGTACTTCGGGCCG	CASTPTVGQLSYEQYF	1
ATCCAGCCTGCAGAGCTTGGGGACTCGGCCGTGTATCTCTGTGCCAGCAGCCGGACTAGCGGGAGAAGCGAGCAGTACTTCGGGCCG	CASSRTSGRSEQYF	2
CAGCGCACACAGCAGGAGGACTCGGCCGTGTATCTCTGTGCCAGCAGCCCTGTCCCCTACGCGAGGGACGAGCAGTACTTCGGGCCG	CASSPVPYARDEQYF	1
AGTGCCCATCCTGAAGACAGCAGCTTCTACATCTGCAGTGCTAGAGAGGGGACAGGGGGCACTGGGCAGCCCCAGCATTTTGGTGAT	CSAREGTGGTGQPQHF	1
TCCCTGGAGCTTGGTGACTCTGCTGTGTATTTCTGTGCCAGCAGTCCCCCCAGGGCAGGTATGAACACTGAAGCTTTCTTTGGACAA	CASSPPRAGMNTEAFF	1
TTGGAGCTGGACGACTCGGCCCTGTATCTCTGTGCCAGCAGCTTGTGAATCCTCAAGGGGGGGACCTATGGCTACACCTTCGGTTCG	CASSL*ILKGGTYGYTF	1
GCCTTGGAGCTGGAGGACTCGGCCCTGTATCTCTGTGCCAGCAGCTTTCCCATCGCAGACTCTAACTATGGCTACACCTTCGGTTCG	CASSFPIADSNYGYTF	1
CTCACTCTGGGGTCCGCTACCAGCTCCCAGACATCTGTGTACTTCTGTGCCACCCGACTGGAGTTATATGGCTACACCTTCGGTTCG	CATRLELYGYTF	1
AGTTCTAAGAAGCTCCTTCTCAGTGACTCTGGCTTCTATCTCTGTGCCTGGAGTGCTTTCGGGACCGGGGAGCTGTTTTTTGGAGAA	CAWSAFGTGELFF	1
CAGCAGGTAGTGCGAGGAGATTCGGCAGCTTATTTCTGTGCCAGCTCACCAATTACGGGAGGGCCAGGTGAGCAGTTCTTCGGGCCA	CASSPITGGPGEQFF	1
GAGCTGGGGGACTCGGCCCTTTATCTTTGCGCCAGCAGCTTAGGGCGATGGATGGGGGTAGGACTATACGAGCAGTACTTCGGGCCG	CASSLGRWMGVGLYEQYF	1
GTGACCAGTGCCCATCCTGAAGACAGCAGCTTCTACATCTGCAGTGCTAAGCGGCCAGGTCGGACAGATACGCAGTATTTTGGCCCA	CSAKRPGRTDTQYF	1
CCCCTCACTCTGGAGTCAGCTACCCGCTCCCAGACATCTGTGTATTTCTGCGCCAGCAAGCTCGGGGAAAAACTGTTTTTTGGCAGT	CASKLGEKLFF	1
ACAGTGACCAGTGCCCATCCTGAAGACAGCAGCTTCTACATCTGCAGTGCGGGAGATTCTAGCTCCTACGAGCAGTACTTCGGGCCG	CSAGDSSSYEQYF	1
ATCCAGCCCTCAGAACCCAGGGACTCAGCTGTGTACTTCTGTGCCAGCAGTTTAGGGACAGGGGCCTATGGCTACACCTTCGGTTCG	CASSLGTGAYGYTF	1
CTGGAGTCGCCCAGCCCCAACCAGACCTCTCTGTACTTCTGTGCCAGCAGACAGGGGAATAATATCGGGGAGCTGTTTTTTGGAGAA	CASRQGNNIGELFF	2
GCAAAGCTTGAGGACTCGGCCGTGTATCTCTGTGCCAGCAGCCCGAGGGGCCTCGGCGGGGGGCAGTACGAGCAGTACTTCGGGCCG	CASSPRGLGGGQYEQYF	1
CAGCGCACAGAGCAGCGGGACTCGGCCATGTATCGCTGTGCCAGCAGCTTCGGACCTGATGGGACCGGGGAGCTGTTTTTTGGAGAA	CASSFGPDGTGELFF	1
CAGCAGGTAGTGCGAGGAGATTCGGCAGCTTATTTCTGTGCCAGCTCACCAATTAATAGGTGGGGAGAGACCCAGTACTTCGGGCCA	CASSPINRWGETQYF	1
GAGATCCAGCGCACAGAGCAGGGGGACTCGGCCATGTATCTCTGTGCCAGCAGCGCGGGACATCTCATGGAGCAGTACTTCGGGCCA	CASSAGHLMEQYF	1
ATCCAGCGCACAGAGCAGGGGGACTCGGCCATGTATCTCTGTGCCAGCAGCTTACAAGGTTTCGGTTCACCCCTCCACTTTGGGAAC	CASSLQGFGSPLHF	1
GAGTCTGCCATCCCCAACCAGACAGCTCTTTACTTCTGTGCCGCAAGGCACCACAACCCCAAGAGAAACACCATATATTTTGGAGAG	CAARHHNPKRNTIYF	1
CGCACAGAGCAGGGGGACTCGGCCATGTATCTCTGTGCCAGCAGCCCCCGGGACCCCCATTCGAGGGATGAGCAGTTCTTCGGGCCA	CASSPRDPHSRDEQFF	1
GCCTTGTTGCTGGGGGACTCGGCCCTCTATCTCTGTGCCAGCAGCTTGCTTACGGTCTCCAGCACAGATACGCAGTATTTTGGCCCA	CASSLLTVSSTDTQYF	1
CCCCTCACTCTGGAGTCAGCTACCCGCTCCCAGACATCTGTGTATTTCTGCGCCAGCAGTGAGTTGGACAATCAGTTCTTCGGGCCA	CASSELDNQFF	1
CCGCTCAGGCTGGAGTTGGCTGCTCCCTCCCAGACATCTGTGTACTTCTGTGCCAGCAGTTCAGTGTATGGCTACACCTTCGGTTCG	CASSSVYGYTF	1
GAGTTGGCTGCTCCCTCCCAGACATCTGTGTACTTCTGTGCCAGCAGTTACTCGAAGGGGGCAGGACAGCCCCAGCATTTTGGTGAT	CASSYSKGAGQPQHF	1
GAGTTGGCTGCTCCCTCCCAGACATCTGTGTACTTCTGTGCCAGCAGGTATACTAGCGGCAACACCGGGGAGCTGTTTTTTGGAGAA	CASRYTSGNTGELFF	1
ATTCTGGAGTCCGCCAGCACCAACCAGACATCTATGTACCTCTGTGCCAGCAGTCTGACAGGGTATTGGAGCTACACCTTCGGTTCG	CASSLTGYWSYTF	1
ACTCTGACGATCCAGCGCACACAGCAGGAGGACTCGGCCGTGTATCTCTGTGCCAGCAGCCCGGGGACGGAGCAGTTCTTCGGGCCA	CASSPGTEQFF	2
ATCCGGTCCACAAAGCTGGAGGACTCAGCCATGTACTTCTGTGCCAGCAGACGGACAGGCACCCCCTATGGCTACACCTTCGGTTCG	CASRRTGTPYGYTF	1
ATCCTGAGTTCTAAGAAGCTCCTTCTCAGTGACTCTGGCTTCTATCTCTGTGCCTCAGGACAGGGCTACGGCTACACCTTCGGTTCG	CASGQGYGYTF	1
ACGATCCAGCGCACACAGCAGGAGGACTCGGCCGTGTATCTCTGTGCCAGCAGCTTAGGGGCCCCAAGGGCCCTCCACTTTGGGAAC	CASSLGAPRALHF	1
CAGGTAGTGCGAGGAGATTCGGCAGCTTATTTCTGTGCCAGCTCACCACCGGGGAGCAGGGGTGAGGAGACCCAGTACTTCGGGCCA	CASSPPGSRGEETQYF	1
ATCCAGCGCACAGAGCAGGGGGACTCGGCCATGTATCTCTGTGCCGCACTCCGGGGGGGGGCCGTCGGGGAGCTGTTTTTTGGAGAA	CAALRGGAVGELFF	1
ACAGAGCAGGGGGACTCGGCCATGTATCTCTGTGCCAGCAGCGCGGGGAGGGGGGTCTATAGCAATCAGCCCCAGCATTTTGGTGAT	CASSAGRGVYSNQPQHF	1
GTCCACGGAGTCAGGGGACACAGCACTGTATTTCTGTGCCAGCAGCAATTAAGGGTAGCACATGGATACGAGCAGTACTTCGGGCCG		1
AATGTGAACGCCTTGGAGCTGGACGACTCGGCCCTGTATCTCTGTGCCAGCAGCGGAGGGGGGTTATCTGAAGCTTTCTTTGGACAA	CASSGGGLSEAFF	1
GTAGTGCGAGGAGATTCGGCAGCTTATTTCTGTGCCAGCTCAGGAATTCGCATGGGAATTGGAGCCGGGGAGCTGTTTTTTGGAGAA	CASSGIRMGIGAGELFF	1
CTGAAGATCCAGCGCACACAGCAGGAGGACTCCGCCGTGTATCTCTGTGCCAGCAGGGACAGGATGGATGAGCAGTTCTTCGGGCCA	CASRDRMDEQFF	1
GAGTCGGCTGCTCCCTCCCAAACATCTGTGTACTTCTGTGCCAGCACTCCGAGGGGACAGGGACAAGAGACCCAGTACTTCGGGCCA	CASTPRGQGQETQYF	1
CGCTCCCAGACATCTGTGTATTTCTGCGCCAGCAGTGAGAGGGGGGTTTTTTAGTTAGCCAACAATCAGCCCCAGCATTTTGGTGAT	CASSERGVF*LANNQPQHF	1
ATCCAGCCCTCAGAACCCAGGGACTCAGCTGTGTACTTCTGTGCCAGCAGACTCTCCCTGAGCAATCAGCCCCAGCATTTTGGTGAT	CASRLSLSNQPQHF	1
ATTCTGGAGTCCGCCAGCACCAACCAGACATCTATGTACCTCTGTGCCAGCAGTTTAGGACAGCTAAACGAGCAGTACTTCGGGCCG	CASSLGQLNEQYF	1
ACAGTGACCAGTGCCCATCCTGAAGACAGCAGCTTCTACATCTGCAGTGCTCACGGGAGTTGGGGAGAGACCCAGTACTTCGGGCCA	CSAHGSWGETQYF	1
ATGTGAACGCCTTGGAGCTGGACGACTCGGCCCTGTATCTCTATGCCAGCAGCCCTACAATCTAAAGAGACCCAGTACTTCGGGCCA		1
GCTGCTCCCTCCCAAACATCTGTGTACTTCTGTGCCAGCAGCTTCTGGGACAGGGGGGGAAACAATCAGCCCCAGCATTTTGGTGAT	CASSFWDRGGNNQPQHF	1
CCTTGGAGCTGGGGGACTCGGCCCTTTATCTTTGCGCCAGCAGCTTGGGCACGGAGACTAGCCTCCCACGAGCAGTACTTCGGGCCG		1
GTGACCAGTGCCCATCCTGAAGACAGCAGCTTCTACATCTGCAGTGCTACAGGGAGGACAAATGGAAACACCATATATTTTGGAGAG	CSATGRTNGNTIYF	1
ACTGTGACATCGGCCCAAAAGAACCCGACAGCTTTCTATCTCTGTGCCAGTAGTATAGCCCGAGGAGCCGAGCAGTACTTCGGGCCG	CASSIARGAEQYF	1
ATCCAGCGCACACAGCAGGAGGACTCGGCCGTGTATCTCTGTGCCAGCAGCTTAAACAATGGGGGGTGGACGCAGTATTTTGGCCCA	CASSLNNGGWTQYF	1
AGTGCCCATCCTGAAGACAGCAGCTTCTACATCTGCAGTGCTAGGGGATCCGTTTCCCTCCAACTTAATGAGCAGTTCTTCGGGCCA	CSARGSVSLQLNEQFF	1
ACGATCCAGCGCACACAGCAGGAGGACTCGGCCGTGTATCTCTGTGCCAGCAGCTTAGTCCCCGGCAATGAGCAGTTCTTCGGGCCA	CASSLVPGNEQFF	1
ACACAGCAGGAGGACTCCGCCGTGTATCTCTGTGCCAGCAGCTCCCTTGTTGGGGGCAGCTCCTACAATGAGCAGTTCTTCGGGCCA	CASSSLVGGSSYNEQFF	1
TCAGGCTGGAGTCAGCTGCTCCCTCCCAGACATCTGTGTACTTCTGTGCCAGCAGGGACCTTAGGAAACACCATATATTTTGGAGAG		19
CTGAAGATCCAGCCCTCAGAACCCAGGGACTCAGCTGTGTATTTTTGTGCTAGCGGCCCAACCGACACTGAAGCTTTCTTTGGACAA	CASGPTDTEAFF	1
AAGATCCAGCCCTCAGAACCCAGGGACTCAGCTGTGTACTTCTGTGCCAGCAAAGGGCCGGGACGCTATGGCTACACCTTCGGTTCG	CASKGPGRYGYTF	1
AAGATCCAGCCCTCAGAACCCAGGGACTCAGCTGTGTACTTCTGTGCCAGCAGTTTTCAGGACTCCTACGAGCAGTACTTCGGGCCG	CASSFQDSYEQYF	1
TTGGAGCTGGGGGACTCGGCCCTTTATCTTTGCGCCAGCAGCTCGCTCCGAGCGGGAGGGCCGTTCAGTGAGCAGTTCTTCGGGCCA	CASSSLRAGGPFSEQFF	1
ATCGGCCCAAAAGAACCCGACAGCTTTCTATCTCTGTGCCAGTAGTCAACGACACCTTATAGCAATCAGCCCCAGCATTTTGGTGAT		1
CGCACAGAGCAAGGGCGACTCGGCTGTGTATCTCTGTCTTCAGAAGGGCCTGGGGGCACAGGGGACACTGAAGCTTTCTTTGGACAA		1
AGTGCCCATCCTGAAGACAGCAGCTTCTACATCTGCAGTGCTAGAGTATTGGCAGCGCCAACTAATGAAAAACTGTTTTTTGGCAGT	CSARVLAAPTNEKLFF	1
TCCAGTCCACGGAGTCAGGGGACACAGCACTGTATTTCTGTGCCAGCAGCCTACAGGGGCTCTGGAAACACCATATATTTTGGAGAG		1
AGTCGCCCAGCCCCAACCAGACCTCTCTGTACTTCTGTGCCAGCAGTTTGTACGATTCCTGGGGTTCAGCCCCAGCATTTTGGTGAT		1
AGGCTGGAGTCGGCTGCTCCCTCCCAGACATCTGTGTACTTCTGTGCCAGCAGTAGGAGCCAGGGGTACGAGCAGTACTTCGGGCCG	CASSRSQGYEQYF	2
GAGTCGGCTGCTCCCTCCCAAACATCTGTGTACTTCTGTGCCAGCAGTCGTCCCGTGACAGGGGCCTACGAGCAGTACTTCGGGCCG	CASSRPVTGAYEQYF	1
GCTCTCTGGAGCTGGGGGACTCAGCTTTGTATTTCTGTGCCACCACCTTCGGGAGACTAGGTAACATATACGCAGTATTTTGGCCCA		1
CTGACAGTGACCAGTGCCCATCCTGAAGACAGCAGCTTCTACATCTGCAGTGCTAGCAGGGAACGCGGGGAGCTGTTTTTTGGAGAA	CSASRERGELFF	1
ATCCGCTCACCAGGCCTGGGGGACGCAGCCATGTACCTGTGTGCCACCAGCACAGAAATCGTGGGCACTGAAGCTTTCTTTGGACAA	CATSTEIVGTEAFF	1
CTCAGGCTGGAGTCGGCTGCTCCCTCCCAGACATCTGTGTACTTCTGTGCCCTGGAGGGACAGAACACTGAAGCTTTCTTTGGACAA	CALEGQNTEAFF	1
GCTCCCTCCCAAACATCTGTGTACTTCTGTGCCAGCAGGGTGGCTAGCGGGAGGGCGTCGTCCTACAATGAGCAGTTCTTCGGGCCA	CASRVASGRASSYNEQFF	1
CTACACGCCCTGCAGCCAGAAGACTCAGCCCTGTATCTCTGCGCCAGCAGCCAGGGGACCATAAACTATGGCTACACCTTCGGTTCG	CASSQGTINYGYTF	1
GAGTCCGCTACCAGCTCCCAGACATCTGTGTACTTCTGTGCCATCAGTGATATGGGACAGGGCAATCAGCCCCAGCATTTTGGTGAT	CAISDMGQGNQPQHF	1
ACGATCCAGCGCACACAGCAGGAGGACTCGGCCGTGTATCTCTGTGCCAGCGGTGGACAGGGCGGGGAGACCCAGTACTTCGGGCCA	CASGGQGGETQYF	1
ATTCTGGAGTCCGCCAGCACCAACCAGACATCTATGTACCTCTGTGCCAGCAGTTTATTAGGGGGCTACGAGCAGTACTTCGGGCCG	CASSLLGGYEQYF	1
CGCACAGAGCAGCGGGACTCGGCCATGTATCGCTGTGCCAGCAGCTCCATGCCCGGATCGGACACCGGGGAGCTGTTTTTTGGAGAA	CASSSMPGSDTGELFF	1
CCTTGGAGCTGGGGGACTCGGCCCTTTATCTTTGCGCCAGCAGCTCCGATGCACCATCAGTCCTACTACGAGCAGTACTTCGGGCCG		1
TCCACTCTGACAGTGACCAGTGCCCATCCTGAAGACAGCAGCTTCTACATCTGCAGTGCTTGGGATGAAAAACTGTTTTTTGGCAGT	CSAWDEKLFF	1
ACGATCCAGCGCACAGAGCAGCGGGACTCGGCTATGTATCGCTGTGCCAGCAGCCCACTACCCGGTGGGGGCTACACCTTCGGTTCG	CASSPLPGGGYTF	1
ATGAATGTGAGCACCTTGGAGCTGGGGGACTCGGCCCTTTATCTTTGCGCCAGCAGCTTCAGCGGGGGGGAGCAGTATTTTGGCCCA	CASSFSGGEQYF	1
GGCCTGGGGGACGCAGCCATGTACCTGTGTGCCACCAGCAGAGATTGGGCAATTGGATTGGCGGACGAAAAACTGTTTTTTGGCAGT	CATSRDWAIGLADEKLFF	1
CTGACAGTGACCAGTGCCCATCCTGAAGACAGCAGCTTCTACATCTGCAGTGCTAGCGGGCAGGTCGGTGGCTACACCTTCGGTTCG	CSASGQVGGYTF	1
ATCAATTCCCTGGAGCTTGGTGACTCTGCTGTGTATTTCTGTGCCAGCAGCAAGGGACTTAACTACAATGAGCAGTTCTTCGGGCCA	CASSKGLNYNEQFF	1
TCCCTGATTCTGGAGTCCGCCAGCACCAACCAGACATCTATGTACCTCTGTGCCAGCACCCAAGGGTGGCCCCAGCATTTTGGTGAT	CASTQGWPQHF	1
GAGTCGGCTGCTCCCTCCCAGACATCTGTGTACTTCTGTGCCAGCAGTGAAACCAAAAGAAGCAATCAGCCCCAGCATTTTGGTGAT	CASSETKRSNQPQHF	1
GTGACATCGGCCCAAAAGAACCCGACAGCTTTCTATCTCTGTGCCAGTACTCGTCTGTTCATGAACACTGAAGCTTTCTTTGGACAA	CASTRLFMNTEAFF	1
AGGCTGCTGTCGGCTGCTCCCTCCCAGACATCTGTGTACTTCTGTGCCAGCAGGGGGACGGGAACCTACGAGCAGTACTTCGGGCCG	CASRGTGTYEQYF	1
AGGCTGGAGTCGGCTGCTCCCTCCCAGACATCTGTGTACTTCTGTGCCATACAGAGCCGACTGGGGTACGAGCAGTACTTCGGGCCG	CAIQSRLGYEQYF	1
GAGTCGGCTGCTCCCTCCCAAACATCTGTGTACTTCTGTGCCAGCAGTGGAGCGGGAGTCTCCTACAATGAGCAGTTCTTCGGGCCA	CASSGAGVSYNEQFF	1
CTGAGCTCTCTGGAGCTGGGGGACTCAGCTTTGTATTTCTGTGCCAGCAGCGTAGTCAGCCAGGTTAGCGGCTACACCTTCGGTTCG	CASSVVSQVSGYTF	1
CACGCCCTGCAGCCAGAAGACTCAGCCCTGTATCTCTGCGCCAGCAGCCCAGCGTGGGGTGTCAGCACTGAAGCTTTCTTTGGACAA	CASSPAWGVSTEAFF	1
CAGAGCAGGGGGACTCGGCCATGTATCTCTGTGCCAGCAGCTTACCCCCGACTAGCGGGAGCGGAGGAGACCCAGTACTTCGGGCCA		1
AGGCTGGAGTCAGCTGCTCCCTCCCAGACATCTGTGTACTTCTGTGCCAGCAGTCACCCCGCGACCACTGAAGCTTTCTTTGGACAA	CASSHPATTEAFF	1
CATCCTGAAGACAGCAGCTTCTACATCTGCAGTGCTAGTACGTTCGAAAGGGGACTGCTCTCTGGAAACACCATATATTTTGGAGAG	CSASTFERGLLSGNTIYF	2
TCGGCCCAAAAGAACCCGACAGCTTTCTATCTCTGTGCCAGTAGTATAGATCTGGGTCTAAAATACAATGAGCAGTTCTTCGGGCCA	CASSIDLGLKYNEQFF	1
ATCCAACCTGCAAAGCTTGAGGACTCGGCCGTGTATCTCTGTGCCAGCACCTCAGTTCATCCAGGCTACGAGCAGTACTTCGGGCCG	CASTSVHPGYEQYF	1
CGCACAGAGCAGCGGGACTCGGCCATGTATCGCTGTGCCAGCAGCTTAGCGGCGGGACAGGGGAATGCTGAAGCTTTCTTTGGACAA	CASSLAAGQGNAEAFF	1
ATCCAGCGCACAGAGCAGGGGGACTCGGCCATGTATCTCTGTGCCAGCAGCTCGTCCGGGCGCACAGATACGCAGTATTTTGGCCCA	CASSSSGRTDTQYF	1
GTGCGAGGAGATTCGGCAGCTTATTTCTGTGCCAGCTCACCGACGGCAGGGGGACCCTCGGGGAATTCACCCCTCCACTTTGGGAAC	CASSPTAGGPSGNSPLHF	1
TGAGCAACATGAGCCCTGAAGACAGCAGCATATATCTCTGCACCCCCCCGGGGTACAGGGATAGAATCACCCCTCCACTTTGGGAAC		1
TGCCCATCCTGAAGACAGCAGCTTCTACATCTGCAGTGCTAGAGTTGGAAAACCGGGACCCTAGGTCCACCCCTCCACTTTGGGAAC		2
GGAGTCCGCTACCAGCTCCCAGACATCTGTGTACTTCTGTGCCTCCTGAACTAGCGGCGCGACTACAATGAGCAGTTCTTCGGGCCA		1
TCGGCTGCTCCCTCCCAGACATCTGTGTACTTCTGTGCCAGCAGTTACTCGAGTGGCAGGGTGAACACTGAAGCTTTCTTTGGACAA	CASSYSSGRVNTEAFF	1
TGGAGCTTGGTGACTCTGCTGTGTATTTCTGTGCCAGCAGCAACTCTGCTCCCATTTTGGCATCATCAGCCCCAGCATTTTGGTGAT		1
TGTGAACGCCTTGTTGCTGGGGGACTCGGCCCTGTATCTCTGTGCCAGCAGATCTGGGGGGGTCAAAACACCATATATTTTGGAGAG		1
ACCAGTGCCCATCCTGAAGACAGCAGCTTCTACATCTGCAGTGCTAGTGGCGGGGGGGCCCCGGTAGATGAGCAGTTCTTCGGGCCA	CSASGGGAPVDEQFF	2
GAGTCGCCCAGCCCCAACCAGACCTCTCTGTACTTCTGTGCCAGCACCCCCGAGGCTAGTGGTTTGGGTGAGCAGTACTTCGGGCCG	CASTPEASGLGEQYF	1
GAGTCCGCCAGCACCAACCAGACATCTATGTACCTCTGTGCCAGCAGCCATACCGGGACAGGGAACTACGAGCAGTACTTCGGGCCG	CASSHTGTGNYEQYF	1
CTGCTGTCGGCTGCTCCCTCCCAGACATCTGTGTACTTCTGTGCCAGCAGGGGGATGAGGGGGACTCAGCCCCAGCATTTTGGTGAT	CASRGMRGTQPQHF	1
ATCCAGCCCTCAGAACCCAGGGACTCAGCTGTGTACTTCTGTGCCAGCAGTCAAACCGAAGGTAGTCAGCCCCAGCATTTTGGTGAT	CASSQTEGSQPQHF	1
GTGCAGCCTGCAGAACTGGAGGATTCTGGAGTTTATTTCTGTGCCAGCAGCCAAGCATACAGTAACACTGAAGCTTTCTTTGGACAA	CASSQAYSNTEAFF	1
AGGATCCAGCAGGTAGTGCGAGGAGATTCGGCAGCTTATTTCTGTGCCAGCTCACCCCCTAGCACAGATACGCAGTATTTTGGCCCA	CASSPPSTDTQYF	1
TGCTGTCGGCTGCTCCCTCCCAGACATCTGTGTACTTCTGTGCCAGCAGTTAGTGAGGTTTCCTACAATGAGCAGTTCTTCGGGCCA		1
GAGTCGGCTGCTCCCTCCCAGACATCTGTGTACTTCTGTGCCAGCAGAGAAGGTCCGGCGGGAGCCTACGAGCAGTACTTCGGGCCG	CASREGPAGAYEQYF	1
GCTGCTGTCGGCTGCTCCCTCCCAGACATCTGTGTACTTCTGTGCCAGCAGTCTTCTAGGGGGGAAAACATTCAGTACTTCGGCGCC		1
AGGATCCAGCAGGTAGTGCGAGGAGATTCGGCAGCTTATTTCTGTGCCAGCTCACTGGGGGAAGGTAATGGCTACACCTTCGGTTCG	CASSLGEGNGYTF	1
AACGCCTTGGAGCTGGACGACTCGGCCCTGTATCTCTGTGCCAGCAGCTTGGAGGCCCCGGGCGTCGAGACCCAGTACTTCGGGCCA	CASSLEAPGVETQYF	1
CTGGAGTCGCCCAGCCCCAACCAGACCTCTCTGTACTTCTGTGCCAGCAAGGGCCTCTTAAGGACAGATACGCAGTATTTTGGCCCA	CASKGLLRTDTQYF	1
GTGAGCACCTTGGAGCTGGGGGACTCGGCCCTTTATCTTTGCGCCAGCAGCTTGCCCTCAGGGGCAGATACGCAGTATTTTGGCCCA	CASSLPSGADTQYF	1
GCCCATCCTGAAGACAGCAGCTTCTACATCTGCAGTGCAACCCCTGGACTAGCGGCCGGTTGGACCGGGGAGCTGTTTTTTGGAGAA	CSATPGLAAGWTGELFF	1
CGCACACAGCAGGAGGACTCGGCCGTGTATCTCTGTGCCAGCAGCCATAGTAGCGGGGGGGCCGGTATTGAGCAGTTCTTCGGGCCA	CASSHSSGGAGIEQFF	1
AAGATCCAGCCCTCAGAACCCAGGGACTCAGCTGTGTACTTCTGTGCCAGCAGTCCGACCGCCAACTACGAGCAGTACTTCGGGCCG	CASSPTANYEQYF	1
ACCTTGGAGATCCAGTCCACGGAGTCAGGGGACACAGCACTGTATTTCTGTGCCAGCAGCAAGGTAGATGGCTACACCTTCGGTTCG	CASSKVDGYTF	1
TCAGCTACCCGCTCCCAGACATCTGTGTATTTCTGCGCCAGCAAGGACGATGGGGGACGTCAGAATCAGCCCCAGCATTTTGGTGAT	CASKDDGGRQNQPQHF	1
CTGTCGGCTGCTCCCTCCCAGACATCTGTGTACTTCTGTGCCAGCAACCCCTTTAGCGGGGCCCTCTACGAGCAGTACTTCGGGCCG	CASNPFSGALYEQYF	1
CCCTAGAGTCTGCCATCCCCAACCAGACAGCTCTTTACTTCTGTGCCGCCAGTGCCAGGACAGAACACTGAAGCTTTCTTTGGACAA		1
CAAAGCTGGAGGACTCAGCCATGTACTTCTGTGCCAGCAGTGAGAGGGACAGACCGTTTAGCCAAAAACATTCAGTACTTCGGCGCC		1
ACAGTGACCAGTGCCCATCCTGAAGACAGCAGCTTCTACATCTGCAGTGCTAGTAAGGGATCGGGTCAGCCCCAGCATTTTGGTGAT	CSASKGSGQPQHF	1
ACACAGCAGGAGGACTCCGCCGTGTATCTCTGTGCCAGCAGCTTAGCTGTTCAGGGCGGGTTGAACACTGAAGCTTTCTTTGGACAA	CASSLAVQGGLNTEAFF	1
AACGCCTTGGAGCTGGACGACTCGGCCCTGTATCTCTGTGCCAGCATCACGATCGACTAGCCTCTCTACGAGCAGTACTTCGGGCCG	CASITID*PLYEQYF	1
GAGTCAGCTACCCGCTCCCAGACATCTGTGTATTTCTGCGCCAGCTATAGGGGTGGGCCCCGATACAATGAGCAGTTCTTCGGGCCA	CASYRGGPRYNEQFF	1
AGCACCTTGGAGCTGGGGGACTCGGCCCTTTATCTTTGCGCCAGCAGCCAAGGCGACAGTTTGTACGAAAAACTGTTTTTTGGCAGT	CASSQGDSLYEKLFF	1
GTGAGCACCTTGGAGCTGGGGGACTCGGCCCTTTATCTTTGCGCCAGCAGAGGGACAGGGGGATTAGATACGCAGTATTTTGGCCCA	CASRGTGGLDTQYF	1
CAGCCCTCAGAACCCAGGGGCTCAGCTGTGTATTTTTGTGCTAGTGGTTCCTTGAGGACAGGGGGTCAGCCCCAGCATTTTGGTGAT	CASGSLRTGGQPQHF	1
CTACACACCCTGCAGCCAGAAGACTCGGCCCTGTATCTCTGTGCCAGCAGCCAATCTTTACAGGACACTGAAGCTTTCTTTGGACAA	CASSQSLQDTEAFF	1
GTCCGCTACCAGCTCCCAGACATCTGTGTACTTCTGTGCCATCAGTGAGTCCAAGGGACAGGGGGTTCACCCCTCCACTTTGGGAAC		1
ATCCAGCAGGTAGTGCGAGGAGATTCGGCAGCTTATTTCTGTGCCAGCTCACCCGGGACAGCTAATGAAAAACTGTTTTTTGGCAGT	CASSPGTANEKLFF	1
CTGACTGTGAGCAACATGAGCCCTGAAGACAGCAGCATATATCTCTGCAGCGGGCGGGACAGTGTCTACGAGCAGTACTTCGGGCCG	CSGRDSVYEQYF	2
TTGGAGTCGGCTGCTCCCTCCCAAACATCTGTGTACTTCTGTGCCAGCTACTACAGGGGGCGGACCGGGGAGCTGTTTTTTGGAGAA	CASYYRGRTGELFF	1
AATGTGAGCACCTTGGAGCTGGGGGACTCGGCCCTTTATCTTTGCGCCAGCAGCTTGGGGCAGATCTATGGCTACACCTTCGGTTCG	CASSLGQIYGYTF	1
GAGTCGGCTGCTCCCTCCCAAACATCTGTGTACTTCTGTGCCAGCAGTTACTCGTTGTCAGGGAACCCTGAAGCTTTCTTTGGACAA	CASSYSLSGNPEAFF	2
CAGTGCCCATCCTGAAGACAGCAGCTTCTACATCTGCAGAGCCGGGACAGGGGAGCGTGGAACACCGGGGAGCTGTTTTTTGGAGAA		1
ATCCAGCGCACACAGCAGGAGGACTCGGCCGTGTATCTCTGTGCCAGCAGCCCTCACGGCAGTCCCTTTGAAGCTTTCTTTGGACAA	CASSPHGSPFEAFF	1
AGTGACCAGTGCCCATCCTGAAGACAGCAGCTTCTACATCTGCAGTGCCTTTGGGGGGCACCGAACTATGGCTACACCTTCGGTTCG		1
AGGCTGCTGTCGGCTGCTCCCTCCCAGACATCTGTGTACTTCTGTGCCAGCAGAGGTACTAACAATCAGCCCCAGCATTTTGGTGAT	CASRGTNNQPQHF	1
GAGTCCGCCAGCACCAACCAGACATCTATGTACCTCTGTGCCAGCAGTAAGACAGGGACCCAAAATCAGCCCCAGCATTTTGGTGAT	CASSKTGTQNQPQHF	1
TGGAGCTGGGGGACTCGGCCCTTTATCTTTGCGCCAGCAGCTTGTTTCGGGATAGAGGATGGGGACACTGAAGCTTTCTTTGGACAA		1
ACAGTGACCAGTGCCCATCCTGAAGACAGCAGCTTCTACATCTGCAGTGCTAGGTGGGGGGCCTTGCAAGGCTACACCTTCGGTTCG	CSARWGALQGYTF	1
AAGATCCGGTCCACAAAGCTGGAGGACTCAGCCATGTACTTCTGTGCCACGAAACAGGGGTCGACAGATACGCAGTATTTTGGCCCA	CATKQGSTDTQYF	1
CAGCCCTCAGAACCCAGGGACTCAGCTGTGTACTTCTGTGCCAGCAGTGCGGGACTTTCAATCTACAATGAGCAGTTCTTCGGGCCA	CASSAGLSIYNEQFF	1
CCAGCGCACAGAGCAGGGGGACTCAGCCGCGTATCTCCGTGCCAGCAGCAGAGACCAGCCACCTACAATGAGCAGTTCTTCGGGCCA		1
ATTCTGGAGTCCGCCAGCACCAACCAGACATCTATGTACCTCTGTGCCAGCCAAAGGGCACCTTCCTACGAGCAGTACTTCGGGCCG	CASQRAPSYEQYF	1
ACCAGTGCCCATCCTGAAGACAGCAGCTTCTACATCTGCAGTGCTAGAATGCCTAGCGGGGGGCAAGAGACCCAGTACTTCGGGCCA	CSARMPSGGQETQYF	1
TGGGGGACTCGGCCCTTTATCTTTGCGCCAGCAGCTTGGCCCCCTAGCGGGGGACACCCCATTCGAGATACGCAGTATTTTGGCCCA		1
ACCTTGGAGCTGGGGGACTCGGCCCTTTATCTTTGCGCCAGCAGCCCAGCCAGCGGGACTGCCTCCTACGAGCAGTACTTCGGGCCG	CASSPASGTASYEQYF	1
AGTGCCCATCCTGAAGACAGCAGCTTCTACATCTGCAGTGCTAGAGATTACCGGCGGGAGAGTTACAACGAGCAGTTCTTCGGGCCA	CSARDYRRESYNEQFF	1
CAGCGCACACAGCAGGAGGACTCGGCCGTGTATCTCTGTGCCAGCAGCTTTCAGGGACAGGCAAGCCGTGGCTACACCTTCGGTTCG	CASSFQGQASRGYTF	1
GTGACATCGGCCCAAAAGAACCCGACAGCTTTCTATCTCTGTGCCAGTAGATTCCAGGGGGACAATCAGCCCCAGCATTTTGGTGAT	CASRFQGDNQPQHF	1
CAGCCAGAAGACTCAGCCCTGTATCTCTGCGCCAGCAGCCAATACTCCGGGACAGGAGACTCTGGAAACACCATATATTTTGGAGAG	CASSQYSGTGDSGNTIYF	1
CTGAATGTGAACGCCTTGTTGCTGGGGGACTCGGCCCTCTATCTCTGTGCCAGCAGCTTGAACATCGAGGGCTACACCTTCGGTTCG	CASSLNIEGYTF	1
CTGAAGATCCGGTCCACAAAGCTGGAGGACTCAGCCATGTACTTCTGTGCCAGCAGTGAAATAGGGAGCGAGCAGTACTTCGGGCCA	CASSEIGSEQYF	1
ACCCTGGAGTCTGCCAGGCCCTCACATACCTCTCAGTACCTCTGTGCCAGCAGTGCCAGGAGTGGGGGCGAGCAGTACTTCGGGCCA	CASSARSGGEQYF	1
CTGGAGTCGCCCAGCCCCAACCAGACCTCTCTGTACTTCTGTGCCAGCAGAAACAGGGGGCAGGGGCAGCCCCAGCATTTTGGTGAT	CASRNRGQGQPQHF	1
AGGCTGCTGTCGGCTGCTCCCTCCCAGACATCTGTGTACTTCTGTGCCAGCAGTGTCTCCAGGAACACTGAAGCTTTCTTTGGACAA	CASSVSRNTEAFF	1
GAGTCTGCTGCCTCCTCCCAGACATCTGTATATTTCTGCGCCAGCAGTGATGACAGGGGGGGAAACACTGAAGCTTTCTTTGGACAA	CASSDDRGGNTEAFF	1
CGGCTGCTCCCTCCCAGACATCTGTGTACTTCTGTGCCAGCAGCAGACGAGGACAGGGGGTCGGAAAATGAGCAGTTCTTCGGGCCA		1
GCAGAGCTTGGGGACTCGGCCGTGTATCTCTGTGCCAGCAGGCGACCCCGTCGGCAGGCGAACGCCTACGAGCAGTACTTCGGGCCG	CASRRPRRQANAYEQYF	1
GTGAGCACCTTGGAGCTGGGGGACTCGGCCCTTTATCTTTGCGCCAGCAGCTTTCGACTAGATTCCTACGAGCAGTACTTCGGGCCG	CASSFRLDSYEQYF	1
ATCCAGCCTGCAGAGCTTGGGGACTCGGCCATGTATCTCTGTGCCAGCAGCTATGGACAGATGAACACTGAAGCTTTCTTTGGACAA	CASSYGQMNTEAFF	1
CAGTGACCAGTGCCCATCCTGAAGACAGCAGCTTCTACATCTGCAGTGCAAGTCTTGGACTAGGGGTATGAGCAGTTCTTCGGGCCA		1
AAGATCCAGCCTGCAAAGCTTGAGGACTCGGCCGTGTATCTCTGTGCCAGCAGCACGGGACAGACCTACGAGCAGTACTTCGGGCCG	CASSTGQTYEQYF	1
ATCCAGCGCACAGAGCAGGGGGACTCGGCCATGTATCTCTGTGCCAGCAGCCGACAGGGTCTTAACACTGAAGCTTTCTTTGGACAA	CASSRQGLNTEAFF	1
GAACTAAACCTGAGCTCTCTGGAGCTGGGGGACTCAGCTTTGTATTTCTGTGCCAGCAGCGTAGCGGAGACCCAGTACTTCGGGCCA	CASSVAETQYF	1
ATCCGGTCCACAAAGCTGGAGGACTCAGCCATGTACTTCTGTGCCAGCAGTCCAGGGGGCTATAATGAAAAACTGTTTTTTGGCAGT	CASSPGGYNEKLFF	1
ATCCAGCAGGTAGTGCGAGGAGATTCGGCAGCTTATTTCTGTGCCAGCGGGAGTTCGCCTTCGACAGATACGCAGTATTTTGGCCCA	CASGSSPSTDTQYF	1
CAGCCCTCAGAACCCAGGGACTCAGCTGTGTACTTCTGTGCCAGCAGTTTAGCGAGTACAGGGAGGAACGAGCAGTACTTCGGGCCG	CASSLASTGRNEQYF	1
ATCCAGCCCTCAGAACCCAGGGACTCAGCTGTGTACTTCTGTGCCAGCAGGGGGACAGGGGTCGGAAACACCATATATTTTGGAGAG	CASRGTGVGNTIYF	1
AGCAACATGAGCCCTGAAGACAGCAGCATATATCTCTGCAGCGTTGCCCCCGCGGGAGGGCTGAGGGATACGCAGTATTTTGGCCCA	CSVAPAGGLRDTQYF	1
AAGATCCAGCCCTCAGAACCCAGGGACTCAGCTGTGTACTTCTGTGCCAGCCGGTCTCACTCTGGAAACACCATATATTTTGGAGAG	CASRSHSGNTIYF	1
ACCAGTGCCCATCCTGAAGACAGCAGCTTCTACATCTGCAGTGCCAGGCAAATCGGCGACTCCTACAATGAGCAGTTCTTCGGGCCA	CSARQIGDSYNEQFF	1
CTGGAGTCGGCTGCTCCCTCCCAGACATCTGTGTACTTCTGTGCCTCAAATGAGAGGGCATTTGGAACTGAAGCTTTCTTTGGACAA	CASNERAFGTEAFF	1
CAGCCTGCAAAGCTTGAGGACTCGGCCGTGTATCTCTGTGCCAGCAGCTTAGTTCCGGGAGCGGACTACGAGCAGTACTTCGGGCCG	CASSLVPGADYEQYF	1
CACATCAATTCCCTGGAGCTTGGTGACTCTGCTGTGTATTTCTGTGCCAGCATCCCCGACAGCTCCTACGAGCAGTACTTCGGGCCG	CASIPDSSYEQYF	1
CTGCTGTCGGCTGCTCCCTCCCAGACATCTGTGTACTTCTGTGCCAGCAGTCCCGGGCCCTTTCTCACTGAAGCTTTCTTTGGACAA	CASSPGPFLTEAFF	1
GAGCTGAATGTGAACGCCTTGGAGCTGGACGACTCGGCCCTGTATCTCTGTGCCAGCAGCTCGGCTAGCGAGCAGTTCTTCGGGCCA	CASSSASEQFF	1
ATCCAGCCCTCAGAACCCAGGGACTCAGCTGTGTACTTCTGTGCCAGCAGTTTTAGGGGAGACACCGGGGAGCTGTTTTTTGGAGAA	CASSFRGDTGELFF	2
GCCTTGGAGCTGGACGACTCGGCCCTGTATCTCTGTGCCAGCAGCTTGGTACGGGGGGGCGATGCAGATACGCAGTATTTTGGCCCA	CASSLVRGGDADTQYF	1
TGGAGTCGGCTGCTCCCTCCCAAACATCTGTGTACTTCTGTGCCAGCAGTTCGGGACTGGGGAGATGAAAAACTGTTTTTTGGCAGT		1
TCCGCCAGCACCAACCAGACATCTATGTACCTCTGTGCCAGCAGCGGGGCTAGCGGGACTGGCCGAGATACGCAGTATTTTGGCCCA	CASSGASGTGRDTQYF	1
GGAGCTGGGGGACTCGGCCCTGTATCTCTGTGCCAGAAGCTTGGAATGGGCCCAGGGCCTGATGACTACGAGCAGTACTTCGGGCCG		1
ACCAGTGCCCATCCTGAAGACAGCAGCTTCTACATCTGCAGTGCTAGATTATGGGTTTCTGGGGCCAACGTCCTGACTTTCGGGGCC	CSARLWVSGANVLTF	3
GCCCTGCAGCCAGAAGACTCAGCCCTGTATCTCTGCGCCAGCAGCCAAGGATACAGGGGAATAAACACTGAAGCTTTCTTTGGACAA	CASSQGYRGINTEAFF	1
CACCTACACGCCCTGCAGCCAGAAGACTCAGCCCTGTATCTCTGCGCCAGCAGGGGGGCCATTCTCTATGGCTACACCTTCGGTTCG	CASRGAILYGYTF	1
GCCCAAAAGAACCCGACAGCTTTCTATCTCTGTGCCAGTAGTATAGATCCGAGGGCGGTTCCCTACAATGAGCAGTTCTTCGGGCCA	CASSIDPRAVPYNEQFF	1
GTGAACGCCTTGTTGCTGGGGGACTCGGCCCTGTATCTCTGTGCCAGCAGCTTAGGCCCGACGGAAGAGACCCAGTACTTCGGGCCA	CASSLGPTEETQYF	1
AATGTGAACGCCTTGGAGCTGGACGACTCGGCCCTGTATCTCTGTGCCAGCAGTCTACAGGGGGCGCGGGGCTACACCTTCGGTTCG	CASSLQGARGYTF	1
ATCCAGCGCACAGAGCAGCGGGACTCGGCCATGTATCGCTGTGCCAGCAGCCGGACAGGGCAGGGGGAAAAACTGTTTTTTGGCAGT	CASSRTGQGEKLFF	1
CTGGAGTCGGCTGCTCCCTCCCAGACATCTGTGTACTTCTGTGCCAGCAGAGGGCGGGACAGGGGCTATGGCTACACCTTCGGTTCG	CASRGRDRGYGYTF	1
AGCTCTCTGGAGCTGGGGGACTCAGCTTTGTATTTCTGTGCCAGCAGCAAAAGCCGGGACAGCGCTTCACCCCTCCACTTTGGGAAC	CASSKSRDSASPLHF	1
CTTGGAGATCCAGCGCACAGAGCAGGGGGACTCGGCCATGTATCTCTGTGCCAGCAGCCCTCAAGCAATGAGCAGTTCTTCGGGCCA		1
GAGTCTGCTGCCTCCTCCCAGACATCTGTATATTTCTGCGCCAGCAGTGACACGGGAGGGCCAAGAGATACGCAGTATTTTGGCCCA	CASSDTGGPRDTQYF	1
AGATCCAGCGCACAGAGCAGGGGGACTCAGCCGCGTATCTCCGTGCCAGCACCTCGACAGGGTCACTATGGCTACACCTTCGGTTCG		1
ATCCAGCGCACACAGCAGGAGGACTCCGCCGTGTATCTCTGTGCCAGCAGCTTAGCCCCGTCGGGAAACACCATATATTTTGGAGAG	CASSLAPSGNTIYF	2
TCTCTGGAGCTGGGGGACTCAGCTTTGTATTTCTGTGCCAGCAGCGTAGGGACAAGCCACTCTGGAAACACCATATATTTTGGAGAG	CASSVGTSHSGNTIYF	1
ACCCTGCAGCCAGAAGACTCGGCCCTGTATCTCTGCGCCAGCAGCCAAGTTGGCGGAGGCTCCTACAATGAGCAGTTCTTCGGGCCA	CASSQVGGGSYNEQFF	1
GTGAGCACCTTGGAGCTGGGGGACTCGGCCCTTTATCTTTGCGCCAGCAGCTTGATACGAGGATCCTACGAGCAGTACTTCGGGCCA	CASSLIRGSYEQYF	1
GAGTTGGCTGCTCCCTCCCAGACATCTGTGTACTTCTGTGCCAGCAGTCCGGGACTAGAGATCACAGATACGCAGTATTTTGGCCCA	CASSPGLEITDTQYF	1
GCTCTCTGGAGCTGGGGGACTCAGCTTTGTATTTCTGTGCCAGCAGCGTAGGTGGGGAGGGGTAATGAAAAACTGTTTTTTGGCAGT		1
GTGAGCACCTTGGAGCTGGGGGACTCGGCCCTTTATCTTTGCGCCAGCAGCTTGCCGGGGGGCCTTGGGGAGCAGTACTTCGGGCCG	CASSLPGGLGEQYF	1
CAGGGGGACTCGGCCGTGTATGTCTGTGCAAGTCGCTTAGCTTCCCAGAGACTGGGCCAAAGCAATCAGCCCCAGCATTTTGGTGAT	CASRLASQRLGQSNQPQHF	1
CTGCTGTCGGCTGCTCCCTCCCAGACATCTGTGTACTTCTGTGCCAGCAGTTGGACTAGCGGGAGCCACGAGCAGTACTTCGGGCCG	CASSWTSGSHEQYF	1
CCTGCAAAGCTTGAGGACTCGGCCGTGTATCTCTGTGCCAGCAGCTTGGGACTAGCGGGGGCCCGGGAGACCCAGTACTTCGGGCCA	CASSLGLAGARETQYF	1
GTGACCAGTGCCCATCCTGAAGACAGCAGCTTCTACATCTGCAGTGCTAGAAAGGGACATTCTAACTATGGCTACACCTTCGGTTCG	CSARKGHSNYGYTF	1
GAATGTGAGCACCTTGGAGCTGGGGGACTCGGCCCTTTATCTTTGCGCCAGCAGCCTAGACTCGGTGGGGAGCAGTACTTCGGGCCG		1
CTGCTGTCGGCTGCTCCCTCCCAGACATCTGTGTACTTCTGTGCCAGCAGTCCACAGACAGGGTCCTACGAGCAGTACTTCGGGCCG	CASSPQTGSYEQYF	1
ATCCAGCGCACACAGCAGGAGGACTCGGCCGTGTATCTCTGTGCCAGCACCCCCAGGGGGGAAGACTATGGCTACACCTTCGGTTCG	CASTPRGEDYGYTF	1
ATGAATGTGGGCACCTTGGAGCTGGGGGACTCGGCCCTTTATCTTTGCGCCAGCCCCATGGGGGCGTCTGAAGCTTTCTTTGGACAA	CASPMGASEAFF	1
CTGGAGTTGGCTGCTCCCTCCCAGACATCTGTGTACTTCTGTGCCAGCAGCGTCGGGACAGGGCCTGAAAAACTGTTTTTTGGCAGT	CASSVGTGPEKLFF	1
GAGTCGGCTGCTCCCTCCCAAACATCTGTGTACTTCTGTGCCAGCAGCCCGCAGTTTAATGCTCGAGAGACCCAGTACTTCGGGCCA	CASSPQFNARETQYF	1
CTGCTGTCGGCTGCTCCCTCCCAGACATCTGTGTACTTCTGTGCCAGCAGTTCAGCTCGGAACTCCTACGAGCAGTACTTCGGGCCG	CASSSARNSYEQYF	1
CTGGAGTCTGCTGCCTCCTCCCAGACATCTGTATATTTCTGCGCCAGCAGCGACTCCCCTGTCTCCGGGGAGCTGTTTTTTGGAGAA	CASSDSPVSGELFF	1
AACGCCTTGTTGCTGGGGGACTCGGCCCTCTATCTCTGTGCCAGCAGCGCGGGACTAGTGGGGACAGATACGCAGTATTTTGGCCCA	CASSAGLVGTDTQYF	1
CGCACACAGCAGGAGGACTCGGCCGTGTATCTCTGTGCCAGCCAACTTCGAGGCGGGACAGGGACCTACGAGCAGTACTTCGGGCCG	CASQLRGGTGTYEQYF	1
ATCCAGCGCACACAGCAGGAGGACTCCGCCGTGTATCTCTGTGCCAGCAGCTTAGAGGGACAAGACTACGAGCAGTACTTCGGGCCG	CASSLEGQDYEQYF	1
CCTGCAGAACTGGAGGATTCTGGAGTTTATTTCTGTGCCAGCAGCGCAATAATGGGGGTGGGGTCCAATGAGCAGTTCTTCGGGCCA	CASSAIMGVGSNEQFF	1
AGGCTGCTGTCGGCTGCTCCCTCCCAGACATCTGTGTACTTCTGTGCCAGCAGGGAACGGATTCTTAGAGGCTACACCTTCGGTTCG	CASRERILRGYTF	1
CTGTCGGCTGCTCCCTCCCAGACATCTGTGTACTTCTGTGCCAGCAGTTCCCGGGACAGGGGTACCTACGAGCAGTACTTCGGGCCG	CASSSRDRGTYEQYF	1
AACTGGAGGATTCTGGAGTTTATTTCTGTGCCAGCAGCCAAGATCGGACCACCCCCGTTTGCAACCGGGGAGCTGTTTTTTGGAGAA		1
AGGCTGCTGTCGGCTGCTCCCTCCCAGACATCTGTGTACTTCTGTGCCACAGCGGTACACCGGAATCAGCCCCAGCATTTTGGTGAT	CATAVHRNQPQHF	1
TGGAGTCCGCCAGCACCAACCAGACATCTATGTACCTCTGTGCCTAGCCAGACTCGGGTATCCTACAATGAGCAGTTCTTCGGGCCA		1
CTGGAGCTGGGGGACTCAGCTTTGTATTTCTGTGCCAGCAGCGTATCGGTAACGGGAGCTAGCACAGATACGCAGTATTTTGGCCCA	CASSVSVTGASTDTQYF	1
CTGTCGGCTGCTCCCTCCCAGACATCTGTGTACTTCTGTGCCAGCAGCCAACTCCGGGGGAGGGACCAGCCCCAGCATTTTGGTGAT	CASSQLRGRDQPQHF	2
AAGATCCAGCCCTCAGAACCCAGGGACTCAGCTGTGTACTTCTGTGCCAGCAGGAATCAAATGAACACTGAAGCTTTCTTTGGACAA	CASRNQMNTEAFF	1
TGACCAGTGCCCATCCTGAAGACAGCAGCTTCTACATCTGCAGTGCTGGAAACAGGGGTGAGCTCCTACGAGCAGTACTTCGGGCCG		1
AAGATCCAGCGCACACAGCAGGAGGACTCCGCCGTGTATCTCTGTGCCAGCAGCTTAGTCGGGAACACTGAAGCTTTCTTTGGACAA	CASSLVGNTEAFF	1
ACAGTGACCAGTGCCCATCCTGAAGACAGCAGCTTCTACATCTGCAGTGCTACGCCTGTATTGCTCACTGAAGCTTTCTTTGGACAA	CSATPVLLTEAFF	1
ACATCGGCCCAAAAGAACCCGACAGCTTTCTATCTCTGTGCCAGTAGTATAGTCAGGGTTAGGAACACTGAAGCTTTCTTTGGACAA	CASSIVRVRNTEAFF	1
ACTGTGACATCGGCCCAAAAGAACCCGACAGCTTTCTATCTCTGTGCCAGTAGCACTATTACAGGCTACGAGCAGTACTTCGGGCCG	CASSTITGYEQYF	1
CAGCCCTCAGAACCCAGGGACTCAGCTGTGTACTTCTGTACCAGCAGTTTATGGACAGGGGGCATGGGTGGCTACACCTTCGGTTCG	CTSSLWTGGMGGYTF	1
CTGATTCTGGAGTCCGCCAGCACCAACCAGACATCTATGTACCTCTGTGCCAGCAGTTTAGGGAGTTACGAGCAGTACTTCGGGCCG	CASSLGSYEQYF	1
GTGCGAGGAGATTCGGCAGCTTATTTCTGTGCCAGCTCACCCCAACCGACAGGAGGTGGCTCTGGAAACACCATATATTTTGGAGAG	CASSPQPTGGGSGNTIYF	1
GGGTTGGAGTCGGCTGCTCCCTCCCAAACATCTGTGTACTTCTGTGCCAGCAGCCGTACAGGTTCCGCTGAAGCTTTCTTTGGACAA	CASSRTGSAEAFF	1
AGTGCCCATCCTGAAGACAGCAGCTTCTACATCTGCAGTGCTAGATGGACTAGCGGGAGTACGGGAAATGAGCAGTTCTTCGGGCCA	CSARWTSGSTGNEQFF	1
ATCCAGCAGGTAGTGCGAGGAGATTCGGCAGCTTATTTCTGTGCCAGCTCCCGCCGGACGCGCACAGATACGCAGTATTTTGGCCCA	CASSRRTRTDTQYF	1
GAGTCCGCCAGCACCAACCAGACATCTATGTACCTCTGTGCCAGCAGCGCCCACACAGGGGGATACACTGAAGCTTTCTTTGGACAA	CASSAHTGGYTEAFF	1
AAGGTGCAGCCTGCAGAACTGGAGGATTCTGGAGTTTATTTCTGTGCCAGCAGTCCTCAAGAGAACACTGAAGCTTTCTTTGGACAA	CASSPQENTEAFF	1
GTGCGAGGAGATTCGGCAGCTTATTTCTGTGCCAGCTCCCCTGGGACTAGCGGGGGAACTAGCACAGATACGCAGTATTTTGGCCCA	CASSPGTSGGTSTDTQYF	1
AGTCGCCCAGCCCCAACCAGACCTCTCTGTACTTCTGTGCCAGCAGGGGACAGGCGGCCGAGCTCCTACGAGCAGTACTTCGGGCCG		1
AGCACCTTGGAGCTGGGGGACTCGGCCCTTTATCTTTGCGCCAGCAGCGGGGGGGACAGGGGGTTCTACGGCTACACCTTCGGTTCG	CASSGGDRGFYGYTF	2
CTGGAGTCCGCTACCAGCTCCCAGACATCTGTGTACTTCTGTGCCGCACAGGGGGGAAATAGCAATCAGCCCCAGCATTTTGGTGAT	CAAQGGNSNQPQHF	1
TCCAGCAGGTAGTGCGAGGAGATTCGGCAGCTTATTTCTGTGCCAGCTCATCCGGCAGGGGGCGCTTTGGGCTACACCTTCGGTTCG		1
TACACACCCTGCAGCCAGAAGACTCGGCCCTGTATCTCTGCGCCAGCAGCCCCTTTTGGGGTATAAGACGAGCAGTACTTCGGGCCG		1
ACCAGTGCCCATCCTGAAGACAGCAGCTTCTACATCTGCAGTGCTAGTAAAAACAGGGGTAGCAATCAGCCCCAGCATTTTGGTGAT	CSASKNRGSNQPQHF	1
CAAAAGAACCCGACAGCTTTCTATCTCTGTGCCAGTAGTATAGACGCGGGACAGAGGTATAGCAATCAGCCCCAGCATTTTGGTGAT	CASSIDAGQRYSNQPQHF	1
ACTGTGAGCAACATGAGCCCTGAAGACAGCAGCATATATCTCTGCAGCGTAAATCAGGGGGCAGGTCAGCCCCAGCATTTTGGTGAT	CSVNQGAGQPQHF	1
GCTGCTCCCTCCCAAACATCTGTGTACTTCTGTGCCAGCAGACCTACGTATGGTGGCCCCTCGTTTTACGAGCAGTACTTCGGGCCG	CASRPTYGGPSFYEQYF	1
CGCACAGAGCAGCGGGACTCGGCCATGTATCGCTGTGCCAGCAGCCCCCTAGGGACAGTGTTTTCGGAGACCCAGTACTTCGGGCCA	CASSPLGTVFSETQYF	1
AACGCCTTGTTGCTGGGGGACTCGGCCCTGTATCTCTGTGCCAGCAGTAGCGGGGGGCGCGGGTACAATGAGCAGTTCTTCGGGCCA	CASSSGGRGYNEQFF	1
CTGATTCTGGAGTCCGCCAGCACCAACCAGACATCTATGTACCTCTGTGCCAGCAGTCGGACCAATCAGCCCCAGCATTTTGGTGAT	CASSRTNQPQHF	1
GTGACATCGGCCCAAAAGAACCCGACAGCTTTCTATCTCTGTGCCAGTAGAGGCAGGGCGGCGGACTACGAGCAGTACTTCGGGCCG	CASRGRAADYEQYF	1
AGCACCTTGGAGCTGGGGGACTCGGCCCTTTATCTTTGCGCCAGCAGCTTGGATGCTCAGGGGCACTATGGCTACACCTTCGGTTCG	CASSLDAQGHYGYTF	1
ACTGTGAGCAACATGAACCCTGAAGACAGCAGCATATATCTCTGCAGCGCGAATAGGGGGAGCACAGATACGCAGTATTTTGGCCCA	CSANRGSTDTQYF	1
CTCAGGCTGGAGTCGGCTGCTCCCTCCCAGACATCTGTGTACTTCTGTGCCACAGGGGTTAAAGGCGGGGAGCTGTTTTTTGGAGAA	CATGVKGGELFF	1
GCACAGAGCAAGGGCGACTCGGCTGTGTATCTCTGTGTCAGAAGCTTAGTAGGCTAGCCCTCCCAAGAGACCCAGTACTTCGGGCCA	CVRSLVG*PSQETQYF	1
AGCACCTTGGAGCTGGGGGACTCGGCCCTTTATCTTTGCGCCAGCAGCTTTGATGCCGACAGAATCTACGAGCAGTACTTCGGGCCG	CASSFDADRIYEQYF	1
AGCACCTTGGAGCTGGGGGACTCGGCCCTTTATCTTTGCGCCAGCAGCTCCCGCCCGGGGACGGCCTACGAGCAGTACTTCGGGCCG	CASSSRPGTAYEQYF	1
GTGAGCACCTTGGAGCTGGGGGACTCGGCCCTTTATCTTTGCGCCAGCAGTTGGGACAGGGAATTCTACGAGCAGTACTTCGGGCCG	CASSWDREFYEQYF	1
ACTGTGACATCGGCCCAAAAGAACCCGACAGCTTTCTATCTCTGTGCCAGTAGTATAGGCACGGCCTATGGCTACACCTTCGGTTCG	CASSIGTAYGYTF	1
CACACCCTGCAGCCAGAAGACTCGGCCCTGTATCTCTGTGCCAGCAGCCAAGCACAGTCGGCGAACTATGGCTACACCTTCGGTTCG	CASSQAQSANYGYTF	1
GCCTGCAGAGCTTGGGGACTCGGCCGTGTATCTCTGTGCCAGCAGCTTAGATTTAGGGTTAGCAATCAGCCCCAGCATTTTGGTGAT		1
GTGAGCACCTTGGAGCTGGGGGACTCGGCCCTTTATCTTTGCGCCAGCAGCTTTACGACAGGGGGCAGGGAGCTGTTTTTTGGAGAA	CASSFTTGGRELFF	1
CAGCCCTCAGAACCCAGGGACTCAGCTGTGTACTTCTGTGCCAGCAGTCGGGACAGGGCGAACACCGGGGAGCTGTTTTTTGGAGAA	CASSRDRANTGELFF	1
GTGAGCACCTTGGAGCTGGGGGACTCGGCCCTTTATCTTTGCGCCAGCAGCCGAACAGGGGGCCGGACTGAAGCTTTCTTTGGACAA	CASSRTGGRTEAFF	1
GAGTCGGCTGCTCCCTCCCAGACATCTGTGTACTTCTGTGCCAGCAGGACAGGGGGCTCTGGGGCCAACGTCCTGACTTTCGGGGCC	CASRTGGSGANVLTF	1
ATCCAGCCCTCAGAACCCAGGGACTCAGCTGTGTACTTCTGTGCCAGCAGCCTAGACAGGGGGCGCAATGGCTACACCTTCGGTTCG	CASSLDRGRNGYTF	1
AGTCAGGGGACACAGCACTGTATTTCTGTGCCAGCAGCTTCGGGGACAGGGGCTTTACTAAGCACAGATACGCAGTATTTTGGCCCA		1
AGTCTGCCAGGCCCTCACATACCTCTCAGTACCTCTGTGCCAGCAGTCCGCCTCCGGGACGTAAACTATGGCTACACCTTCGGTTCG		1
CTGACTGTGAGCAACATGAGCCCTGAAGACAGCAGCATATATCTCTGCAGCGTTGTGGCTACATCCTACGAGCAGTACTTCGGGCCG	CSVVATSYEQYF	1
GTGACATCGGCCCAAAAGAACCCGACAGCTTTCTATCTCTGTGCCAGCGCGGACAGAGCCTCCTACAATGAGCAGTTCTTCGGGCCA	CASADRASYNEQFF	1
TTGGAGATCCAGCGCACAGAGCAGGGGGACTCGGCCATGTATCTCTGTGCCAGCAGCGGTTCGGAAGATACGCAGTATTTTGGCCCA	CASSGSEDTQYF	1
CTGAAGATCCAGCCCTCAGAACCCAGGGACTCAGCTGTGTACTTCTGTGCCAGCAGTTTAAGAGGAGGGTGGCAGTACTTCGGGCCG	CASSLRGGWQYF	1
CTGGAGTCCGCTACCAGCTCCCAGACATCTGTGTACTTCTGTGCCATCATGTCGGCGGGACAGAACTATGGCTACACCTTCGGTTCG	CAIMSAGQNYGYTF	1
CCACGGAGTCAGGGGACACAGCACTGTATTTCTGTGCCAGCAGCAAAGCGCTGAGACAGGGGGCCCTACGAGCAGTACTTCGGGCCA		1
CTGGAGTCGCCCAGCCCCAACCAGACCTCTCTGTACTTCTGTGCCAGCAGTTTAGATCGGCGCAGGGCTGGCTACACCTTCGGTTCG	CASSLDRRRAGYTF	1
CTGTCGGCTGCTCCCTCCCAGACATCTGTGTACTTCTGTGCCAGCAGTTACTCGGCAGGGGGACTCCACGAGCAGTACTTCGGGCCG	CASSYSAGGLHEQYF	1
CTGAGTTCTAAGAAGCTCCTTCTCAGTGACTCTGGCTTCTATCTCTGTGCCTGGGCTCTTGGTCAAGAGACCCAGTACTTCGGGCCA	CAWALGQETQYF	1
AAGATCCAGCCCTCAGAACCCAGGGACTCAGCTGTGTACTTCTGTGCCAGCATCACGACAGGGGAAAATGAGCAGTTCTTCGGGCCA	CASITTGENEQFF	1
AAGATCCAGCCCTCAGAACCCAGGGACTCAGCTGTGTACTTCTGTGCCAGCGGGGGGCAGACGAACACTGAAGCTTTCTTTGGACAA	CASGGQTNTEAFF	1
ATCCAGCGCACACAGCAGGAGGACTCGGCCGTGTATCTCTGTGCCAGCAGCTCTTTGGACAGGGAAGGGACCCAGTACTTCGGGCCA	CASSSLDREGTQYF	1
CAGGTAGCGCGAGGAGATTCGGCAGCTTATTTCTGTGCCAGCTCACCACCATCTCTCGGGTTTGGTGAAAAACTGTTTTTTGGCAGT	CASSPPSLGFGEKLFF	1
CTGCTGTCGGCTGCTCCCTCCCAGACATCTGTGTACTTCTGTGCCAGCAGTTACCAGGGGACGGGGACTGAAGCTTTCTTTGGACAA	CASSYQGTGTEAFF	1
CATGTATCGCTGTGCCAGCAGCCTCGCCCCGGCGAGCGATAGCCCACCTTCCCTGGCCAAAAATTCAACATTCAGTACTTCGGCGCC		1
CTGACGATCCAGCGCACACAGCAGGAGGACTCGGCCGTGTATCTCTGTGCCAGCACCCGTAATCAAGAGACCCAGTACTTCGGGCCA	CASTRNQETQYF	1
CGCACAGAGCAGGGGGACTCGGCCATGTATCTCTGTGCCAGCAGCTTAGGGTCGGGGATCGGCTTCAATGAGCAGTTCTTCGGGCCA	CASSLGSGIGFNEQFF	1
ACTCTGAAGATCCAGCCCTCAGAACCCAGGGACTCAGCTGTGTACTTCTGTGCCAGCAGTTTCTATTATACGCAGTATTTTGGCCCA	CASSFYYTQYF	1
CTGCTGTCGGCTGCTCCCTCCCAGACATCTGTGTACTTCTGTGCCAGCAGTCGGGGACAGGGGCCCTCACCCCTCCACTTTGGGAAC	CASSRGQGPSPLHF	1
CGCTACCAGCTCCCAGACATCTGTGTACTTCTGTGCCATCAGTGAGTCGACCTGCCGTCCCCAGAGCGAGACGGTTCGTACGGGCCA		1
CAGGTAGTGCGAGGAGATTCGGCAGCTTATTTCTGTGCCAGCTCACCATCGAAAGGCAATAGCAATCAGCCCCAGCATTTTGGTGAT	CASSPSKGNSNQPQHF	1
AGGCTGGAGTCGGCTGCTCCCTCCCAGACATCTGTGTACTTCTGTGCCAGCAGTGAATCCGTCCTCAATGAGCAGTTCTTCGGGCCA	CASSESVLNEQFF	1
GCCCTGCAGCCAGAAGACTCAGCCCTGTATCTCTGCGCCAGCAGCCAAGAAGGTCTAGCGGGTTACAATGAGCAGTTCTTCGGGCCA	CASSQEGLAGYNEQFF	1
AAGATCCAACCTGCAAAGCTTGAGGACTCGGCCGTGTATCTCTGTGCCAGCAGCTCGGACAGAGCCGGGGAGCTGTTTTTTGGAGAA	CASSSDRAGELFF	1
CTGCAGAACTGGAGGATTCTGGAGTTTATTTCTGTGCCAGCAGCCTCGGTCTCCAAGGAGCCGAACACTGAAGCTTTCTTTGGACAA		1
AAGATCCAGCCCTCAGAACCCAGGGACTCAGCTGTGTACTTCTGTGCCAGCAGTGGACTGCTCCAAGAGACCCAGTACTTCGGGCCA	CASSGLLQETQYF	1
CAGCGCACAGAGCAGGGGGACTCGGCCATGTATCTCTGTGCCAGCAGCCTACAGGGTCCAACTAATGAAAAACTGTTTTTTGGCAGT	CASSLQGPTNEKLFF	265
GAGTCGGCTGCTCCCTCCCAGACATCTGTGTACTTCTGTGCCAGCAGTTACTTAGGGACAGGGCATGAAAAACTGTTTTTTGGCAGT	CASSYLGTGHEKLFF	1
TCGGCTGCTCCCTCCCAGACATCTGTGTACTTCTGTGCCAGCAGTCCTATCACCGTGACAGGCGCCTATGGCTACACCTTCGGTTCG	CASSPITVTGAYGYTF	1
GCTCAGGCTGCTGTCGGCTGCTCCCTCCCAGACATCTGTGTACTTCTGTGCTACCTCAAGCCCGGGGGGCGCGCTTTCTTTGGACAA		1
GTGAACGCCTTGGAGCTGGACGACTCGGCCCTGTATCTCTGTGCCACCTCCTTGGAGGCGATCTATGAGACCCAGTACTTCGGGCCA	CATSLEAIYETQYF	1
TTGGAGTCGGCTGCTCCCTCCCAAACATCTGTGTACTTCTGTGCCAGCCTATCCTTAGCGGGAGTCTACGAGCAGTACTTCGGGCCG	CASLSLAGVYEQYF	1
GTGAGCACCTTGGAGCTGGGGGACTCGGCCCTTTATCTTTGCGCCAGCAGCTCTAGAGGGGTGGGAACTGAAGCTTTCTTTGGACAA	CASSSRGVGTEAFF	1
CATCCTGAAGACAGCAGCTTCTACATCTGCAGTGCTAGAGACCGTTCTGGGACAGGGGGTTCCTACAATGAGCAGTTCTTCGGGCCA	CSARDRSGTGGSYNEQFF	1
TCGCCCAGCCCCAACCAGACCTCTCTGTACTTCTGTGCCAGCAGTTCTTGGGCCTCCCCCGGCACAGATACGCAGTATTTTGGCCCA	CASSSWASPGTDTQYF	1
CCCTCAGAACCCAGGGACTCAGCTGTGTACTTCTGTGCCAGCAGTCGAACGAAGCGGGGGGGCGGTCATACGCAGTATTTTGGCCCA	CASSRTKRGGGHTQYF	1
AAGATCCGGTCCACAAAGCTGGAGGACTCAGCCATGTACTTCTGTGCCAGCAGTGACCAGGAGAACACTGAAGCTTTCTTTGGACAA	CASSDQENTEAFF	2
GCTGCTCCCTCCCAGACATCTGTGTACTTCTGTGCCAGCAGTTACTCGATGGCTCGGGGGATAAACTATGGCTACACCTTCGGTTCG	CASSYSMARGINYGYTF	1
ACTCTGGAGTCCGCTACCAGCTCCCAGACATCTGTGTACTTCTGTGCCATCAGTGTTCAACAGGGTGATACGCAGTATTTTGGCCCA	CAISVQQGDTQYF	1
CGGTCCACAAAGCTGGAGGACTCAGCCATGTACTTCTGTGCCAGCAACCCCCGCACTACGCACAACCAGCCCCAGCATTTTGGTGAT	CASNPRTTHNQPQHF	1
GAGTCTGCCATCCCCAACCAGACAGCTCTTTACTTCTGTGCCACCAGTGGGAGGGACAGGGGAACCGGGGAGCTGTTTTTTGGAGAA	CATSGRDRGTGELFF	1
AACATGAGCTCCTTGGAGCTGGGGGACTCAGCCCTGTACTTCTGTGCCAGCAGCCCCCGCCAGGGCGCTGAAGCTTTCTTTGGACAA	CASSPRQGAEAFF	1
GAGATGAATGTGAGCACCTTGGAGCTGGGGGACTCGGCCCTTTATCTTTGCGCCAGCAGAGAAGGGGGCGAGCAGTACTTCGGGCCG	CASREGGEQYF	1
AGGCTGCTGTCGGCTGCTCCCTCCCAGACATCTGTGTACTTCTGTGCCAGCATAGGACTAGCGGGGAATGAGCAGTTCTTCGGGCCA	CASIGLAGNEQFF	1
TGCAGCCAGAAGACTCGGCCCTGTATCTCTGTGCCAGCAGCCCGAAGGATAGGGACTAGCGTGAACAATGAGCAGTTCTTCGGGCCA		1
CAGTGCCCATCCTGAAGACAGCAGCTTCTACATCTGCAGTGCTAGAGGAAGCGGCAGAATCGAGGTTCACCCCTCCACTTTGGGAAC		2
ACATCGGCCCAAAAGAACCCGACAGCTTTCTATCTCTGTGCCAGTAGTATGGACAGGGGCTTTGGCTATGGCTACACCTTCGGTTCG	CASSMDRGFGYGYTF	1
ATCAATTCCCTGGAGCTTGGTGACTCTGCTGTGTATTTCTGTGCCAGCAGCCCCGGGACTACCAACTACGAGCAGTACTTCGGGCCG	CASSPGTTNYEQYF	1
CCCCTGACCCTGGAGTCTGCCAGGCCCTCACATACCTCTCAGTACCTCTGTGCCAGCAGTGGAGTGGATACGCAGTATTTTGGCCCA	CASSGVDTQYF	1
TGTCCCTAGAGTCTGCCATCCCCAACCAGACAGCTCTTTACTTCTGTGCCACCCGACAGGGGGCACCAGCCCCAGCATTTTGGTGAT		1
TTTCCTCTCACTGTGACATCGGCCCAAAAGAACCCGACAGCTTTCTATCTCTGTGCCAGCGGGCAGCGGCCTCAGGACTTCGGCGCC	CASGQRPQDF	1
ACAGAGCAGGGGGACTCGGCCATGTATCTCTGTGCCAGCAGCTTAGCGGCGTGGACATATAGCAATCAGCCCCAGCATTTTGGTGAT	CASSLAAWTYSNQPQHF	3
ACCAGTGCCCATCCTGAAGACAGCAGCTTCTACATCTGCAGTGTCAATCTAGCGGGGGCTAGCACAGATACGCAGTATTTTGGCCCA	CSVNLAGASTDTQYF	1
AGGCTGGAGTTGGCTGCTCCCTCCCAGACATCTGTGTACTTCTGTGCCAGCAGGAGCGGGGGAGGCACTGAAGCTTTCTTTGGACAA	CASRSGGGTEAFF	1
AGCTCCTTGGAGCTGGGGGACTCAGCCCTGTACTTCTGTGCCAGCAGCGGCAGTATTAGCGGGGCTTGGGAGCAGTACTTCGGGCCA	CASSGSISGAWEQYF	1
AGTGACCAGTGCCCATCCTGAAGACAGCAGCTTCTACATCTGCAGTGCTAGTTAGGCTAGCTAAACACTGAAGCTTTCTTTGGACAA		1
AGTGCGAGGAGATTCGGCAGCTTATTTCTGTGCCAGCTCACCTACCCCGGACTAGCGGGGGGAACCTACGAGCAGTACTTCGGGCCG		1
TCGCCCAGCCCCAACCAGACCTCTCTGTACTTCTGTGCCAGCAGTTATGACTTAGCGGGCCGCTCCTACGAGCAGTACTTCGGGCCG	CASSYDLAGRSYEQYF	1
CTGGAGCTTGGTGACTCTGCTGTGTATTTCTGTGCCAGCAGCCACAGGGTAGGGCTTACTAGCACAGATACGCAGTATTTTGGCCCA	CASSHRVGLTSTDTQYF	1
CTGAAGATCCAGCCCTCAGAACCCAGGGACTCAGCTGTGTACTTCTGTGCCAGCAGTCAGACAGACTATGGCTACACCTTCGGTTCG	CASSQTDYGYTF	2
AAGATCCAGCCTGCAAAGCTTGAGGACTCGGCCGTGTATCTCTGTGCCAGCAGCTTAGAGGCAGGGACCGAGCAGTACTTCGGGCCG	CASSLEAGTEQYF	1
CTGACAGTGACCAGTGCCCATCCTGAAGACAGCAGCTTCTACATCTGCAGTGCTAGTCAGGGGGCGAGAGGCTACACCTTCGGTTCG	CSASQGARGYTF	1
ACCAGTGCCCATCCTGAAGACAGCAGCTTCTACATCTGCAGTGCTAGAGTGCGGGGAATGGGCAATCAGCCCCAGCATTTTGGTGAT	CSARVRGMGNQPQHF	1
CTGATCCTGGAGTCGCCCAGCCCCAACCAGACCTCTCTGTACTTCTGTGCCAGCAGCCCGAGGGGTGAAAAACTGTTTTTTGGCAGT	CASSPRGEKLFF	1
CAAAAGAACCCGACAGCTTTCTATCTCTGTGCCAGTAGTATAATGGAGGGACAGGGGGTTAACACCGGGGAGCTGTTTTTTGGAGAA	CASSIMEGQGVNTGELFF	1
AACATGAGCCCTGAAGACAGCAGCATATATCTCTGCAGCGTTGAAGATGGGGCAGGGACGGGGGCCAACGTCCTGACTTTCGGGGCC	CSVEDGAGTGANVLTF	1
ATTCCCTGGAGCTTGGTGACTCTGCTGTGTATTTCTGTGCCAGCAGCCCTCTCGGGGAAGGAAGGCTATGGCTACACCTTCGGTTCG		1
ACGATCCAGCGCACACAGCAGGAGGACTCGGCCGTGTATCTCTGTGCCAGCAGCTTCGAGTGGGGCTACGAGCAGTACTTCGGGCCG	CASSFEWGYEQYF	1
CACACCCTGCAGCCAGAAGACTCGGCCCTGTATCTCTGCGCCAGCAGCCAAGAGAGAATCCGCTCCTACGAGCAGTACTTCGGGCCG	CASSQERIRSYEQYF	1
CTGGAGTCGCCCAGCCCCAACCAGACCTCTCTGTACTTCTGTGCCAGCAGTTTCTTAGACAGGGCGGGAGGCTACACCTTCGGTTCG	CASSFLDRAGGYTF	1
CTGTCGGCTGCTCCCTCCCAGACATCTGTGTACTTCTGTGCCAGCAGTTACTCGAGACAGTTGAACACTGAAGCTTTCTTTGGACAA	CASSYSRQLNTEAFF	1
ATTCTGGAGTCCGCCAGCACCAACCAGACATCTATGTACCTCTGTGCCAGCCTAAAGGCGGGACTCGATACGCAGTATTTTGGCCCA	CASLKAGLDTQYF	1
CTGGAGTCGCCCAGCCCCAACCAGACCTCTCTGTACTTCTGTGCCAGTTCCCCGGACAGGGTAGACAATGAGCAGTTCTTCGGGCCA	CASSPDRVDNEQFF	1
CACCTACACGCCCTGCAGCCAGAAGACTCAGCCCTGTATCTCTGCGCCAGCAGCCAAATGCAGGGCCACGAGCAGTACTTCGGGCCG	CASSQMQGHEQYF	1
CAGCAGGTAGTGCGAGGAGATTCGGCAGCTTATTTCTGTGCCAGCTCACCACCTGGGACAGCCTACAATGAGCAGTTCTTCGGGCCA	CASSPPGTAYNEQFF	1
AGCTGGGGGACTCAGCCCTGTACTTCTGTGCCAGCAGCGGATTTGGTAACGCATGAGTGAAAGACCTATGGCTACACCTTCGGTTCG		1
AGTTCTAAGAAGCTCCTTCTCAGTGACTCTGGCTTCTATCTCTGTGCCTGGAGTGTAGGGCAGGGATATGGCTACACCTTCGGTTCG	CAWSVGQGYGYTF	2
CCAGCGCACAGAGCAGGGGGCTCGGCCATGTATCTCTGTGCCAGCAGCCCGAGACAGGGGCTTACCTACGAGCAGTACTTCGGGCCG	CASSPRQGLTYEQYF	1
AGCACCTTGGAGCTGGGGGACTCGGCCCTTTATCTTTGCGCCAGCAGCCCCCGGGACAGCATGAACACTGAAGCTTTCTTTGGACAA	CASSPRDSMNTEAFF	1
CACACCCTGCAGCCAGAAGACTCGGCCCTGTATCTCTGCGCCAGCAGCCACCCCAGGGCCCCGGGGGGTGAGCAGTTCTTCGGGCCA	CASSHPRAPGGEQFF	1
AGCACCTTGGAGCTGGGGGACTCGGCCCTTTATCTTTGCGCCAGCAGCTTGGGGAGTAGTCCTGGGAATGAGCAGTTCTTCGGGCCA	CASSLGSSPGNEQFF	1
ATCCAGCGCACACAGCAGGAGGACTCCGCCGTGTATCTCTGTGCCAGCAGCTGGGACAGGGGCGCCACTGAAGCTTTCTTTGGACAA	CASSWDRGATEAFF	1
TTGGAGATCCAGCGCACAGAGCAGGGGGACTCGGCCATGTATCTCTGTGCCAGCAGCTTAGTGCAAGGGATCTACACCTTCGGTTCG	CASSLVQGIYTF	2
CAGCAGGTAGTGCGAGGAGATTCGGCAGCTTATTTCTGTGCCAGCTCACCACCGGGCAGGGGGGACTATGGCTACACCTTCGGTTCG	CASSPPGRGDYGYTF	1
CTGGAGTCCGCTACCAGCTCCCAGACATCTGTGTACTTCTGTGCCATCAGTCCCTCGGGGGGGAACACTGAAGCTTTCTTTGGACAA	CAISPSGGNTEAFF	1
ATCCAGCCCTCAGAACCCAGGGACTCAGCTGTGTACTTCTGTGCCAGCAGTTTAGGTGAGGAATCCTACGAGCAGTACTTCGGGCCG	CASSLGEESYEQYF	1
AGTGCCCATCCTGAAGACAGCAGCTTCTACATCTGCAGTGCTAGAGTTAGACAGGGAGTATCCACAGATACGCAGTATTTTGGCCCA	CSARVRQGVSTDTQYF	2
CTGACTGTGAGCAACATGAGCCCTGAAGACAGCAGCATATATCTCTGCAGCGTTGGACAGGGCCCCTACGAGCAGTACTTCGGGCCG	CSVGQGPYEQYF	1
ATCCAGCCCTCAGAACCCAGGGACTCAGCTGTGTACTTCTGTGCCAGCATGAGGGCAGGGGTGGAAGATACGCAGTATTTTGGCCCA	CASMRAGVEDTQYF	1
GCTCCCTCCCAGACATCTGTGTACTTCTGTGCCAGCAGTGCATACAGGACAGGGGCCTCAACTAATGAAAAACTGTTTTTTGGCAGT	CASSAYRTGASTNEKLFF	1
AGGATCCAGCAGGTAGTGCGAGGAGATTCGGCAGCTTATTTCTGTGCCAGCTCACCCCTCGGACCGGAAGTTTACACCTTCGGTTCG	CASSPLGPEVYTF	1
TCCCTAGAGTCTGCCATCCCCAACCAGACAGCTCTTTACTTCTGTGCCACTAAAGACCGAAGCACAGATACGCAGTATTTTGGCCCA	CATKDRSTDTQYF	1
CGCCCAGCCCCAACCAGACCTCTCTGTACTTCTGTGCCAGGCTTGAGCGGGAGAGATGCGAGCACCGGGGAGCTGTTTTTTGGAGAA		1
ATGAATGTGAGCACCTTGGAGCTGGGGGCCTCGGCCCTTTATCTTTGCGCCAGCAGCCCCACCCAAGAGACCCAGTACTTCGGGCCA	CASSPTQETQYF	1
GTCTGCTGTACCCTCTCAGACATCTGTGTACTTCTGTGCCAGCAGTGAGCCTCGGGACTAGACACAGATACGCAGTATTTTGGCCCA		1
ACACAGCAGGAGGACTCGGCCGTGTATCTCTGTGCCAGCCGTCCCGGGACAGGTATTAGTGGGGCCAACGTCCTGACTTTCGGGGCC	CASRPGTGISGANVLTF	1
CTGAGTTCTAAGAAGCTCCTTCTCAGTGACTCTGGCTTCTATCTCTGTGCCTGGAGCGGGACAGGGAGTGGGCAGTTCTTCGGGCCA	CAWSGTGSGQFF	1
CAGCAGGTAGTGCGAGGAGATTCGGCAGCTTATTTCTGTGCCAGCTCACCGATCTGGGGACCTCAAGAGACCCAGTACTTCGGGCCA	CASSPIWGPQETQYF	1
CTGCTGTCGGCTGCTCCCTCCCAGACATCTGTGTACTTCTGTGCCAGCAGCCCGACGATTTACCGATATACCATATATTTTGGAGAG	CASSPTIYRYTIYF	1
TTGGAGATCCAGCGCACAGAGCAGGGGGACTCGGCCATGTATCTCTGTGCCAGCAGCTTAGCAAACTATGGCTACACCTTCGGTTCG	CASSLANYGYTF	1
TCGGCTGCTCCCTCCCAAACATCTGTGTACTTCTGTGCCAGCAGTGAAGGGACTAGCGGGATCGGGAATGAGCAGTTCTTCGGGCCA	CASSEGTSGIGNEQFF	1
ACATCGGCCCAAAAGAACCCGACAGCTTTCTATCTCTGTGCCAGTGCCTACCCGGGAGTCCAGGGCCAGCCCCAGCATTTTGGTGAT	CASAYPGVQGQPQHF	1
CAGCCCTCAGAACCCAGGGACTCAGCTGTGTACTTCTGTGCCAGCAGTTCATCAGCTGCAACTAATGAAAAACTGTTTTTTGGCAGT	CASSSSAATNEKLFF	1
TTGGCGTCTGCTGTACCCTCTCAGACATCTGTGTACTTCTGTGCCAGTAGACGACAGGGGAGCACCTATGGCTACACCTTCGGTTCG	CASRRQGSTYGYTF	1
CTGGAGTCGCCCAGCCCCAACCAGACCTCTCTGTACTTCTGTGCCAGCAGTTAGTAAGGAGGGCGCAATGAGCAGTTCTTCGGGCCA	CASS**GGRNEQFF	1
TTGGAGCTGGAGGACTCGGCCCTGTATCTCTGTGCCAGCAGCTTACTAGCGGGAGTGAGCTCCTACAATGAGCAGTTCTTCGGGCCA	CASSLLAGVSSYNEQFF	1
CCCTGCAGCCAGAAGACTCGGCCCTGTATCTCTGCGCCAGCAGCCAAGCCCGGGACTAGCGAGAGGGATACGCAGTATTTTGGCCCA		1
ACTGTGAGCAACATGAGCCCTGAAGACAGCAGCATATATCTCTGCAGCGTTCCAGTCGCGGTGGGTGAGACCCAGTACTTCGGGCCA	CSVPVAVGETQYF	1
GAGATCCAGCGCACAGAGCAGGGGGACTCGGCCATGTATCTCTGTGCCAGCAGCCGAGAGGGGGGGGCCGAAGCTTTCTTTGGACAA	CASSREGGAEAFF	1
GTGAACGCCTTGTTGCTGGGGGACTCGGCCCTGTATCTCTGTGCCAGCAGTATGGGGACCCCTGTGGAGACCCAGTACTTCGGGCCA	CASSMGTPVETQYF	1
CACATCAATTCCCTGGAGCTTGGTGACTCTGCTGTGTATTTCTGTGCCAGCAGCCAAGCAATCAAGGACATTCAGTACTTCGGCGCC	CASSQAIKDIQYF	1
GGGTTGGAGTCGGCTGCTCCCTCCCAAACATCTGTGTACTTCTGTGCCAGCGCCGGGACTCCCCTCCACGAGCAGTACTTCGGGCCG	CASAGTPLHEQYF	1
TTGCTGGGGGACTCGGCCCTCTATCTCTGTGCCAGCAGCAAACCTACGACAGGGGCCAAGAACACCGGGGAGCTGTTTTTTGGAGAA	CASSKPTTGAKNTGELFF	2
GTGACCAGTGCCCATCCTGAAGACAGCAGCTTCTACATCTGCAGTGCTCCAAGCCGGGTGATCGGCACTGAAGCTTTCTTTGGACAA	CSAPSRVIGTEAFF	1
TGTGAGCAACATGAGCCCTGAAGACAGCAGCATATATCTCTGCAGCGGAATAAGACAGCTAGTCGAGAGACCCAGTACTTCGGGCCA		1
ACATCGGCCCAAAAGAACCCGACAGCTTTCTATCTCTGTGCCAGTATGGAATGGGGGGGTCCGACCTATGGCTACACCTTCGGTTCG	CASMEWGGPTYGYTF	1
GTGAACGCCTTGTTGCTGGGGGACTCGGCCCTCTATCTCTGTGCCAGCAGCAAGGACAGCCTCCCCTATGGCTACACCTTCGGTTCG	CASSKDSLPYGYTF	1
CGGCTGCTCCCTCCCAAACATCTGTGTACTTCTGTGCCAGCAGTGGGGGGACTAGCGGGAGGGTCAGATACGCAGTATTTTGGCCCA		1
ACTGTGACATCGGCCCAAAAGAACCCGACAGCTTTCTATCTCTGTGCCAGTAGCCTAGCCGGGGATCAGCCCCAGCATTTTGGTGAT	CASSLAGDQPQHF	1
GTGAGCACCTTGGAGCTGGGGGACTCGGCCCTTTATCTTTGCGCCAGCAGCCTAGAGCGGGAATACAATGAGCAGTTCTTCGGGCCA	CASSLEREYNEQFF	1
ACAGAGCAGGGGGACTCGGCCATGTATCTCTGTGCCAGCAGCTTAGCCCAGGGAAGGTGGGAAAGGGATGAGCAGTTCTTCGGGCCA	CASSLAQGRWERDEQFF	1
TCCCAGACATCTGTGTACTTCTGTGCCAGCAGCTACCCCCGGGACAGGGGGCTACCTAGCTCCTACAATGAGCAGTTCTTCGGGCCA	CASSYPRDRGLPSSYNEQFF	1
GCTGCTCCCTCCCAGACATCTGTGTACTTCTGTGCCAGCAGTGAAAGGGGGACTAGCGGGAGCGTCAATGAGCAGTTCTTCGGGCCA	CASSERGTSGSVNEQFF	5
GAGTCGGCTGCTCCCTCCCAGACATCTGTGTACTTCTGTGCCAGCAGTGAATATGAGGGCCAAAGCTATGGCTACACCTTCGGTTCG	CASSEYEGQSYGYTF	1
CGGTCCACAAAGCTGGAGGACTCAGCCATGTACTTCTGTGCCAGCACCGGACAGATCTCTGGGGCCAACGTCCTGACTTTCGGGGCC	CASTGQISGANVLTF	1
AGATGAATGTGAGCACCTTGGAGCTGGGGGACTCGGCCCTGTATCTCTGTGCCAGAAGCCATCCAAGAGACCCAGTACTTCGGGCCA		1
ATCCAGCGCACAGAGCAGGGGGACTCGGCCATGTATCTCTGTGCCTCCCGAGATAGAGGCAACCAAGAGACCCAGTACTTCGGGCCA	CASRDRGNQETQYF	1
AGCACCTTGGAGCTGGGGGACTCGGCCCTTTATCTTTGCGCCAGCAGCTTGGGGGGGAGCACTAATGAAAAACTGTTTTTTGGCAGT	CASSLGGSTNEKLFF	1
ATCCAGCGCACAGAGCAGGGGGACTCGGCCCTGTATCTCTGTGCCAGCAGCATACCTTTCCGTGGCTCACCCCTCCACTTTGGGAAC	CASSIPFRGSPLHF	1
TCGGCTGCTCCCTCCCAGACATCTGTGTACTTCTGTGCCAGCTCCCGAACGGGACAGGGGTATAATCAGCCCCAGCATTTTGGTGAT	CASSRTGQGYNQPQHF	1
AGCACCTTGGAGCTGGGGGACTCGGCCCTTTATCTTTGCGCCAGCAGCTTAACGGGCAGGTGGGCAGATACGCAGTATTTTGGCCCA	CASSLTGRWADTQYF	1
TCTCTGGAGCTGGGGGACTCAGCTTTGTATTTCTGTGCCAGCAGCGTGAGTCCGGGAGTTCTCTCCTACGAGCAGTACTTCGGGCCG	CASSVSPGVLSYEQYF	1
GAGCTTGGTGACTCTGCTGTGTATTTCTGTGCCAGCAGCCAAGTATTTATGGCTGGACAGGGCAACACTGAAGCTTTCTTTGGACAA	CASSQVFMAGQGNTEAFF	1
GTGAGCACCTTGGAGCTGGGGGACTCGGCCCTTTATCTTTGCGCCAGCAGCCCGGACGGAATGAACACTGAAGCTTTCTTTGGACAA	CASSPDGMNTEAFF	1
CTGTCGGCTGCTCCCTCCCAGACATCTGTGTACTTCTGTGCCAGCAGTTACTCGTGGGGCGGTGATGAAAAACTGTTTTTTGGCAGT	CASSYSWGGDEKLFF	1
CAGCCTGCAGAGCTTGGGGACTCGGCCGTGTATCTCTGTGCCAGCAGCCTAGGGGGGACAGAGAACACTGAAGCTTTCTTTGGACAA	CASSLGGTENTEAFF	1
CCCTCAGAACCCAGGGACTCAGCTGTGTACTTCTGTGCCAGCAGTAACAGGGGGCGAAGCATGAACACTGAAGCTTTCTTTGGACAA	CASSNRGRSMNTEAFF	1
GTGAGCACCTTGGAGCTGGGGGACTCGGCCCTTTATCTTTGCGCCAGCAGGTACAGACTGAACACCGGGGAGCTGTTTTTTGGAGAA	CASRYRLNTGELFF	1
CCTCCCAAACATCTGTGTACTTCTGTGCCAGCACCCACCGTTTGGGGGTTAAGTTGGGGCTCTGGAAACACCATATATTTTGGAGAG		1
CACACCCTGCAGCCAGAAGACTCGGCCCTGTATCTCTGCGCCAGCAGCCAGCTACAAGACACCTCCTACGAGCAGTACTTCGGGCCG	CASSQLQDTSYEQYF	2
TTGGAGATCCAGCGCACAGAGCAGGGGGACTCGGCCATGTATCTCTGTGCCAGCAGCCGAGTAACCTACGAGCAGTACTTCGGGCCG	CASSRVTYEQYF	1
ACAGTGACCAGTGCCCATCCTGAAGACAGCAGCTTCTACATCTGCAGTGCTAGAGATGAGGGAGGGTATGGCTACACCTTCGGTTCG	CSARDEGGYGYTF	1
TGGAGCTGGGGGACTCAGCCCTGTACTTCTGTGCCAGCAGCTCGAGGGGACATCCCCTCTGGGGCCAACGTCCTGACTTTCGGGGCC		1
GTGACCAGTGCCCATCCTGAAGACAGCAGCTTCTACATCTGCAGTGCTACCCCAGGGGAGGCGGGGACTGAAGCTTTCTTTGGACAA	CSATPGEAGTEAFF	3
CTGATTCTGGAGTCCGCCAGCACCAACCAGACATCTATGTACCTCTGTGCCAGCAGTTTCCCCGACGGGACGACGTTTTTCGGGCCA	CASSFPDGTTFF	1
AACGCCTTGGAGCTGGACGACTCGGCCCTGTATCTCTGTGCCAGCAGCTTATCAGCGGCGAGCACAGATACGCAGTATTTTGGCCCA	CASSLSAASTDTQYF	1
GCCAGCACCAACCAGACATCTATGTACCTCTGTGCCAGCAGGGGTACAGGGTTTGAAGGTTCCGACACTGAAGCTTTCTTTGGACAA	CASRGTGFEGSDTEAFF	1
AGCTCTCTGGAGCTGGGGGACTCAGCTTTGTATTTCTGTGCCAGCAGCGTCGGCTAGCCGATTCCGGATGAGCAGTTCTTCGGGCCA	CASSVG*PIPDEQFF	1
GTGAGCACCTTGGAGCTGGGGGACTCGGCCCTTTATCTTTGCGCCAGCAGTTATGCGGGGGGTCAAGAGACCCAGTACTTCGGGCCA	CASSYAGGQETQYF	1
ATCCAACCTGCAAAGCTTGAGGACTCGGCCGTGTATCTCTGTGCCAGCAGCCCAGGCGGGGTTCCCGAGGAACTGTTTTTTGGCAGT	CASSPGGVPEELFF	1
AGTTCTAAGAAGCTCCTTCTCAGTGACTCTGGCTTCTATCTCTGTGCCTGGAGACTTAGGGGGGCCGGTCCACCGCACTTCGGTTCG	CAWRLRGAGPPHF	1
CTGGAGTCTGCCAGGCCCTCACATACCTCTCAGTACCTCTGTGCCAGCAGTTCAGACAGGGTCACCGGGGAGCTGTTTTTTGGAGAA	CASSSDRVTGELFF	1
AGGATCCAGCAGGTAGTGCGAGGAGATTCGGCAGCTTATTTCTGTGCCAGCTCGGGACAGCTCCAAGAGACCCAGTACTTCGGGCCA	CASSGQLQETQYF	1
CAGCCTGCAAAGCTTGAGGACTCGGCCGTGTATCTCTGTGCCAGCAGCGACGGACACCAGAACACCGGGGAGCTGTTTTTTGGAGAA	CASSDGHQNTGELFF	1
ACCTTGGAGCTGGGGGACTCGGCCCTTTATCTTTGCGCCAGCAGCGCGGCTGATCGATACCCCACAGATACGCAGTATTTTGGCCCA	CASSAADRYPTDTQYF	1
GCCCAAAAGAACCCGACAGCTTTCTATCTCTGTGCCAGTAGTGAATATGCCGGGACTAGAACAATCAATGAGCAGTTCTTCGGGCCA	CASSEYAGTRTINEQFF	1
TCCAGCGCACAGAGCAGCGGGACTCGGCCATGTATCGCTGTGCCAGCAGCTTAAAATAGCGGCACCTACGAGCAGTACTTCGGGCCA		1
GTGACATCGGCCCAAAAGAACCCGACAGCTTTCTATCTCTGTGCCAGTAGTAAGTCTGCAACTAATGAAAAACTGTTTTTTGGCAGT	CASSKSATNEKLFF	1
ACCAGTGCCCATCCTGAAGACAGCAGCTTCTACATCTGCAGTGCTAGAGATTGGGCGGGAGGTCCCTATACGCAGTATTTTGGCCCA	CSARDWAGGPYTQYF	1
CTGAAGATCCGGTCCACAAAGCTGGAGGACTCAGCCATGTACTTCTGTGCCAGCAGCAGGGGGAGAGAGACCCAGTACTTCGGGCCA	CASSRGRETQYF	1
CAGGCCTGGGGGACGCAGCCATGTACCTGTGTGCCACCAGCAGAGATTGGCACGGAAACCAATAATTCACCCCTCCACTTTGGGAAC		1
ACGATCCAGCGCACACAGCAGGAGGACTCGGCCGTGTATCTCTGTGCCAGCAGCCGACCGACCTCCTACGAGCAGTACTTCGGGCCG	CASSRPTSYEQYF	1
GGGTTGGAGTCGGCTGCTCCCTCCCAAACATCTGTGTACTTCTGTGCCAGCAGAGGGACAGACTACACTGAAGCTTTCTTTGGACAA	CASRGTDYTEAFF	1
GCCTTGGAGCTGGGGGACTCGGCCCTGTATCTCTGTGCCAGAAGCACGTGACTAAGAAATTACCAAGAGACCCAGTACTTCGGGCCA	CARST*LRNYQETQYF	1
ACTGTGACATCGGCCCAAAAGAACCCGACAGCTTTCTATCTCTGTGCCAGTAGCGGGGACGGCGAAAGGCCCCTCCACTTTGGGAAC	CASSGDGERPLHF	1
GTGACCAGTGCCCATCCTGAAGACAGCAGCTTCTACATCTGCAGTGCTAGCGAGACCAGGCCTCTCTATGGCTACACCTTCGGTTCG	CSASETRPLYGYTF	1
CTGGGGTTGGAGTCGGCTGCTCCCTCCCAAACATCTGTGTACTTCTGTGTCACCCGAGGCTGGGCAGATACGCAGTATTTTGGCCCA	CVTRGWADTQYF	1
CTGCAGCCAGAAGACTCGGCCCTGTATCTCTGCGCCAGCAGCCAAGGGACTAGCGGGAGTACCTACAATGAGCAGTTCTTCGGGCCA	CASSQGTSGSTYNEQFF	1
ACCAGTGCCCATCCTGAAGACAGCAGCTTCTACATCTGCAGTGCTAGAGATCTGGGACAGGGGATCGGTGAGCAGTTCTTCGGGCCA	CSARDLGQGIGEQFF	1
ACCAGTGCCCATCCTGAAGACAGCAGCTTCTACATCTGCAGTGCTAGAGAGGTACGGGGGGGCAATCAGCCCCAGCATTTTGGTGAT	CSAREVRGGNQPQHF	1
ACGATCCAGCGCACACAGCAGGAGGACTCGGCCGTGTATCTCTGTGCCAGCAGGGGGGGGCGGGAGAACATTCAGTACTTCGGCGCC	CASRGGRENIQYF	1
ACTGTGACATCGGCCCAAAAGAACCCGACAGCTTTCTATCTCTGTGCCAGTAGTATTCGTAGCTCCTACGAGCAGTACTTCGGGCCG	CASSIRSSYEQYF	1
AATTCCCTGGAGCTTGGTGACTCTGCTGTGTATTTCTGTGCCAGCAGCCAAGGTCGGACGACTGGAAACACCATATATTTTGGAGAG	CASSQGRTTGNTIYF	1
GCCTTGTTGCTGGGGGACTCGGCCCTGTATCTCTGTGCCAGCAGCTATGAGACTAGCTGGTCCTACAATGAGCAGTTCTTCGGGCCA	CASSYETSWSYNEQFF	1
GCCTTGTTGCTGGGGGACTCGGCCCTGTATCTCTGTGCCAGCAGCTCTCAACCAGGGGGATCAAATGAAAAACTGTTTTTTGGCAGT	CASSSQPGGSNEKLFF	1
ACCTTGGAGATCCAGCGCACAGAGCAGGGGGACTCGGCCATGTATCTCTGTGCCAGCAGCCACCTGTACGAGCAGTACTTCGGGCCG	CASSHLYEQYF	1
TCCAGCCCATGGAACCCAGGGACTTGGGCCTATATTTCTGTGCCAGCAGCTTTGATAGGGAATAGCAACACCATATATTTTGGAGAG		1
GAGTCAGCTACCCGCTCCCAGACATCTGTGTATTTCTGCGCCAGCAGTGACACAGGGAGGAGCAATCAGCCCCAGCATTTTGGTGAT	CASSDTGRSNQPQHF	1
GAGATCCAGCGCACAGAGCAGGGGGACTCGGCCATGTATCTCTGTGCCAGCAGCTTATTCGAAAATCAGCCCCAGCATTTTGGTGAT	CASSLFENQPQHF	1
TCTAAGAAGCTCCTTCTCAGTGACTCTGGCTTCTATCTCTGTGCCTGGACCCTACAGGGGGGTTGGGAGACCCAGTACTTCGGGCCA	CAWTLQGGWETQYF	1
CAGCGCACACAGCAGGAGGACTCGGCCGTGTATCTCTGTGCCAGCAGCTTAGTTGGTGACGGCTACAATGAGCAGTTCTTCGGGCCA	CASSLVGDGYNEQFF	1
CCTGCAAAGCTTGAGGACTCGGCCGTGTATCTCTGTGCCAGCAGCTTTCAAGTTGGCCTAGCGGGAAACATTCAGTACTTCGGCGCC	CASSFQVGLAGNIQYF	1
GAGTCGGCTGCTCCCTCCCAAACATCTGTGTACTTCTGTGCCAGCAGTCAGTACAGAGCTGGGGCCAACGTCCTGACTTTCGGGGCC	CASSQYRAGANVLTF	1
ACAGTGACCAGTGCCCATCCTGAAGACAGCAGCTTCTACATCTGCAGTGCCCCGGACAATCGGGGAGAAAAACTGTTTTTTGGCAGT	CSAPDNRGEKLFF	1
ACAGTGACCAGTGCCCATCCTGAAGACAGCAGCTTCTACATCTGCAGTGCTACCAGACTGGTCCAAGAGACCCAGTACTTCGGGCCA	CSATRLVQETQYF	2
ACCAGTGCCCATCCTGAAGACAGCAGCTTCTACATCTGCAGTGCTAGAGATGAGGGCTCCTTGCGAAACATTCAGTACTTCGGCGCC	CSARDEGSLRNIQYF	1
CACACCCTGCAGCCAGAAGACTCGGCCCTGTATCTCTGTGCCAGCAGCCAAGAAACGACTGGGGATTCACCCCTCCACTTTGGGAAC	CASSQETTGDSPLHF	1
CTGGAGGACTCAGCCATGTACTTCTGTGCCAGCAGCCCCCTGGGACTAGCGGGGGACTCTGGGGCCAACGTCCTGACTTTCGGGGCC	CASSPLGLAGDSGANVLTF	1
GTCCGCCAGCACCAACCAGACATCTATGTACCTCTGTGCCAGCAGTTTAGCCAGGGGAGCTCCTACAATGAGCAGTTCTTCGGGCCA		1
GTGAGCACCTTGGAGCTGGGGGACTCGGCCCTTTATCTTTGCGCCAGCAGCCTCGGCGGGAACTCAGATACGCAGTATTTTGGCCCA	CASSLGGNSDTQYF	1
GTGACCAGTGCCCATCCTGAAGACAGCAGCTTCTACATCTGCAGTGCCCATTCCGGGACAGGTGCCTACGAGCAGTACTTCGGGCCG	CSAHSGTGAYEQYF	2
ATGTGAACGCCTTGTTGCTGGGGGACTCGGCCCTCTATCTCTGTGCCAGCAGCTTGGTTGGGGGCGCATGGCTACACCTTCGGTTCG		1
ACGATCCAGCGCACACAGCAGGAGGACTCGGCCGTGTATCTCTGTGCCAGCAGTCAGAATCAAAACTATGGCTACACCTTCGGTTCG	CASSQNQNYGYTF	1
GTCGGCTGCTCCCTCCCAGACATCTGTGTACTTCTGTGCCAGCAGTTACCCCGGGACAGAGCTAACTATGGCTACACCTTCGGTTCG		1
ACTGTGACATCGGCCCAAAAGAACCCGACAGCTTTCTATCTCTGTGCCAGTAGTATAGATCTATTGAGGGAGCAGTACTTCGGGCCG	CASSIDLLREQYF	1
ACAGTGACCAGTGCCCATCCTGAAGACAGCAGCTTCTACATCTGCAGTGCAAAAGGGGGATCCAATCAGCCCCAGCATTTTGGTGAT	CSAKGGSNQPQHF	1
AGCACCTTGGAGCTGGGGGACTCGGCCCTTTATCTTTGCGCCAGCAGCCCGACTAGCGGGGGGAGGGATACGCAGTATTTTGGCCCA	CASSPTSGGRDTQYF	1
GCAAAGCTTGAGGACTCGGCCGTGTATCTCTGTGCCAGCAGCTTAGAGGGGGGACTAGCGCCGACCTCGGAGCAGTACTTCGGGCCG	CASSLEGGLAPTSEQYF	1
GACCAGTGCCCATCCTGAAGACAGCAGCTTCTACATCTGCAGTGCTAGATAGGGGGGGCAAGACAAGAGACCCAGTACTTCGGGCCA		1
ATCCAGCGCACAGAGCAGGGGGACTCGGCCATGTATCTCTGTGCCAGCAGCTTAGCAGGGGACACAGATACGCAGTATTTTGGCCCA	CASSLAGDTDTQYF	3
CGCACACAGCAGGAGGACTCGGCCGTGTATCTCTGTGCCAGCAGCTTAGGAGGGACTACCCGAACCGGGGAGCTGTTTTTTGGAGAA	CASSLGGTTRTGELFF	1
TTGGCGTCTGCTGTACCCTCTCAGACATCTGTGTACTTCTGTGCCAGCAGTGACGGGACGGGAGGGGGTGAGCAGTTCTTCGGGCCA	CASSDGTGGGEQFF	1
AAGATCCAGCCCTCAGAACCCAGGGACTCAGCTGTGTACTTCTGTGCCAGCATGGGTAGCTCCTACAATGAGCAGTTCTTCGGGCCA	CASMGSSYNEQFF	1
CGCACAGAGCAGGGGGACTCAGCCGTGTATCTCCGTGCCAGCAGCCCCCAGTGTAGCGGGGGCTACAATGAGCAGTTCTTCGGGCCA	RASSPQCSGGYNEQFF	1
CAGCAGGTAGTGCGAGGAGATTCGGCAGCTTATTTCTGTGCCAGCTCACCAGGGGGCGGAACGAGGGAGACCCAGTACTTCGGGCCA	CASSPGGGTRETQYF	1
ATCCAGCGCACAGAGCAGGGGGACTCGGCCATGTATCTCTGTGCCAGCAGATCTAGCGGGGGAAGACGGGAGCTGTTTTTTGGAGAA	CASRSSGGRRELFF	1
GTGAACGCCTTGGAGCTGGACGACTCGGCCCTGTATCTCTGTGCCAGCAGCCCCGGGCCGCCTAACTATGGCTACACCTTCGGTTCG	CASSPGPPNYGYTF	1
ACCTTGGAGCTGGGGGACTCGGCCCTTTATCTTTGCGCCAGCAGCCCCGGGACAGGGGGAGCTAATGAAAAACTGTTTTTTGGCAGT	CASSPGTGGANEKLFF	1
CTGCAGCCAGAAGACTCAGCCCTGTATCTCTGCGCCAGCAGCCAAGATTCATACCTGGGGGGGAATTCACCCCTCCACTTTGGGAAC	CASSQDSYLGGNSPLHF	1
TCCTGTCCTCAGAACCGGGAGACACGGCACTGTATCTCTGCGCCAGCAGTCAATCGCTCTCGATCCTACGAGCAGTACTTCGGGCCG		1
GAGTCTGCCATCCCCAACCAGACAGCTCTTTACTTCTGTGCCACCAGTGCCCCCGGGGCGGCAGGGGAGACCCAGTACTTCGGGCCA	CATSAPGAAGETQYF	1
GCCCAAAAGAACCCGACAGCTTTCTATCTCTGTGCCAGTTTCACCGGGACTAGCGGGGTGAACACCGGGGAGCTGTTTTTTGGAGAA	CASFTGTSGVNTGELFF	1
CTTCACATCAATTCCCTGGAGCTTGGTGACTCTGCTGTGTATTTCTGTGCCAGCAGCCAAGTTGTCTCTGAAGCTTTCTTTGGACAA	CASSQVVSEAFF	1
GCCTTGGAGCTGGACGACTCGGCCCTGTATCTCTGTGCCAGCAGCTTTGGTGCGGGAGGGTACCACTACGAGCAGTACTTCGGGCCA	CASSFGAGGYHYEQYF	1
CCGCTACCAGCTCCCAGACATCTGTGTACTTCTGTGCCATCGCCGCCGGGACAGCATGACATGGGTTCACCCCTCCACTTTGGGAAC		1
AATTCCCTGGAGCTTGGTGACTCTGCTGTGTATTTCTGTGCCAGCAGCCAAGACCGGGGACAAAATTCACCCCTCCACTTTGGGAAC	CASSQDRGQNSPLHF	1
AATGTGAGCACCTTGGAGCTGGGGGACTCGGCCCTTTATCTTTGCGCCAGCAGCTGGACAGGGAACACTGAAGCTTTCTTTGGACAA	CASSWTGNTEAFF	1
ATCCAGCCTGCAGAGCTTGGGGACTCGGCCGTGTATCTCTGTGCCAGCAGCGGTGAGCGGGCCACCGGGGAGCTGTTTTTTGGAGAA	CASSGERATGELFF	1
AGGCTGCTGTCGGCTGCTCCCTCCCAGACATCTGTGTACTTCTGTGCCAGCAGTTACTCGCGGGAGTATGGCTACACCTTCGGTTCG	CASSYSREYGYTF	1
ACCAGTGCCCATCCTGAAGACAGCAGCTTCTACATCTGCAGTGCTGCCCTAGCGGGGGGTAGCACAGATACGCAGTATTTTGGCCCA	CSAALAGGSTDTQYF	1
GCCTTGTTGCTGGGGGACTCGGCCCTCTATCTCTGTGCCAGCAGCTTGTCCCTAGATATCAACACCGGGGAGCTGTTTTTTGGAGAA	CASSLSLDINTGELFF	1
TCTCTGGAGCTGGGGGACTCAGCTTTGTATTTCTGTGCCAGCAGCCCCCGGACAGTCTCTGGGGCCAACGTCCTGACTTTCGGGGCC	CASSPRTVSGANVLTF	1
AAGATCCAGCCCTCAGAACCCAGGGACTCAGCTGTGTACTTCTGTGCCAGCAGTTGGATCTCGCGCAATGAGCAGTTCTTCGGGCCA	CASSWISRNEQFF	1
CACGCCCTGCAGCCAGAAGACTCAGCCCTGTATCTCTGCGCCAGCAGCCAAGGGACAGGGGGAACCTACGAGCAGTACTTCGGGCCG	CASSQGTGGTYEQYF	1
CTGCTGTCGGCTGCTCCCTCCCAGACATCTGTGTACTTCTGTGCCAGCAAGCAGAGACAGCCTTTCACTGAAGCTTTCTTTGGACAA	CASKQRQPFTEAFF	1
CTGACAGTGACCAGTGCCCATCCTGAAGACAGCAGCTTCTACATCTGCAGCGCCGGGCCCGGAGAAGAGACCCAGTACTTCGGGCCA	CSAGPGEETQYF	1
ACTCTGGAGTCAGCTACCCGCTCCCAGACATCTGTGTATTTCTGCGCCAGCAGTGAGACAGCCAAAAACATTCAGTACTTCGGCGCC	CASSETAKNIQYF	1
ACCAGTGCCCATCCTGAAGACAGCAGCTTCTACATCTGCAGTGCTAGAGACCCCGGGACAGGGCCCTATGGCTACACCTTCGGTTCG	CSARDPGTGPYGYTF	1
GTGACCAGTGCCCATCCTGAAGACAGCAGCTTCTACATCTGCAGTGCTCCCCGAGGGAGGTCTGGCAATGAGCAGTTCTTCGGGCCA	CSAPRGRSGNEQFF	1
ATCCAGCAGGTAGTGCGAGGAGATTCGGCAGCTTATTTCTGTGCCAGCTCACCATTGGAGGGGAACACTGAAGCTTTCTTTGGACAA	CASSPLEGNTEAFF	1
AGTGCCCATCCTGAAGACAGCAGCTTCTACATCTGCAGTGCTAGACGAGGGCGGGCCCTATCGAACACTGAAGCTTTCTTTGGACAA	CSARRGRALSNTEAFF	1
CTGAGCTCTCTGGAGCTGGGGGACTCAGCTTTGTATTTCTGTGCCAGCAGCCCCAGGCGGGAGAGAGATACGCAGTATTTTGGCCCA	CASSPRRERDTQYF	1
CTGACTGTGAGCAACATGAGCCCTGAAGACAGCAGCATATATCTCTGCAGCGTTGAAGTTAGGGACACTGAAGCTTTCTTTGGACAA	CSVEVRDTEAFF	1
CCCTAGAGTCTGCCATCCCCAACCAGACAGCTCTTTACTTCTGTGCCTCTCCTGACACTCGCCAAAAACATTCAGTACTTCGGCGCC		1
CACGCCCTGCAGCCAGAAGACTCAGCCCTGTATCTCTGCGCCAGCAGCCGACTCGGACAGGCGATCTACGAGCAGTACTTCGGGCCG	CASSRLGQAIYEQYF	1
AGTGCCCATCCTGAAGACAGCAGCTTCTACATCTGCAGTGCTAGACCCCCGGGCAGGGGTCCCCAAAATGAGCAGTTCTTCGGGCCA	CSARPPGRGPQNEQFF	1
TTGTTGCTGGGGGACTCGGCCCTGTATCTCTGTGCCAGCAGCTTGAGCGCGGGAGGGTCCCTCTCCTACGAGCAGTACTTCGGGCCG	CASSLSAGGSLSYEQYF	1
ACATCGGCCCAAAAGAACCCGACAGCTTTCTATCTCTGTGCCAGTACCCCCCCCGGGGAGATGAACACTGAAGCTTTCTTTGGACAA	CASTPPGEMNTEAFF	1
CAGCGCACACAGCAGGAGGACTCGGCCGTGTATCTCTGTGCCAGCAGCGGGACAGGGCTGAACACCGGGGAGCTGTTTTTTGGAGAA	CASSGTGLNTGELFF	1
CAGCCCTCAGAACCCAGGGACTCAGCTGTGTACTTCTGTGCCACCTCTGAAACGGGACAACCAAACTATGGCTACACCTTCGGTTCG	CATSETGQPNYGYTF	1
CAGCGCACAGAGCAGGGGGACTCGGCCATGTATCTCTGTGCCAGCAGCTTATGAGAGATATAGAAACGGGAAGCTTTCTTTGGACAA	CASSL*EI*KREAFF	1
ACCTTGGAGCTGGGGGACTCGGCCCTTTATCTTTGCGCCAGCAGCCCCGGGATAGTCGCCTACCAAGAGACCCAGTACTTCGGGCCA	CASSPGIVAYQETQYF	1
ATCCGCTCACCAGGCCTGGGGGACGCAGCCATGTACCTGTGTGCCACCAGCAGCCGACTCACAGGGGACGGCTACACCTTCGGTTCG	CATSSRLTGDGYTF	1
TCCACAAAGCTGGAGGACTCAGCCATGTACTTCTGTGCCAGCAGTCGACAGGGGGCCAGATCGAACACTGAAGCTTTCTTTGGACAA	CASSRQGARSNTEAFF	1
AAGATCCAGCCCTCAGAACCCAGGGACTCAGCTGTGTACTTCTGTGCCAGCAGTTTACAGAGGGCAGATACGCAGTATTTTGGCCCA	CASSLQRADTQYF	1
ATCCAACCTGCAAAGCTTGAGGACTCGGCCGTGTATCTCTGTGCCAGCAGCTCGGACAGGAGGAATTCACCCCTCCACTTTGGGAAC	CASSSDRRNSPLHF	1
ATCCAGCCCTCAGAACCCAGGGACTCAGCTGTGTACTTCTGTGCCAGCAGTCCTCCCCATCGCTCCTACGAGCAGTACTTCGGGCCG	CASSPPHRSYEQYF	1
AGGCTGCTGTCGGCTGCTCCCTCCCAGACATCTGTGTACTTCTGTGCCAGCAGTTACCACAGGAGCACTGAAGCTTTCTTTGGACAA	CASSYHRSTEAFF	1
CGCACACAGCAGGAGGACTCCGCCGTGTATCTCTGTGCCAGCAGCTTCTTAGGGGTGAACCGGGCCAACGTCCTGACTTTCGGGGCC	CASSFLGVNRANVLTF	1
CAGGAGGACTCGGCCGTGTATCTCTGTGCCAGCAGCTTAGCCCCCGGCAGAGCGGGAGGGGGCACCGGGGAGCTGTTTTTTGGAGAA	CASSLAPGRAGGGTGELFF	1
TCGGCTGCTCCCTCCCAGACATCTGTGTACTTCTGTGCCAGCATCCACTTCTCAGCGGGGGGGCGCGGTGAGCAGTTCTTCGGGCCA	CASIHFSAGGRGEQFF	1
GCCTTGTTGCTGGGGGACTCGGCCCTGTATCTCTGTGCCAGCAGCTCGGAACGGATGGGACCTGACGAAAAACTGTTTTTTGGCAGT	CASSSERMGPDEKLFF	1
GAATGTGAATGCCTTGGAGCTGGAGGACTCGGCCCTGTATCTCTGTGCCAGCAGTCCCGGACAGATAATGAGCAGTTCTTCGGGCCA		1
GCTGCTCCCTCCCAGACATCTGTGTACTTCTGTGCCAGCAGTTACTCGTACAGGGGTCCTCTACAAGAGACCCAGTACTTCGGGCCA	CASSYSYRGPLQETQYF	1
CTGAACATGAGCTCCTTGGAGCTGGGGGACTCAGCCCTGTACTTCTGTGCCACAGGAAGGGGGGAAGAGACCCAGTACTTCGGGCCA	CATGRGEETQYF	1
ACTCTGACAGTGACCAGTGCCCATCCTGAAGACAGCAGCTTCTACATCTGCATGGGGACGACAACCTACGAGCAGTACTTCGGGCCG	CMGTTTYEQYF	1
GAGTCGGCTGCTCCCTCCCAGACATCTGTGTACTTCTGTGCCAGCAGACGAAAAGGGGAAGTTACTCAGCCCCAGCATTTTGGTGAT	CASRRKGEVTQPQHF	1
CTGAGCTCTCTGGAGCTGGGGGACTCAGCTTTGTATTTCTGTGCCAGCAGCGTACTTGGGGGCTCAGATACGCAGTATTTTGGCCCA	CASSVLGGSDTQYF	1
GAGTCGCCCAGCCCCAACCAGACCTCTCTGTACTTCTGTGCCAGCTGCGGACTAGCGGGACTTAGAGATACGCAGTATTTTGGCCCA	CASCGLAGLRDTQYF	1
GTGAGCACCTTGGAGCTGGGGGACTCGGCCCTTTATCTTTGCGCCAGCAACGAGGTGCCGGGCCCTTACGAGCAGTACTTCGGGCCG	CASNEVPGPYEQYF	1
CAGAACCGGGAGACACGGCACTGTATCTCTGCGCCAGCAGTCAATAGATAGGGGGGAGATAGCAATCAGCCCCAGCATTTTGGTGAT		1
CAGCAGGTAGTGCGAGGAGATTCGGCAGCTTATTTCTGTGCCAGCTCACCGGACAGGTCGAACACCGGGGAGCTGTTTTTTGGAGAA	CASSPDRSNTGELFF	1
CTGACGATCCAGCGCACACAGCAGGAGGACTCGGCCGTGTATCTCTGTGCCAGCAGCTTATCTGATCAGCCCCAGCATTTTGGTGAT	CASSLSDQPQHF	1
CAGGTAGTGCGAGGAGATTCGGCAGCTTATTTCTGTGCCAGCTCACCACGGGGACTAGCGGGTAACAATGAGCAGTTCTTCGGGCCA	CASSPRGLAGNNEQFF	1
ACTCAGCTTTGTATTTCTGTGCCAGCAGCGTAGACGGGGGTGATAAGGGGGAAGGGGCGAGGGAACACTGAAGCTTTCTTTGGACAA		1
GAGTCGCCCAGCCCCAACCAGACCTCTCTGTACTTCTGTGCCAGCAGTTCCGGGACCACATCGTTGAAAGGCTACACCTTCGGTTCG	CASSSGTTSLKGYTF	1
GAGTCCGCCAGCACCAACCAGACATCTATGTACCTCTGTGCCAGCAGTTTAAGTCCACAGGGGACTCAGCCCCAGCATTTTGGTGAT	CASSLSPQGTQPQHF	1
CGCACAGAGCAGCGGGACTCGGCCATGTATCGCTGTGCCAGCAGCCCGGCAGCGGGGGGACTCTACAATGAGCAGTTCTTCGGGCCA	CASSPAAGGLYNEQFF	1
CTGACTGTGAGCAACATGAGCCCTGAAGACAGCAGCATATATCTCTGCAGCGTTTTGGCGGCTAACTACGAGCAGTACTTCGGGCCA	CSVLAANYEQYF	1
GAGATCCAGCGCACACAGCAGGAGGACTCGGCCGTGTATCTCTGTGCCAACAGCTTGAGGACCGATCAGCCCCAGCATTTTGGTGAT	CANSLRTDQPQHF	1
ATCCAGCCCTCAGAACCCAGGGACTCAGCTGTGTACTTCTGTGCCAGCAGTTTAGCAGGGGTGAACACTGAAGCTTTCTTTGGACAA	CASSLAGVNTEAFF	1
TTCCCTGGAGCTTGGTGACTCTGCTGTGTATTTCTGTGCCAGTCAGGGGGAGCGGGGGGGACCCCGAATACGCAGTATTTTGGCCCA		1
CGCACAGAGCAGGGGGACTCGGCCATGTATCTCTGTGCCAGCAATATACACAGAGAACAGGGGTTGGAGACCCAGTACTTCGGGCCA	CASNIHREQGLETQYF	1
TTTCTTGACATCCGCTCACCAGGCCTGGGGGACGCAGCCATGTACCTGTGTGCCACCAGCGCGGGGACTGAGCAGTTCTTCGGGCCA	CATSAGTEQFF	1
ATCCAGCGCACACAGCAGGAGGACTCGGCCGTGTATCTCTGTGCCAGCAGCCCTCTTGGGACAGCCCGCGAGCAGTACTTCGGGCCG	CASSPLGTAREQYF	1
CTACACACCCTGCAGCCAGAAGACTCGGCCCTGTATCTCTGTGCCAGCAGCCAACCGGGGACAGAGATAAAAGCTTTCTTTGGACAA	CASSQPGTEIKAFF	1
AACTAAACCTGAGCTCTCTGGAGCTGGGGGACTCAGCTTTGTATTTCTGTGGGGGGACAGGGTTATGCGACCCAGTACTTCGGGCCA		1
ACTCTGACAGTGACCAGTGCCCATCCTGAAGACAGCAGCTTCTACATCTGCAGTGCTAGAGATCGTCTGGAGCAGTACTTCGGGCCG	CSARDRLEQYF	1
GCTACCAGCTCCCAGACATCTGTGTACTTCTGTGCCATCAGCTTTAAAGACGGGACAGGGGGCGACAATGAGCAGTTCTTCGGGCCA	CAISFKDGTGGDNEQFF	1
TCGCCCAGCCCCAACCAGACCTCTCTGTACTTCTGTGCCAGCAGTTCAGAGGGGGACGTCTACCAAGAGACCCAGTACTTCGGGCCA	CASSSEGDVYQETQYF	1
ACCTTGGAGCTGGGGGACTCGGCCCTTTATCTTTGCGCCAGCAGCTTGGCGGTAGCGGGAGGTGGGGAGACCCAGTACTTCGGGCCA	CASSLAVAGGGETQYF	1
CTGGAGTCGCCCAGCCCCAACCAGACCTCTCTGTACTTCTGTGCCAGCAGTAACGGACAGCTGAACACTGAAGCTTTCTTTGGACAA	CASSNGQLNTEAFF	1
CGGTCCACAAAGCTGGAGGACTCAGCCATGTACTTCTGTGCCAGCACCAAAGGGGAGGTGGCCCCCGGGACCCAGTACTTCGGGCCA	CASTKGEVAPGTQYF	1
TCAGCTGCGTATCTCTGCACCAGCAGCCAAGATTCGTGAGCGGGGGCCATAGGACTTCCTGGGGCCAACGTCCTGACTTTCGGGGCC	CTSSQDS*AGAIGLPGANVLTF	1
GCCCTCAGAACCCAGGGACTCAGCTGTGTACTTCTGTGCCAGCAGTTAAGACTAGCGGGAAATGGCTACGAGCAGTACTTCGGGCCG		1
ACAGTGACCAGTGCCCATCCTGAAGACAGCAGCTTCTACATCTGCAGTGCAATACCCAGCGGCGATCAGCCCCAGCATTTTGGTGAT	CSAIPSGDQPQHF	1
CTTGACATCCGCTCACCAGGCCTGGGGGACGCAGCCATGTACCTGTGTGCCACCAGCCGAGGGGGGCAGGAAGCTTTCTTTGGACAA	CATSRGGQEAFF	1
GAGTCGCCCAGCCCCAACCAGACCTCTCTGTACTTCTGTGCCAGCAAAGAGGCTAGCGGGAGGGGGGATGAGCAGTTCTTCGGGCCA	CASKEASGRGDEQFF	1
ACCTTGGAGCTGGGGGACTCGGCCCTTTATCTTTGCGCCAGCAGCGCGGGGACTAGCGGGGTAACAGATACGCAGTATTTTGGCCCA	CASSAGTSGVTDTQYF	1
CCTGGAGCTTGGTGACTCTGCTGTGTATTTCTGTGCCAGCAGCCAAGATACTACGGCGGGGGCGATTCACCCCTCCACTTTGGGAAC		1
GCCCATCCTGAAGACAGCAGCTTCTACATCTGCAGTGCCCAAAGAGGGACTCAACGGAGGGCCACAGATACGCAGTATTTTGGCCCA	CSAQRGTQRRATDTQYF	1
CGCACACAGCAGGAGGACTCGGCCGTGTATCTCTGTGCCAGCCAACTTCGAGGCGGGACAGGGACCTACGAGCAGTACTTCGGGCCA	CASQLRGGTGTYEQYF	1
ATCCGGTCCACAAAGCTGGAGGACTCAGCCATGTACTTCTGTGCCAGCAGGACAGGGGGCGGTAAAAACATTCAGTACTTCGGCGCC	CASRTGGGKNIQYF	1
AGCACCAACCAGACATCTATGTACCTCTGTGCCAGCAGTTCTTTCAGCGGGGGGCCGGGGTTCAAAGAGACCCAGTACTTCGGGCCA	CASSSFSGGPGFKETQYF	1
GAGTCCGCCAGCACCAACCAGACATCTATGTACCTCTGTGCCAGCGGGCACGAGGCAGGGAACAATCAGCCCCAGCATTTTGGTGAT	CASGHEAGNNQPQHF	1
CCTGAGCTCTCTGGAGCTGGGGGACTCAGCTTTGTATTTCTGTGCCAGCGGGTAGGGGGGGGCGAAGAGACCCAGTACTTCGGGCCA		1
ACGTTGGCGTCTGCTGTACCCTCTCAGACATCTGTGTACTTCTGTGCCAGCAATATACAGGGGAGCACTGAAGCTTTCTTTGGACAA	CASNIQGSTEAFF	1
CAGCGCACAGAGCAGGGGGACTCGGCCATGTATCTCTGTGCCAGCAGCTTAGGAGGGGGCGTAAACAATGAGCAGTTCTTCGGGCCA	CASSLGGGVNNEQFF	1
CAGGTAGTGCGAGGAGATTCGGCAGCTTATTTCTGTGCCAGCTCCGTAACCACTAGCGGGGGGGACAATGAGCAGTTCTTCGGGCCA	CASSVTTSGGDNEQFF	1
CACAGAGCAGGGGGACTCAGCCGCGTATCTCCGTGCCAGCAATTCACCGGGACAGGGACCAGGTGAACTGAAGCTTTCTTTGGACAA		1
CGGTCCACAAAGCTGGAGGACTCAGCCATGTACTTCTGTGCCAGCACCTTGGGCGAGGGGGCTTTCAATGAGCAGTTCTTCGGGCCA	CASTLGEGAFNEQFF	1
CTACACGCCCTGCAGCCAGAAGACTCAGCCCTGTATCTCTGCGCCAGCAGCCAAGGAGGGTTGCAAGAGACCCAGTACTTCGGGCCA	CASSQGGLQETQYF	1
CTGGAGTTGGCTGCTCCCTCCCAGACATCTGTGTACTTCTGTGCCACCCTCCCTGGGCAGGGCACCGGGGAGCTGTTTTTTGGAGAA	CATLPGQGTGELFF	1
ACTCTGAAGATCCAGCCCTCAGAACCCAGGGACTCAGCTGTGTACTTCTGTGCCAGCAGCAATCAGTGGGGCTACACCTTCGGTTCG	CASSNQWGYTF	1
AAGCTTGAGGACTCGGCCGTGTATCTCTGTGCCAGCAGCTCCAGACAGGGGCGGGCGGGAGCCACCTACGAGCAGTACTTCGGGCCG	CASSSRQGRAGATYEQYF	1
GGGGACACAGCACTGTATTTCTGTGCCAGCAGCAGGTCTGGGGGACTAGCGGGAGGCCCATAGGGCAATGAGCAGTTCTTCGGGCCA	CASSRSGGLAGGP*GNEQFF	1
CTGGAGTCGCCCAGCCCCAACCAGACCTCTCTGTACTTCTGTGCCAGCAGTTTAAACGGAAAAAATCAGCCCCAGCATTTTGGTGAT	CASSLNGKNQPQHF	1
ACCTTGGAGCTGGGGGACTCGGCCCTTTATCTTTGCGCCAGCAGCTCCCGGGACTCCCCCCCCACCGGGGAGCTGTTTTTTGGAGAA	CASSSRDSPPTGELFF	1
ACTGTGAGCAACATGAGCCCTGAAGACAGCAGCATATATCTCTGCAGCGTTGAAGAGCAGAGCGGGACTGAAGCTTTCTTTGGACAA	CSVEEQSGTEAFF	1
GAGTCTGCTGCCTCCTCCCAGACATCTGTATATTTCTGCGCCAGCAGTAAAGGGACTAGCGGGAGCTATGAGCAGTTCTTCGGGCCA	CASSKGTSGSYEQFF	1
CTTGTTGCTGGGGGACTCGGCCCTCTATCTCTGTGCCAGCAGCATCCCTCCGACGCGGGGGAGCGCACTGAAGCTTTCTTTGGACAA		1
CAGCCCTCAGAACCCAGGGACTCAGCTGTGTACTTCTGTGCCAGCGGAGACCGACTAATAGCCTACAATGAGCAGTTCTTCGGGCCA	CASGDRLIAYNEQFF	1
ATCCTGGAGTCGCCCAGCCCCAACCAGACCTCTCTGTACTTCTGTGCCAGCAACGCCCCCGGGGGCACTGAAGCTTTCTTTGGACAA	CASNAPGGTEAFF	1
CGCACACAGCAGGAGGACTCCGCCGTGTATCTCTGTGCCAGCAGCGCGCTAGGGCCCGCTCCCGGCAATGAGCAGTTCTTCGGGCCA	CASSALGPAPGNEQFF	1
ATCCGGTCCACAAAGCTGGAGGACTCAGCCATGTACTTCTGTGCCAGCAGTGAAGAGGACGGCCAAGAGACCCAGTACTTCGGGCCA	CASSEEDGQETQYF	1
ACAGTGACCAGTGCCCATCCTGAAGACAGCAGCTTCTACATCTGCAGTGCCCCGGACCCGTACACAGATACGCAGTATTTTGGCCCA	CSAPDPYTDTQYF	1
CATCCTGAAGACAGCAGCTTCTACATCTGCAGTGCTATTCCTCTAGCGCTTAGGGGGTCTAGCACAGATACGCAGTATTTTGGCCCA	CSAIPLALRGSSTDTQYF	1
CTGACAGTGACCAGTGCCCATCCTGAAGACAGCAGCTTCTACATCTGCAGTGCTCTTGGGGTGAACACTGAAGCTTTCTTTGGACAA	CSALGVNTEAFF	1
CTGATTCTGGAGTCCGCCAGCACCAACCAGACATCTATGTACCTCTGTGCCAGCAGTCCACCGCCGGGACACCCACATTTTGGTGAT	CASSPPPGHPHF	1
TTTCCCCTGACCCTGGAGTCTGCCAGGCCCTCACATACCTCTCAGTACCTCTGTGCCAGCAGCGATACAACACTGTTTTTTGGCAGT	CASSDTTLFF	1
AGTGCCCATCCTGAAGACAGCAGCTTCTACATCTGCAGTGCTAGAGAGAGGGGACTATTAAACACCGGGGAGCTGTTTTTTGGAGAA	CSARERGLLNTGELFF	1
ATCCAGCAGGTAGTGCGAGGAGATTCGGCAGCTTATTTCTGTGCCAGCTCACTGGGTTGGGGACAAGAGACCCAGTACTTCGGGCCA	CASSLGWGQETQYF	1
AGGCTGGAGTTGGCTGCTCCCTCCCAGACATCTGTGTACTTCTGTGCCAGCAGGGGACAGGACAATCAGCCCCAGCATTTTGGTGAT	CASRGQDNQPQHF	1
AGCTCTGAGCTGAATGTGAACGCCTTGGAGCTGGACGACTCGGCCCTGTATCCACCGAGGGGGCGATCGGTGGTTTTCTTTGGACAA	PRGRSVVFF	1
CAGCCCTCAGAACCCAGGGACTCAGCTGTGTACTTCTGTGCCAGCAGTCCCCGGCGCGGAGGTCAAGAGACCCAGTACTTCGGGCCA	CASSPRRGGQETQYF	1
GAGCAGGGGGACTCAGCTGTGTATCTCTGTGCCAGCAGCTTAGACTAGCGGGAGCCCCCTGCGCAAGAGACCCAGTACTTCGGGCCA	CASSLD*REPPAQETQYF	1
CTGCTGGGGTTGGAGTCGGCTGCTCCCTCCCAAACATCTGTGTACTTCTGTGCCAGCAGTCAGAACACTGAAGCTTTCTTTGGACAA	CASSQNTEAFF	1
CTGGAGTCGCCCAGCCCCAACCAGACCTCTCTGTACTTCTGTGCCAGCAGTCGGGACAGGGCGCCCAGCGAGCAGTACTTCGGGCCG	CASSRDRAPSEQYF	1
CGCACACAGCAGGAGGACTCCGCCGTGTATCTCTGTGCCAGCAGCTCCGCTGCGGGGTCGTCTCTGGATACGCAGTATTTTGGCCCA	CASSSAAGSSLDTQYF	2
CAACCTGCAAAGCTTGAGGACTCGGCCGTGTATCTCTGTGCCAGCAGCTTACGGGGGGCTTTAACCTACGAGCAGTACTTCGGGCCG	CASSLRGALTYEQYF	1
TGCCTCCTCCCAGACATCTGTATATTTCTGCGCCAGCAGTGATATCACCCCTCAGGGCTCTGGGGCAATGAGCAGTTCTTCGGGCCA		1
AGGGGACACAGCACTGTATTTCTGTGCCAGCAGCAAAGATTGAGCCACCCAGGGGACTCCCTAGGCTACGAGCAGTACTTCGGGCCG		1
ATTCTGGAGTCCGCCAGCACCAACCAGACATCTATGTACCTCTGTGCCAGCAGGCCCGACAGGGCCCGAGGCTACACCTTCGGTTCG	CASRPDRARGYTF	1
AGGCTGGAGTCGGCTGCTCCCTCCCAGACATCTGTGTACTTCTGTGCCGGCCGGGGTTCTGGGGCCAACGTCCTGACTTTCGGGGCC	CAGRGSGANVLTF	1
GGAGTCCGCCAGCACCAACCAGACATCTATGTACCTCTGTGCCAGGAGAGCAAAAGGGACAACTACAATGAGCAGTTCTTCGGGCCA		1
GTGAACGCCTTGTTGCTGGGGGACTCGGCCCTGTATCTCTGTGCCAGCAGCTCCGGGACACTAAAAGAAAAACTGTTTTTTGGCAGT	CASSSGTLKEKLFF	1
TCTCACTGTGACATCGGCCCAAAAGAACCCGACAGCTTTCTATCTCTGTGCCAGTAGTATGCTCAGGGTGGCTACACCTTCGGTTCG		1
ACTGTGACATCGGCCCAAAAGAACCCGACAGCTTTCTATCTCTGTGCCAGTAGTATGAATACCCAAGAGACCCAGTACTTCGGGCCA	CASSMNTQETQYF	1
AGCGCACAGAGCAGGGGGACTCAGCCGCGTATCTCCGTGCCAGCAGAGGGGAATGGAGCTGGGGCCAACGTCCTGACTTTCGGGGCC		1
GAGTTGGCTGCTCCCTCCCAGACATCTGTGTACTTCTGTGCCAGCAGGTATACTAGCGGGAGTCTAAATGAGCAGTTCTTCGGGCCA	CASRYTSGSLNEQFF	1
CCGCTCAGGCTGGAGTTGGCTGCTCCCTCCCAGACATCTGTGTACTTCTGTGCCAGCACGCAGGCGGGGGGCTACACCTTCGGTTCG	CASTQAGGYTF	1
CTGTCGGCTGCTCCCTCCCAGACATCTGTGTACTTCTGTGCCAGCAGTTTTGGACAGGGGGCGGGGTATACGCAGTATTTTGGCCCA	CASSFGQGAGYTQYF	1
AATGTGAACGCCTTGTTGCTGGGGGACTCGGCCCTCTATCTCTGTGCCAGCAGCTTAAGCTCTGGAAACACCATATATTTTGGAGAG	CASSLSSGNTIYF	2
CAGCCAGAAGACTCGGCCCTGTATCTCTGTGCCAGCAGCCAAGACATAAGAACTAGCGGGGGTGTATATGAGCAGTTCTTCGGGCCA	CASSQDIRTSGGVYEQFF	1
TTGGCGTCTGCTGTACCCTCTCAGACATCTGTGTACTTCTGTGCCAGCAGTGACGGAACGGACCTCGATACGCAGTATTTTGGCCCA	CASSDGTDLDTQYF	1
ATGAATGTGAGCACCTTGGAGCTGGGGGACTCGGCCCTTTATCTTTGCGCCAGCAGCCGGACGGTGATCGAGCAGTACTTCGGGCCG	CASSRTVIEQYF	1
GTTGGAGTCGGCTGCTCCCTCCCAAACATCTGTGTACTTCTGTGCCAGCAGCCCCCCCTCCAGGTCTACGAGCAGTACTTCGGGCCG		1
CAGGTAGTGCGAGGAGATTCGGCAGCTTATTTCTGTGCCAGCTCACCTTTTGTTGGGACAGAATATTCACCCCTCCACTTTGGGAAC	CASSPFVGTEYSPLHF	1
CCTGCAAAGCTTGAGGACTCGGCCGTGTATCTCTGTGCCAGCAGCGCCGGGACAGGGAAGACAGAGGGGGGCTACACCTTCGGTTCG	CASSAGTGKTEGGYTF	1
CAGCGCACACAGCAGGAGGACTCGGCCGTGTATCTCTGTGCCAGCAGCTTAGGCCAGAGTAGCAATCAGCCCCAGCATTTTGGTGAT	CASSLGQSSNQPQHF	1
CTGGAGTCTGCTGCCTCCTCCCAGACATCTGTATATTTCTGCGCCAGCAGTAAGAACAGGGACTCCGGGGAGCTGTTTTTTGGAGAA	CASSKNRDSGELFF	1
AGATCCAGCCTGCAAAGCTTGAGGACTCGGCCGTGTATCTCTGTGCCAGCAGCTTATCGACAGGCCAACGAGCAGTACTTCGGGCCG		1
TGTGAACGCCTTGTTGCTGGGGGACTCGGCCCTCTATCTCTGTGCCAGCAGCTGTACAGGGATTGGCAGCCCCAGCATTTTGGTGAT		1
TCGGCTGCTCCCTCCCAGACATCTGTGTACTTCTGTGCCAGCAGTCTAGGACAGGGGGCGGGAACCGGGGAGCTGTTTTTTGGAGAA	CASSLGQGAGTGELFF	2
CAAAAGAACCCGACAGCTTTCTATCTCTGTGCCAGTAGTAAGCACAGGGGGGTAGGGAATAGCAATCAGCCCCAGCATTTTGGTGAT	CASSKHRGVGNSNQPQHF	1
ATCCAGCGCACACAGCAGGAGGACTCGGCCGCGTATCTCTGTGCCAGCAGCTTAGAGCGGCTCACAGATACGCAGTATTTTGGCCCA	CASSLERLTDTQYF	1
ATTCTGGAGTCCGCCAGCACCAACCAGACATCTATGTACCTCTGTGCCAGCAGCAATCCGCAGAACACTGAAGCTTTCTTTGGACAA	CASSNPQNTEAFF	1
GAGCTTGGTGACTCTGCTGTGTATTTCTGTGCCGCCAGCCCGGGTTTGGGTTCGGGACAGGGGGCAAAGACCCAGTACTTCGGGCCA	CAASPGLGSGQGAKTQYF	2
CTGGAGTCAGCTACCCGCTCCCAGACATCTGTGTATTTCTGCGCCAGTACGCGGGAACAGGGAACGAGAGGACAGTTCTTCGGGCCA	CASTREQGTRGQFF	1
ACATCGGCCCAAAAGAACCCGACAGCTTTCTATCTCTGTGCCAGTAGTATAAAGGACAGCCTACCGGGCGGCTACACCTTCGGTTCG	CASSIKDSLPGGYTF	2
CCTGCAGAGCTTGGGGACTCGGCCGTGTATCTCTGTGCCAGCAGCTTAGATGGACAGGGGGGCTACAATGAGCAGTTCTTCGGGCCA	CASSLDGQGGYNEQFF	1
CGCACAGAGCAGCGGGACTCAGCCATGTATCGCTGTGCCAGCAGCTTAGGCACCATAGCGGAACAAGAGACCCAGTACTTCGGGCCA	CASSLGTIAEQETQYF	1
TCGGCTGCTCCCTCCCAAACATCTGTGTACTTCTGTGCCAGCAGGACTAGCGGGAGGGAGAACACCGGGGAGCTGTTTTTTGGAGAA	CASRTSGRENTGELFF	1
ACTCTGGAGTCCGCTACCAGCTCCCAGACATCTGTGTACTTCTGTGCCATCGGACTGGGGGTTTCAGAGACCCAGTACTTCGGGCCA	CAIGLGVSETQYF	1
CTGGAGTCCGCCAGCACCAACCAGACATCTATGTACCTCTGTGCCAGCAGTTTACTGGGAGGGGACTACGAGCAGTACTTCGGGCCG	CASSLLGGDYEQYF	1
CACACCCTGCAGCCAGAAGACTCGGCCCTGTATCTCTGCGCCAGCAGCCTAAGCTTTGAAGCCAAAAACATTCAGTACTTCGGCGCC	CASSLSFEAKNIQYF	2
CTGACGATCCAGCGCACAGAGCAGCGGGACTCGGCCATGTATCGCTGTGCCAGCAGCCACGACTACAATGAGCAGTTCTTCGGGCCA	CASSHDYNEQFF	1
ATCCGGTCCACAAAGCTGGAGGACACAGCCATGTACTTCTGTGCCAGCACTTTGGAGACAGGAAACTATGGCTACACCTTCGGTTCG	CASTLETGNYGYTF	1
CGCACACAGCAGGAGGACTCCGCCGTGTATCTCTGTGCCAGCAGCTTAGCGGGCAGGGGGCACACCGGGGAGCTGTTTTTTGGAGAA	CASSLAGRGHTGELFF	1
TCACTGTGACATCGGCCCAAAAGAACCCGACAGCTTTCTATCTCTGTGCCACCACAGGGCACTAATGAAAAACTGTTTTTTGGCAGT		1
GCACACAGCAGGAGGACTCGGCCGTGTATCTCTGTGCCAGCAGCCGAGGTGAGGGCTTCGGCCAATCAGCCCCAGCATTTTGGTGAT		1
CGCTCACCAGGCCTGGGGGACGCAGCCATGTACCTGTGTGCCACCAGCAGAGATCGGGGGGGCACCTACGAGCAGTACTTCGGGCCG	CATSRDRGGTYEQYF	1
GAGTCGGCTGCTCCCTCCCAAACATCTGTGTACTTCTGTGCCAGCAGGAAAGGGACTAGCGGGTTCTACGAGCAGTACTTCGGGCCG	CASRKGTSGFYEQYF	1
ACAGTGACCAGTGCCCATCCTGAAGACAGCAGCTTCTACATCTGCAGTGCTAGGAAGCCAGCGAACACTGAAGCTTTCTTTGGACAA	CSARKPANTEAFF	1
AGTGACCAGTGCCCATCCTGAAGACAGCAGCTTCTACATCTGCAGTGCTAGAGGGTACCTTGCACAGATACGCAGTATTTTGGCCCA		1
TTGGAGCTGGGGGACTCGGCCCTTTATCTTTGCGCCAGCAGCTTATCCAGCCTAAGCTCCTATAATTCACCCCTCCACTTTGGGAAC	CASSLSSLSSYNSPLHF	1
AAGATCCGGTCCACAAAGCTGGAGGACTCAGCCATGTACTTCTGTGCCAGCATCCTGGACAGGAACAATGAGCAGTTCTTCGGGCCA	CASILDRNNEQFF	1
ATCCGGTCCACAAAGCTGGAGGACTCAGCCATGTACTTCTGTGCCAGCAGTTCGTCTTTGAACCTGGGGGGCTACACCTTCGGTTCG	CASSSSLNLGGYTF	1
AGGCTGGAGTTGGCTGCTCCCTCCCAGACATCTGTGTACTTCTGTGCCAGCAGTTTAGACGAAGCAGATACGCAGTATTTTGGCCCA	CASSLDEADTQYF	1
CAGCGCACACAGCAGGAGGACTCCGCCGTGTATCTCTGTGCCAGCAGCTTAGACTCGCAGACTTCCTACGAGCAGTACTTCGGGCCG	CASSLDSQTSYEQYF	1
CAGCGCACAGAGCAGCGGGACTCGGCCATGTATCGCTGTGCCAGCAGCTCCCGACACGCAACTAATGAAAAACTGTTTTTTGGCAGT	CASSSRHATNEKLFF	1
CTGACGATCCAGCGCACACAGCAGGAGGACTCGGCCGTGTATCTCTGTGCCAGCAGCTTACAGGAAAACATTCAGTACTTCGGCGCC	CASSLQENIQYF	1
ACAGTGACCAGTGCCCATCCTGAAGACGGCAGCTTCTACATCTGCAGTGCTAGAGATGGTGTTAACTATGGCTACACCTTCGGTTCG	CSARDGVNYGYTF	1
GTGACCAGTGCCCATCCTGAAGACAGCAGCTTCTACATCTGCAGTGCTACTAGCGGACCTGGCACCGGGGAGCTGTTTTTTGGAGAA	CSATSGPGTGELFF	1
ACAGTGACCAGTGCCCATCCTGAAGACAGCAGCTTCTACATCTGCAGTGCTTCGACAGACACAAGAACTGAAGCTTTCTTTGGACAA	CSASTDTRTEAFF	1
GAGCTGGGGGACTCAGCTTTGTATTTCTGTGCCAGCAGCGTAGCCGTTGCTCGCGGGACAGGGGGCACTGAAGCTTTCTTTGGACAA	CASSVAVARGTGGTEAFF	2
GAGTCGGCTGCTCCCTCCCAGACATCTGTGTACTTCTGTGCCAGCAGTGAGCTGGACAGGGCCCTAGGGCCCCAGCATTTTGGTGAT	CASSELDRALGPQHF	1
CTGGAGTCGCCCAGCCCCAACCAGACCTCTCTGTACTTCTGTGCCAGCAGTTCTCACCGTACAGGGGACGGAGCTTTCTTTGGACAA	CASSSHRTGDGAFF	2
CCTGCAGAGCTTGGGGACTCGGCCGTGTATCTCTGTGCCAGCAGCCAAAACTAGGATACGAACACCGGGGAGCTGTTTTTTGGAGAA	CASSQN*DTNTGELFF	1
CGCACAGAGCAGGGGGACTCGGCCATGTATCTCTGTGCCAGCAGCTCGGGACTAGCTGTAAGCACAGATACGCAGTATTTTGGCCCA	CASSSGLAVSTDTQYF	1
TTGTTGCTGGGGGACTCGGCCCTCTATCTCTGTGCCAGCAGCTACAACGCAGGGGGCAGACGGAACACTGAAGCTTTCTTTGGACAA	CASSYNAGGRRNTEAFF	1
CACATCAATTCCCTGGAGCTTGGTGACTCTGCTGTGTATTTCTGTGCCAGCAGCCAAGCTTTGGGCACTGAAGCTTTCTTTGGACAA	CASSQALGTEAFF	1
ATCAATTCCCTGGAGCTTGGTGACTCTGCTGTGTATTTCTGTGCCAGCAGCCCCCAGAGGAGCTCCTACGAGCAGTACTTCGGGCCG	CASSPQRSSYEQYF	1
ACAGTGACCAGTGCCCATCCTGAAGACAGCAGCTTCTACATCTGCAGTGCCGTCTTGGACTACACAGATACGCAGTATTTTGGCCCA	CSAVLDYTDTQYF	1
GACCAGTGCCCATCCTGAAGACAGCAGCTTCTACATCTGCAGTGCAAGCCCCCCCAACAGGGCGACTATGGCTACACCTTCGGTTCG		1
AGGATCCAGCAGGTAGTGCGAGGAGATTCGGCAGCTTATTTCTGTGCCAGCTCACCGGGCAGCCAAGAGACCCAGTACTTCGGGCCA	CASSPGSQETQYF	1
ATCCAACCTGCAAAGCTTGAGGACTCGGCCGTGTATCTCTGTGCCAGCAGTAACAGGGGGCTCAATTCACCCCTCCACTTTGGGAAC	CASSNRGLNSPLHF	1
AACGCCTTGTTGCTGGGGGACTCGGCCCTGTATCTCTGTGCCAGCAGCTTGGCTGCAGGTCGGCATGAAAAACTGTTTTTTGGCAGT	CASSLAAGRHEKLFF	1
CTGGAGTCAGCTACCCGCTCCCAGACATCTGTGTATTTCTGCGCCAGCAGTGCACAGGCTTTGGGCTATGGCTACACCTTCGGTTCG	CASSAQALGYGYTF	1
AGCTCTCTGGAGCTGGGGGACTCAGCTTTGTATTTCTGTGCCAGCAGCCAGTGGGACGGTACATTTGGCATTCAGTACTTCGGCGCC	CASSQWDGTFGIQYF	1
CTCACTCTGGAGTCTGCTGCCTCCTCCCAGACATCTGTATATTTCTGCGCCAGCGGGCAACAGGGGTACGAGCAGTACTTCGGGCCG	CASGQQGYEQYF	1
GAATGCCTTGGAGCTGGAGGACTCGGCCCTGTATCTCTGTGCCAGCAGCTTACAGGGAATAGCAATCAGCCCCAGCATTTTGGTGAT		1
AGGATCCAGCAGGTAGTGCGAGGAGATTCGGCAGCTTATTTCTGTGCCAGCACCGGGACACGAAATCAGCCCCAGCATTTTGGTGAT	CASTGTRNQPQHF	1
CAGCCTGCAGAGCAGGGGGACTCGGCCGTGTATGTCTGTGCAAGTCGCTTAATTCCGGGGATGAACACTGAAGCTTTCTTTGGACAA	CASRLIPGMNTEAFF	1
ATCCTGAGTTCTAAGAAGCTCCTTCTCAGTGACTCTGGCTTCTATCTCTGTGCCTGGAGTGTTTGGGAGACCCAGTACTTCGGGCCA	CAWSVWETQYF	1
ATCCAGCGCACAGAGCAGGAGGACTCGGCCATGTATCTCTGTGCCAGCAGCCCGGGAGCCCTTAATGAAAAACTGTTTTTTGGCAGT	CASSPGALNEKLFF	1
AACGCCTTGTTGCTGGGGGACTCGGCCCTCTATCTCTGTGCCAGCAGCTTGGAATCCAGGCCTAATGAAAAACTGTTTTTTGGCAGT	CASSLESRPNEKLFF	1
GTGAACGCCTTGGAGCTGGACGACTCGGCCCTGTATCTCTGTGCCAGCAGCTTGGGACACCCTAATGAAAAACTGTTTTTTGGCAGT	CASSLGHPNEKLFF	1
ATCCTGGAGTCGCCCAGCCCCAACCAGACCTCTCTGTACTTCTGTGCCAGCAGGGGACTAGTCCAAGAGACCCAGTACTTCGGGCCA	CASRGLVQETQYF	1
AGCAACATGAGCCCTGAAGACAGCAGCATATATCTCTGCAGCGTGACAGGGGTGGGTAGGGGGGGAGAGACCCAGTACTTCGGGCCA	CSVTGVGRGGETQYF	1
AACGCCTTGTTGCTGGGGGACTCGGCCCTGTATCTCTGTGCCAGCAGCTTAACCGGGACACCAGGCCTCGAGCAGTACTTCGGGCCG	CASSLTGTPGLEQYF	1
CAGCGCACACAGCAGGAGGACTCGGCCGTGTATCTCTGTGCCAGCAGCCCCAGCAGGGGGCACAATTCACCCCTCCACTTTGGGAAC	CASSPSRGHNSPLHF	1
GAGTCTGCCATCCCCAACCAGACAGCTCTTTACTTCTGTGCCACCAGTGACCCAACTAGCGGCCAAGAGACCCAGTACTTCGGGCCA	CATSDPTSGQETQYF	1
CAGCGCACAGAGCAGGGGGACTCGGCCATGTATCTCTGTGCCAGCAGCCCCACGGGCCCCGCGGGCTATGGCTACACCTTCGGTTCG	CASSPTGPAGYGYTF	1
ACAAAGCTGGAGGACTCAGCCATGCACTTCTGTGCCAGCAAGACAAGGGAAACCAACTCTGGGGCCAACGTCCTGACTTTCGGGGCC	CASKTRETNSGANVLTF	1
TAAACCTGGGCTCTCTGGAGCTGGGGGACTCAGCTTTGTATTTCTGTGCCAGCAGCGTAGTGACGAACCCCAGCTTTCTTTGGACAA		1
GAGCTGAATGTGAACGCCTTGTTGCTGGGGGACTCGGCCCTCTATCTCTGTGCCAGCAGCTTGGGTGGGGAGCTGTTTTTTGGAGAA	CASSLGGELFF	1
TCCACAAAGCTGGAGGACTCAGCCATGTACTTCTGTGCCAGCAGTGAAGCGGCGGGGTATGGGGCCAACGTCCTGACTTTCGGGGCC	CASSEAAGYGANVLTF	2
CAGCGCACACAGCAGGAGGACTCGGCCGTGTATCTCTGTGCCAGCAGCCCTACGGTCGGGGCAAACTATGGCTACACCTTCGGTTCG	CASSPTVGANYGYTF	1
TCGGCCCAAAAGAACCCGACAGCTTTCTATCTCTGTGCCAGTAGTTCGCAGGGGGCGCGGAATAATGAAAAACTGTTTTTTGGCAGT	CASSSQGARNNEKLFF	1
GTGAGCACCTTGGAGCTGGGGGACTCGGCCCTTTATCTTTGCGCCAGCAGCTTTTGGACAGCTCAAGAGACCCAGTACTTCGGGCCA	CASSFWTAQETQYF	1
CAGCCTGCAGAGCAGGGGGACTCGGCCGTGTATGTCTGTGCAAGTCGCTTTAGTCCGTCGCCCAATGAAAAACTGTTTTTTGGCAGT	CASRFSPSPNEKLFF	1
AGCACCTTGGAGCTGGGGGACTCGGCCCTTTATCTTTGCGCCAGCAGCTTGGAGGGGTTTAGCAATCAGCCCCAGCATTTTGGTGAT	CASSLEGFSNQPQHF	1
AAGATCCGGTCCACAAAGCTGGAGGACTCAGCCATGTACTTCTGTGCCAGCAGGGCAAGTACAGGGGACGAGCAGTACTTCGGGCCG	CASRASTGDEQYF	1
CGCTCACCAGGCCTGGGGGACGCAGCCATGTACCTGTGTGCCACCAGCAGAGGGGAGGCGAGGCGGCAGACCCAGTACTTCGGGCCA	CATSRGEARRQTQYF	1
GAGTCCGCCAGCACCAACCAGACATCTATGTACCTCTGTGCCAGCAGTTTAAATAGTGGGAGTCGGTACGAGCAGTACTTCGGGCCG	CASSLNSGSRYEQYF	1
CTCAGGCTGCTGTCGGCTGCTCCCTCCCAGACATCTGTGTACTTCTGTGCCAGCAGTGGACCGCTGGGCGAGCAGTACTTCGGGCCG	CASSGPLGEQYF	1
ATTCTGGAGTCCGCCAGCACCAACCAGACATCTATGTACCTCTGTGCCAGCAGTCTAACCAGCTCCTACGAGCAGTACTTCGGGCCG	CASSLTSSYEQYF	1
GAGTCGCCCAGCCCCAACCAGACCTCTCTGTACTTCTGTGCCAGCGGCACCACAGGGGGCGCGTTAGATACGCAGTATTTTGGCCCA	CASGTTGGALDTQYF	1
AAGCTCCTTCTCAGTGACTCTGGCTTCTATCTCTGTGCCTGGATAGCTGGTGGACTAGCGGTTTACAATGAGCAGTTCTTCGGGCCA	CAWIAGGLAVYNEQFF	2
ACCAGTGCCCATCCTGAAGACAGCAGCTTCTACATCTGCAGTGCTACAGCAACGTATAAGAACACCGGGGAGCTGTTTTTTGGAGAA	CSATATYKNTGELFF	1
TCGGCCCAAAAGAACCCGACAGCTTTCTATCTCTGTGCCAGTAGCTTTTCCGCGGGTGGTAGCAATCAGCCCCAGCATTTTGGTGAT	CASSFSAGGSNQPQHF	1
ACCAGTGCCCATCCTGAAGACAGCAGCTTCTACATCTGCAGTGCGCCCCTAAGCACAGGAGTTCGGTCACCCCTCCACTTTGGGAAC	CSAPLSTGVRSPLHF	1
CACCAACCAGACATCTATGTACCTCTGTGCCAGCAGTTTAAGGCTACGACAGGGGGCCCCTTGAACACTGAAGCTTTCTTTGGACAA		1
CAGCATCCTGAGGATCCAGCAGGTAGTGCGAGGAGATTCGGCAGCTTATTTCTGTGCCAGCCCAAAGAGACCCAGTACTTCGGGCCA		1
ATCCAGCAGGTAGTGCGAGGAGATTCGGCAGCTTATTTCTGTGCCAGCTCATTGGGCCCGGGAGACACTGAAGCTTTCTTTGGACAA	CASSLGPGDTEAFF	1
TCGGCTGCTCCCTCCCAGACATCTGTGTACTTCTGTGCCAGCAGTGAGAACCTAGGGGGACAGGGTCAGCCCCAGCATTTTGGTGAT	CASSENLGGQGQPQHF	1
CTGACAGTGACCAGTGCCCATCCTGAAGACAGCAGCTTCTACATCTGCAGTGCTAACAGGGGACCCTACGAGCAGTACTTCGGGCCG	CSANRGPYEQYF	1
GTGACATCGGCCCAAAAGAACCCGACAGCTTTCTATCTCTGTGCCAGTAGTATGGGGGTCAGGACCTACGAGCAGTACTTCGGGCCG	CASSMGVRTYEQYF	1
CTGTCGGCTGCTCCCTCCCAGACATCTGTGTACTTCTGTGCCAGCAGGGCTAGGGCGGGAATAATATACGAGCAGTACTTCGGGCCG	CASRARAGIIYEQYF	1
AGCACCTTGGAGCTGGGGGACTCGGCCCTTTATCTTTGCGCCAGCAGCTGCTTCAGGTCCCTGAGCGAAAAACTGTTTTTTGGCAGT	CASSCFRSLSEKLFF	1
TCTGGAGTCTGCTGCCTCCTCCCAGACATCTGTATATTTCTGCGCCAGATACCCGGGACAGGGAACACTGAAGCTTTCTTTGGACAA		1
ACGATCCAGCGCACACAGCAGGAGGACTCGGCCGTGTATCTCTGTGCCAGCAGCGATTACAGCACAGATACGCAGTATTTTGGCCCA	CASSDYSTDTQYF	1
ATGTGAACGCCTTGTTGCTGGGGGACTCGGCCCTCTATCTCTGTGCCAGCAGCTTGGCCCGACGGTTTCTCCTAGTACTTCGGGCCA		1
CAGTCCACGGAGTCAGGGGACACAGCACTGTATTTCTGTGCCAGCAGCAAAGGGTAGTCCCTGGGCCATGGCTACACCTTCGGTTCG	CASSKG*SLGHGYTF	1
ATCCCCAACCAGACAGCTCTTTACTTCTGTGCCACCAGTGATTTTACGACGGGACAAAGTGGCCCAGATACGCAGTATTTTGGCCCA	CATSDFTTGQSGPDTQYF	1
ATCCAGCCCTCAGAACCCAGGGACTCAGCTGTGTACTTCTGTGCCAGCAGTTTTGGGACTAGCGCAGATACGCAGTATTTTGGCCCA	CASSFGTSADTQYF	1
CACCCTGCAGCCAGAAGACTCGGCCCTGTATCTCTGCGCCAGCAGCCGCTACGGGAGCTGAGGCAAGAGACCCAGTACTTCGGGCCA		1
TCTAAGAAGCTCCTTCTCAGTGACTCTGGCTTCTATCTCTGTGCCTGGACGGCCAGTAAGTTCACCGGGGAGCTGTTTTTTGGAGAA	CAWTASKFTGELFF	1
CTGCTGTCGGCTGCTCCCTCCCAGACATCTGTGTACTTCTGTGCCAGTACTCGGGACAGCATGAACACTGAAGCTTTCTTTGGACAA	CASTRDSMNTEAFF	1
CGCACACAGCAGGAGGACTCGGCCGTGTATCTCTGTGCCAGCAGCTTAGCGAGCAGGGTTGAGCAGCACGAGCAGTACTTCGGGCCG	CASSLASRVEQHEQYF	1
GAGTCCGCCAGCACCAACCAGACATCTATGTACCTCTGTGCCAGCAGAATGTCAGGGGGTCAAAACGGGCCCCAGCATTTTGGTGAT	CASRMSGGQNGPQHF	1
CTGAAGATCCAGCCCTCAGAACCCAGGGACTCAGCTGTGTACTTCTGTGCCAGCAGCTCAGGGGCGAATGAGCAGTTCTTCGGGCCA	CASSSGANEQFF	1
ACCAGTGCCCATCCTGAAGACAGCAGCTTCTACATCTGCAGTGCTAGTGTTACAGGCTCTGGGGCCAACGTCCTGACTTTCGGGGCC	CSASVTGSGANVLTF	1
CTGGAGTCCGCCAGCACCAACCAGACATCTATGTACCTCTGTGCCAGCAATGAGGACGGTTGGGATAGTGAGCAGTACTTCGGGCCG	CASNEDGWDSEQYF	1
CAGCAGGTAGTGCGAGGAGATTCGGCAGCTTATTTCTGTGCCAGCTCATCAGTACAGGGTCAGAATCAGCCCCAGCATTTTGGTGAT	CASSSVQGQNQPQHF	1
ACGCCTTGGAGCTGGACGACTCGGCCCTGTATCTCTGTGCCAGCAGCTTGGTGGGTATAAGCCAAAAACATTCAGTACTTCGGCGCC		1
CTTCACATCAATTCCCTGGAGCTTGGTGACTCTGCTGTGTATTTCTGTGCCAGCAGCCAAGGGACGGTTGAAGCTTTCTTTGGACAA	CASSQGTVEAFF	1
CAGCGCACACAGCAGGAGGACTCGGCCGTGTATCTCTGTGCCAGCAGCCCCATGAGGGGCGGACACTATGGCTACACCTTCGGTTCG	CASSPMRGGHYGYTF	1
CACACCCTGCAGCCAGAAGACTCGGCCCTGTATCTCTGCGCCAGCAGCTATGGGACCACAGGGTCGTATGGCTACACCTTCGGTTCG	CASSYGTTGSYGYTF	3
AGTGCCCATCCTGAAGACAGCAGCTTCTACATCTGCAGTGCTAGAGGGGGCCGGAAACAGGTAGAAAACATTCAGTACTTCGGCGCC	CSARGGRKQVENIQYF	1
CTGCTGTCGGCTGCTCCCTCCCAGACATCTGTGTACTTCTGTGCCAGCAGTTATCGGCCGCCTAGGGATGGCTACACCTTCGGTTCG	CASSYRPPRDGYTF	1
TCAATTCCCTGGAGCTTGGTGACTCTGCTGTGTATTTCTGTGCCAGCAGCTTCGACTGGGGACAGAGACGAGCAGTACTTCGGGCCG		1
AAGAAGCTCCTTCTCAGTGACTCTGGCTTCTATCTCTGTGCCTGGAGTGTACACCCAGGGCAGAGGCAGCCCCAGCATTTTGGTGAT	CAWSVHPGQRQPQHF	1
GCTGGGGGACTCAGCTTTGTATTTCTGTGCCAGCAGCGTAGGTGGATTGGGCAGGGGGACAGAAATGAAAAACTGTTTTTTGGCAGT		1
CGCACACAGCAGGAGGACTCGGCCGTGTATCTCTGTGCCAGCAGCCCTCAGGGACTTTCCTCTGGAAACACCATATATTTTGGAGAG	CASSPQGLSSGNTIYF	1
TCGGCCCAAAAGAACCCGACAGCTTTCTATCTCTGTGCCAGTAGTATTAAAACTAGCGGGAATAAGGGTGAGCAGTTCTTCGGGCCA	CASSIKTSGNKGEQFF	2
ACCTTGGAGCTGGGGGACTCGGCCCTTTATCTTTGCGCCAGCAGCTTGGCCTTAGCGGGGAACTGGGAGACCCAGTACTTCGGGCCA	CASSLALAGNWETQYF	1
GTGACCAGTGCCCATCCTGAAGACAGCAGCTTCTACATCTGCAGTGCTAGGACTAGCGGGAGGCGTGAGACCCAGTACTTCGGGCCA	CSARTSGRRETQYF	1
GAGTCTGCCATCCCCAACCAGACAGCTCTTTACTTCTGTGCCACCAGTGATAGTAGGGCTAGCGGCTACGAGCAGTACTTCGGGCCG	CATSDSRASGYEQYF	1
CAGCGCACAGAGCAGGGGGACTCGGCCATGTATCTCTGTGCCAGCAGCCCCCAGGGTGAGATCGGGACTGAAGCTTTCTTTGGACAA	CASSPQGEIGTEAFF	1
GAGCTGGGGGACTCAGCTTTGTATTTCTGTGCCAGCAGCGTAGCTAAGTCCAGGAGGGGAGGCACAGATACGCAGTATTTTGGCCCA	CASSVAKSRRGGTDTQYF	3
CTGAATGTGAACGCCTTGTTGCTGGGGGACTCGGCCCTCTATCTCTGTGCCAGCAGCAGAGACGAAACTGAAGCTTTCTTTGGACAA	CASSRDETEAFF	1
CAGCCCTCAGAACCCAGGGACTCAGCTGTGTACTTCTGTGCCAGCAGTTTGAATGGCGCCGGGGATGAAAAACTGTTTTTTGGCAGT	CASSLNGAGDEKLFF	1
TTGGCGTCTGCTGTACCCTCTCAGACATCTGTGTACTTCTGTGCCAGCAGGCTCAGGGTGTAGAGGAGGAAACTGTTTTTTGGCAGT	CASRLRV*RRKLFF	1
CTTGAGGACTCGGCCGTGTATCTCTGTGCCAGCAGCACCTCCGCCGGGGGGACGGGTGATAGGAACACTGAAGCTTTCTTTGGACAA	CASSTSAGGTGDRNTEAFF	1
AAGATCCAGCCCTCAGAACCCAGGGACTCAGCTGTGTACTTCTGTGCCAGCAGTTTAGGCAGCTACTATGGCTACACCTTCGGTTCG	CASSLGSYYGYTF	1
CTGACAGTGACCAGTGCCCATCCTGAAGACAGCAGCTTCTACATCTGCAGCGCGGGACAGTCCACAGATACGCAGTATTTTGGCCCA	CSAGQSTDTQYF	1
CGGCTGCTCCCTCCCAAACATCTGTGTACTTCTGTGCCAGCAGTTACCCCGGACTAGCGGGAGGAAGAGACCCAGTACTTCGGGCCA		1
ATCCAGCCCTCAGAACCCAGGGACTCAGCTGTGTACTTCTGTGCCAGCAGTCCTGGACAGGGGGCACTGACCCAGTACTTCGGGCCA	CASSPGQGALTQYF	1
AGGCTGCTGTCGGCTGCTCCCTCCCAGACATCTGTGTACTTCTGTGCCAGTTATCGGGGGGAGCATTCACCCCTCCACTTTGGGAAC	CASYRGEHSPLHF	2
ATCAATTCCCTGGAGCTTGGTGACTCTGCTGTGTATTTCTGTGCCAGCAGCCCCCTAAGTCAGAAAGAGACCCAGTACTTCGGGCCA	CASSPLSQKETQYF	1
TCCGCTACCAGCTCCCAGACATCTGTGTACTTCTGTGCCACCAGGGGTGGGGGTAGCGGAAGCACAGATACGCAGTATTTTGGCCCA	CATRGGGSGSTDTQYF	1
GAGTCGCCCAGCCCCAACCAGACCTCTCTGTACTTCTGTGCCAGCAGTCCCGAACTCTACGAAACAGATACGCAGTATTTTGGCCCA	CASSPELYETDTQYF	1
TTGTTGCTGGGGGACTCGGCCCTCTATCTCTGTGCCAGCAGCTGGGGCAGGGGTTCCTCCTCTGGAAACACCATATATTTTGGAGAG	CASSWGRGSSSGNTIYF	1
CCCTCAGAACCCAGGGACTCAGCTGTGTACTTCTGTGCCAGCAGCTCCCATAGCGGGGGATCCTACAATGAGCAGTTCTTCGGGCCA	CASSSHSGGSYNEQFF	1
CTGACAGTGACCAGTGCCCATCCTGAAGACAGCAGCTTCTACATCTGCAGGGGAGCGGGAGGAGGTAATGAGCAGTTCTTCGGGCCA	CRGAGGGNEQFF	1
CGGTCCACAAAGCTGGAGGACTCAGCCATGTACTTCTGTGCCAGCAGTGAGGGGGTGGGAGGGAATCAGCCCCAGCATTTTGGTGAT	CASSEGVGGNQPQHF	1
GTGACCAGTGCCCATCCTGAAGACAGCAGCTTCTACATCTGCAGTGCTAGATTGGGCGGGAGGAAAAACGAGCAGTACTTCGGGCCG	CSARLGGRKNEQYF	1
GAGTCGCCCAGCCCCAACCAGACCTCTCTGTACTTCTGTGCCAGCAGCTCACTAGCGGGGGGGCGCTACGAGCAGTACTTCGGGCCA	CASSSLAGGRYEQYF	1
CTGGAGTCCGCCAGCACCAACCAGACATCTATGTACCTCTGTGCCAGCAGTTTTACACAGGGGCTCCATGGCTACACCTTCGGTTCG	CASSFTQGLHGYTF	1
GACATCGGCCCAAAAGAACCCGACAGCTTTCTATCTCTGTGCCAGTAGTATCTGGGACAGGGGATAAATGAGCAGTTCTTCGGGCCA		1
GCAAAGCTTGAGGACTCGGCCGTGTATCTCTGTGCCAGCAGCTTAATGCCTAGCGGGAACGGTGGAGATACGCAGTATTTTGGCCCA	CASSLMPSGNGGDTQYF	1
TCCACAAAGCTGGAGGACTCAGCCATGTACTTCTGTGCCAGCAGTGAAGGTTGGCGCCGGAAGGACAATGAGCAGTTCTTCGGGCCA	CASSEGWRRKDNEQFF	1
AAGATCCGGTCCACAAAGCTGGAGGACTCAGCCATGTACTTCTGTGCCAGCGACCAGGTACCCTCCTACGAGCAGTACTTCGGGCCG	CASDQVPSYEQYF	1
TCGGCTGCTCCCTCCCAGACATCTGTGTACTTCTGTGCCAGTGTTTGGAGCGGGAACCTGAACACCGGGGAGCTGTTTTTTGGAGAA	CASVWSGNLNTGELFF	1
GTGAACGCCTTGTTGCTGGGGGACTCGGCCCTCTATCTCTGTGCCAGCAGCTTGCAAGTAGCCCAAGAAAAACTGTTTTTTGGCAGT	CASSLQVAQEKLFF	2
ACATCGGCCCAAAAGAACCCGACAGCTTTCTATCTCTGTGCCAGTAGTATCAGGCGGAGGGGAGGAGAGACCCAGTACTTCGGGCCA	CASSIRRRGGETQYF	2
CAGGTAGTGCGAGGAGATTCGGCAGCTTATTTCTGTGCCAGCTCACCCAACGACAGGGGAAAGCGGGCTGAAGCTTTCTTTGGACAA	CASSPNDRGKRAEAFF	1
GAGACACGGCACTGTATCTCTGCGCCAGCAGTCAATTTATGCGGGACAGTAGCCTCCCTCTATAATTCACCCCTCCACTTTGGGAAC		1
CTGATTCTGGAGTCCGCCAGCACCAACCAGACATCTATGTACCTCTGTGCCAGCCGTGACCCTACCTACGAGCAGTACTTCGGGCCG	CASRDPTYEQYF	1
GCCCAAAAGAACCCGACAGCTTTCTATCTCTGTGCCAGTAGTATAGATCAGACTACAGGACAGGGCTACGAGCAGTACTTCGGGCCG	CASSIDQTTGQGYEQYF	1
GCCTTGTTGCTGGGGGACTCGGCCCTCTATCTCTGTGCCAGCAGCTTAGCGCCGGACGTAAGTCCCTACGAGCAGTACTTCGGGCCG	CASSLAPDVSPYEQYF	1
ACCAGTGCCCATCCTGAAGACAGCAGCTTCTACATCTGCAGTGCTAGTTCCGGACAGGGAAACACCGGGGAGCTGTTTTTTGGAGAA	CSASSGQGNTGELFF	1
AATGTGAACGCCTTGGAGCTGGACGACTCGGCCCTGTATCTCTGTGCCAGCAGCTTGGTCCCGGCGGCGCCCCAGCATTTTGGTGAT	CASSLVPAAPQHF	1
GCCAGCACCAACCAGACATCTATGTACCTCTGTGCCAGCAGTCCCTATGGGACAGCAGGGCTGCAAGAGACCCAGTACTTCGGGCCA	CASSPYGTAGLQETQYF	2
GAGTCCGCCAGCACCAACCAGACATCTATGTACCTCTGTGCCAGCAGATCACCTACGGGACACTTCACTGAAGCTTTCTTTGGACAA	CASRSPTGHFTEAFF	1
ATGAGCTCCTTGGAGCTGGGGGACTCAGCCCTGTACTTCTGTGCCAGCAGCCACGACAGGGCGGGGAACGAGCAGTACTTCGGGCCG	CASSHDRAGNEQYF	1
AGTGCCCATCCTGAAGACAGCAGCTTCTACATCTGCAGTGCTAGAGACCTTCTAGCGGGAGGCGGGGATGAGCAGTTCTTCGGGCCA	CSARDLLAGGGDEQFF	1
ATCCGCTCACCAGGCCTGGGGGACGCAGCCATGTACCTGTGTGCCACCAGCAGAGGGGACGGCTCCTACGAGCAGTACTTCGGGCCG	CATSRGDGSYEQYF	1
CACATCAATTCCCTGGAGCTTGGTGACTCTGCTGTGTATTTCTGTGCCAGCAGCCAACAGAGGGCCACTGAAGCTTTCTTTGGACAA	CASSQQRATEAFF	1
GTGAGCAACATGAGCCCTGAAGACAGCAGCATATATCTCTGCAGCGTCGGAAAGAGGGGGGTCTACAATGAGCAGTTCTTCGGGCCA	CSVGKRGVYNEQFF	1
CTGATTCTGGAGTCCGCCAGCACCAACCAGACATCTATGTACCTCTGTGCCAGCAGTGTGGGGAACACTGAAGCTTTCTTTGGACAA	CASSVGNTEAFF	1
AGTGCCCATCCTGAAGACAGCAGCTTCTACATCTGCAGTGCTAGAGATTTGGCCCAGGGAGGCACAGATACGCAGTATTTTGGCCCA	CSARDLAQGGTDTQYF	1
CAGCAGGTAGTGCGAGGAGATTCGGCAGCTTATTTCTGTGCCAGCTCACTCTCAGGGGGAATGAACACTGAAGCTTTCTTTGGACAA	CASSLSGGMNTEAFF	1
AAGATCCAGCCCTCAGAACCCAGGGACTCAGCTGTGTACTTCTGTGCCAGCAGTTTTAGGGGGACCGCTGGCTACACCTTCGGTTCG	CASSFRGTAGYTF	44
ATCCAGCGCACACAGCAGGAGGACTCGGCCGTGTATCTCTGTGCCAGCAGAGGGGACACCTTCTCCTACGAGCAGTACTTCGGGCCG	CASRGDTFSYEQYF	1
ACTCTGAAGATCCGGTCCACAAAGCTGGAGGACTCAGCCATGTACTTCTGTGCCAGCAGTGAAGGGGCTGAGCAGTTCTTCGGGCCA	CASSEGAEQFF	1
AATGTGAGCACCTTGGAGCTGGGGGACTCGGCCCTTTATCTTTGCGCCAGCAGTCCAGACAGGAACACTGAAGCTTTCTTTGGACAA	CASSPDRNTEAFF	1
GTGACATCGGCCCAAAAGAACCCGACAGCTTTCTATCTCTGTGCCAGTAGGGGACTAGCGGGGACAAATGAGCAGTTCTTCGGGCCA	CASRGLAGTNEQFF	1
GCCTTGGAGCTGGAGGACTCGGCCCTGTATCTCTGTGCCAGCAGCTTGTTTACAGGTAATAGCAATCAGCCCCAGCATTTTGGTGAT	CASSLFTGNSNQPQHF	1
ATCAATTCCCTGGAGCTTGGTGGCTCTGCTGTGTATTTCTGTGCCAGCAGCCAAGGTATAGAGAACACTGAAGCTTTCTTTGGACAA	CASSQGIENTEAFF	1
CTGGAGTTGGCTGCTCCCTCCCAGACATCTGTGTACTTCTGTGCCAGCACCCTCATGAGCTCTGGAAACACCATATATTTTGGAGAG	CASTLMSSGNTIYF	1
ACTCTGGAGTCAGCTACCCGCTCCCAGACATCTGTGTATTTCTGCGCCAGCAGTGGCACAACGGGGGGGACCCAGTACTTCGGGCCA	CASSGTTGGTQYF	1
CTGGAGTCGGCTGCTCCCTCCCAGACATCTGTGTACTTCTGTGCCAGCAGTGAACTGGACTCCAATGAAAAACTGTTTTTTGGCAGT	CASSELDSNEKLFF	1
CTGTCGGCTGCTCCCTCCCAGACATCTGTGTACTTCTGTGCCAGCAGTTACTCGAAGAGCATGAACACTGAAGCTTTCTTTGGACAA	CASSYSKSMNTEAFF	1
CTGGAGTCGCCCAGCCCCAACCAGACCTCTCTGTACTTCTGTGCCAGCAGTTTACTTACTGACAATTACGAGCAGTACTTCGGGCCA	CASSLLTDNYEQYF	1
TCCCTGGAGCTTGGTGACTCTGCTGTGTATTTCTGTGCCAGCAGCCACCGAGCGGGGGGGCGGACAGATACGCAGTATTTTGGCCCA	CASSHRAGGRTDTQYF	1
TGGCGTCTGCTGTACCCTCTCAGACATCTGTGTACTTCTGTGCCAGCAGTGAGTCCGTCCTCCTACAATGAGCAGTTCTTCGGGCCA		1
AGGCTGCTGTCGGCTGCTCCCTCCCAGACATCTGTGTACTTCTGTGCCAGCAATCTGTGGGCTGAATCTGAAGCTTTCTTTGGACAA	CASNLWAESEAFF	3
TCGGCTGCTCCCTCCCAAACATCTGTGTACTTCTGTGCCAGCAGTTACCTCCGGTGGGGGAACACCGGGGAGCTGTTTTTTGGAGAA	CASSYLRWGNTGELFF	1
AGCTCTCTGGAGCTGGGGGACTCAGCTTTGTATTTCTGTGCCAGCAGCGTAGAAGGGGTCGGCACAGATACGCAGTATTTTGGCCCA	CASSVEGVGTDTQYF	1
GAGTCCGCCAGCACCAACCAGACATCTATGTACCTCTGTGCCAGCAGTGGAATGGGGGCCGCTGGAAACACCATATATTTTGGAGAG	CASSGMGAAGNTIYF	2
CTCACTGTGACATCGGCCCAAAAGAACCCGACAGCTTTCTATCTCTGTGCCAGTAGTATTCGCACAGATACGCAGTATTTTGGCCCA	CASSIRTDTQYF	1
GAGTTGGCTGCTCCCTCCCAGACATCTGTGTACTTCTGTGCCAGCCTCCTGGGCCGGGAATCCTACAATGAGCAGTTCTTCGGGCCA	CASLLGRESYNEQFF	1
AGGAGGACTCGGCCGTGTATCTCTGTGCCAGCAGCTTAGCCGAGCTGGGGACTAGCGGGGGGTAAAAACATTCAGTACTTCGGCGCC		1
CCCCTGACCCTGGAGTCTGCCAGGCCCTCACATACCTCTCAGTACCTCTGTGCCAGCAGATATGGAAACACCATATATTTTGGAGAG	CASRYGNTIYF	1
CAGCAGGTAGTGCGAGGAGATTCGGCAGCTTATTTCTGTGCCAGCTCACCAGGTAGCCTCACCTCCTACGAGCAGTACTTCGGGCCG	CASSPGSLTSYEQYF	1
ATCCAGCGCACACAGCAGGAGGACTCGGCCGTGTATCTCTGTGCCAGCAGCTTAGGTGGTGGGTCCGATACGCAGTATTTTGGCCCA	CASSLGGGSDTQYF	1
CCCCTGATCCTGGAGTCGCCCAGCCCCAACCAGACCTCTCTGTACTTCTGTGCCAGCAGTTCCACCCCCCCCCAGCATTTTGGTGAT	CASSSTPPQHF	1
AAGATCCAGCGCACACAGCAGGAGGACTCCGCCGTGTATCTCTCGTAACCTCCGGGCCTCAATACTGGGCCCCAGCATTTTGGTGAT	S*PPGLNTGPQHF	1
ATCCAGCGCACAGAGCAGGGGGACTCGGCCATGTATCTCTGTGCCAGCAGCTTCAGGGACGGTAATGAAAAACTGTTTTTTGGCAGT	CASSFRDGNEKLFF	1
ATCCAGCGCACACAGCAGGAGGACTCCGCCGTGTATCTCTGTGCCAGCAGCACTAGCGGGGGGGTCTACGAGCAGTACTTCGGGCCG	CASSTSGGVYEQYF	1
CAACCTGCAAAGCTTGAGGACTCGGCCGTGTATCTCTGTGCCAGCAGCTTCCAGGGGGCGCAGAGGGAGACCCAGTACTTCGGGCCA	CASSFQGAQRETQYF	1
AGCTCTCTGGAGCTGGGGGACTCAGCTTTGTATTTCTGTGCCAGCAGCGTAGCTCTAGGTCAGAGCACTGGCTACACCTTCGGTTCG	CASSVALGQSTGYTF	1
AGCCTGCAGAACTGGAGGATTCTGGAGTTTATTTCTGTGCCAGCAGCCAATTCCCCGACTAGCCTACATGAGCAGTTCTTCGGGCCA		1
ATGTGAGTGCCTTGGAGCTGGGGGACTCGGCCCTGTATCTCTGTGCCAGAAGATCAGTCGGTGGGCGGGGGCTACACCTTCGGTTCG		1
AAGATCCGGTCCACAAAGCTGGAGGACTCAGCCATGTACTTCTGTGCCAGCCGGCCGGGGGGTTACAATGAGCAGTTCTTCGGGCCA	CASRPGGYNEQFF	1
ATCCAACCTGCAAAGCTTGAGGACTCGGCCGTGTATCTCTGTGCCAGCAGCCAGGGGAGCTCTGGAAACACCATATATTTTGGAGAG	CASSQGSSGNTIYF	1
TCTCTGGAGCTGGGGGACTCAGCTTTGTATTTCTGTGCCAGCAGCGTAGATCAGGGGGATGGGGCCAACGTCCTGACTTTCGGGGCC	CASSVDQGDGANVLTF	3
GAGTCCGCCAGCACCAACCAGACATCTATGTACCTCTGTGCCAGCAGTCAAGTACTAGCGGGCCAGTACGAGCAGTACTTCGGGCCG	CASSQVLAGQYEQYF	1
GTGAGCACCTTGGAGCTGGGGGACTCGGCCCTTTATCTTTGCGCCAGCAGCTTGACAGGGACCACCTACGAGCAGTACTTCGGGCCG	CASSLTGTTYEQYF	1
