nucleotide	aminoAcid	estimatedNumberGenomes
TCCCTCCCAAACATCTGTGTACTTCTGTGCCAGGGTCTCTTGACAGGGTATTGAGTTGTGGGGACCGGGGAGCTGTTTTTTGGAGAA		1
ACGATCCAGCGCACACAGCAGGAGGACTCGGCCGTGTATCTCTGTGCCAGCAGCTTAAGCACGGGGGGAAAACTGTTTTTTGGCAGT	CASSLSTGGKLFF	1
AGGCTGGAGTCGGCTGCTCCCTCCCAGACATCTGTGTACTTCTGTGCCAGCAGGATACAGGGGTCCGAGACCCAGTACTTCGGGCCA	CASRIQGSETQYF	1
CAGCCAGAAGACTCGGCCCTGTATCTCTGCGCCAGCAGCCAAGGACTGAAGGCCGGGACAGTAGACTTCGAAGCTTTCTTTGGACAA	CASSQGLKAGTVDFEAFF	1
GAGTCCGCCAGCACCAACCAGACATCTATGTACCTCTGTGCCAGCAGTTTATCGGGGGGACGCAATCAGCCCCAGCATTTTGGTGAT	CASSLSGGRNQPQHF	1
CTGAGGATCCAGCAGGTAGTGCGAGGAGATTCGGCAGCTTATTTCTGTGCCAGCTCACCCGGGGGCGATGAGCAGTTCTTCGGGCCA	CASSPGGDEQFF	1
AGCAACATGAGCCCTGAAGACAGCAGCATATATCTCTGCAGCGCCGAGGGGCTAGCGGGAGTGGCAGATACGCAGTATTTTGGCCCA	CSAEGLAGVADTQYF	1
CAGGTAGTGCGAGGAGATTCGGCAGCTTATTTCTGTGCCAGCTCACCATCAGCCAGAGCGAACACCGGGGAGCTGTTTTTTGGAGAA	CASSPSARANTGELFF	1
ATCCAGCGCACAGAGCAGCGGGACTCGGCCATGTATCGCTGTGCCAGCAGCCCCGCCAATAGGGCGGAGACCCAGTACTTCGGGCCA	CASSPANRAETQYF	1
GTGAACGCCTTGTTGCTGGGGGACTCGGCCCTGTATCTCTGTGCCAGCAGCCCTGGACAGGGTAACTATGGCTACACCTTCGGTTCG	CASSPGQGNYGYTF	1
CTAGAGTCTGCCATCCCCAACCAGACAGCTCTTTACTTCTGTGCCACCAGTGAGGGACAGGCGGGTGAAAAACTGTTTTTTGGCAGT	CATSEGQAGEKLFF	4
TCCCTGGAGCTTGGTGACTCTGCTGTGTATTTCTGTGCCAGCAGCCAGGGGAGGGGGTTCGCTAATGAAAAACTGTTTTTTGGCAGT	CASSQGRGFANEKLFF	1
AACGCCTTGTTGCTGGGGGACTCGGCCCTGTATCTCTGTGCCAGCAGCGAGGGACTAGCGGGAACCTACGAGCAGTACTTCGGGCCA	CASSEGLAGTYEQYF	1
CAGCCAGAAGACTCGGCCCTGTATCTCTGCGCCAGCAGCCAATACGCCCCGGGACAGGGAGCCAAAAACATTCAGTACTTCGGCGCC	CASSQYAPGQGAKNIQYF	1
ATGAATGTGAGTGCCTTGGAGCTGGGGGACTCGGCCCTGTATCTCTGTGCCAGTACGAAGATGGACACTGAAGCTTTCTTTGGACAA	CASTKMDTEAFF	2
ACTCTGACGATCCAGCGCACAGAGCAGCGGGACTCGGCCATGTATCGCTGTGCCAGCAGCAGCTACAATGAGCAGTTCTTCGGGCCA	CASSSYNEQFF	1
GCCCATCCTGAAGACAGCAGCTTCTACATCTGCAGTGCTAGAGATCCGGGCGGCCTTAGACTCTACAATGAGCAGTTCTTCGGGCCA	CSARDPGGLRLYNEQFF	1
GTGAACGCCTTGTTGCTGGGGGACTCGGCCCTGTATCTCTGTGCCAGCAGCTTGGTGACAGGCAATCAGCCCCAGCATTTTGGTGAT	CASSLVTGNQPQHF	1
AGTCAGGGGACACAGCACTGTATTTCTGTGCCAGCAGCAAATGAAGAGGACAGCTCAAGCTCTGGAAACACCATATATTTTGGAGAG		1
CAGCAGGTAGTGCGAGGAGATTCGGCAGCTTATTTCTGTGCCAGCTCACCATCCGGAGTCCGAGATGAAAAACTGTTTTTTGGCAGT	CASSPSGVRDEKLFF	1
ACGATTCAGCGCACAGAGCAGCGGGACTCAGCCATGTATCGCTGTGCCAGCAGCTTCAGAGGGGGGAACGAGCAGTACTTCGGGCCG	CASSFRGGNEQYF	1
GTGACATCGGCCCAAAAGAACCCGACAGCTTTCTATCTCTGTGCCAGTAGTATAAGAGGGGTCGGTCAGCCCCAGCATTTTGGTGAT	CASSIRGVGQPQHF	2
AAGATCCAGCCCTCAGAACCCAGGGACTCAGCTGTGTACTTCTGTGCCAGCAAAGAGGGTCCGACCTACGAGCAGTACTTCGGGCCG	CASKEGPTYEQYF	1
CCTACACGCCCTGCAGCCAGAAGACTCAGCCCTGTATCTCTGCGCCAGCCCGTTTGATAGTGTCCCGGGGAGCTGTTTTTTGGAGAA		1
CCAGAAGACTCAGCCCTGTATCTCTGCGCCAGCAGCCAATTCTGGGTAGCGCATTTACTTAGCACAGATACGCAGTATTTTGGCCCA	CASSQFWVAHLLSTDTQYF	4
ATCCAGCCCTCAGAACCCAGGGACTCAGCTGTGTACTTCTGTGCCAGCAGTTTAGGGGGACAACTCTATGGCTACACCTTCGGTTCG	CASSLGGQLYGYTF	3
CTGATCCTGGAGTCGCCCAGCCCCAACCAGACCTCTCTGTACTTCTGTGCCAGCAGTTTCGGACCCTACGAGCAGTACTTCGGGCCG	CASSFGPYEQYF	1
AGCACCTTGGAGCTGGGGGACTCGGCCCTTTATCTTTGCGCCAGCAGCTCACCAAATACAGGCACAGATACGCAGTATTTTGGCCCA	CASSSPNTGTDTQYF	1
ATCCAGCCCTCAGAACCCAGGGACTCAGCTGTGTACTTCTGTGCCAGCAGTTTTCAGGACACTACCTACGAGCAGTACTTCGGGCCA	CASSFQDTTYEQYF	1
GCGTCTGCTGTACCCTCTCAGACATCTGTGTACTTCTGTGCCAGCAGCTTGGAGGGGGCCATCGGCAATGAGCAGTTCTTCGGGCCA	CASSLEGAIGNEQFF	1
CAGCGCACAGAGCAGGGGGACTCGGCCATGTATCTCTGTGCCAGCAGCTTCGGGAGGGCCGGCACAGATACGCAGTATTTTGGCCCA	CASSFGRAGTDTQYF	1
CGGTCCACAAAGCTGGAGGACTCAGCCATGTACTTCTGTGCCAGCAGCTTCCTAGCGGCAAGCTCCTACGAGCAGTACTTCGGGCCA	CASSFLAASSYEQYF	1
CTGGAGTCCGCCAGCACCAACCAGACATCTATGTACCTCTGTGCCAGCAGGCCGCAGAAGGGGAACTATGGCTACACCTTCGGTTCG	CASRPQKGNYGYTF	1
CTGGAGTCGGCTGCTCCCTCCCAGACATCTGTGTACTTCTGTGCCAGCAGGTTGGACGGCTCTATGGGGGGCTACACCTTCGGTTCG	CASRLDGSMGGYTF	1
AGATCCGGTCCACAAAGCTGGAGGACTCAGCCATGTACTTCTGTGCCAGCAGGGAGCGGGGAACCCTACGAGCAGTACTTCGGGCCG		1
AGTTCTAAGAAGCTCCTTCTCAGTGACTCTGGCTTCTATCTCTGTGCCTGGAGCCCGGGACAGGGTTACGAGCAGTACTTCGGGCCG	CAWSPGQGYEQYF	1
AGGATCCAGCAGGTAGTGCGAGGAGATTCGGCAGCTTATTTCTGTGCCAGCTCGTCTGACAGGGTAGGCGAGCAGTACTTCGGGCCG	CASSSDRVGEQYF	1
CAGCGCACAGAGCAGGGGGACTCGGCCATGTATCTCTGTGCCAGCAGCTTGGGAGACAGGGCCTACAATGAGCAGTTCTTCGGGCCA	CASSLGDRAYNEQFF	1
GCGCACAGAGCAGGGGGACTCAGCCGTGTATCTCCGTGCCAGCAGCCCGCCGGGGGGCCGGGTGGGAATGAGCAGTTCTTCGGGCCA		1
AATGCCTTGGAGCTGGAGGACTCGGCCCTGTATCTCTGTGCCAGCAGCGCATACAGGGGGACTAATGAAAAACTGTTTTTTGGCAGT	CASSAYRGTNEKLFF	1
CTGATTCTGGAGTCCGCCAGCACCAACCAGACATCTATGTACCTCTGTGCCAGCAGTTGGGCACACACTGAAGCTTTCTTTGGACAA	CASSWAHTEAFF	1
CAGCGCACAGAGCAGGGGGACTCGGCCATGTATCTCTGTGCCAGCAGCTTAGTGGGGACAGAGGCTGAAAAACTGTTTTTTGGCAGT	CASSLVGTEAEKLFF	1
ATCAATTCCCTGGAGCTTGGTGACTCTGCTGTGTATTTCTGTGCCAGCAGCCACCTGGGACCTAATGAAAAACTGTTTTTTGGCAGT	CASSHLGPNEKLFF	2
CTGGAGTCAGCTACCCGCTCCCAGACATCTGTGTATTTCTGCGCCAGCAGTGAGAACGGCATGAACACTGAAGCTTTCTTTGGACAA	CASSENGMNTEAFF	1
ACAGTGACCAGTGCCCATCCTGAAGACAGCAGCTTCTACATCTGCAGTGCTAAGGCGGGGCCTGGAAACACCATATATTTTGGAGAG	CSAKAGPGNTIYF	1
TCGGCTGCTCCCTCCCAAACATCTGTGTACTTCTGTGCCAGCAGTTATACACTAGCGGGAGCAGACGGGGAGCTGTTTTTTGGAGAA	CASSYTLAGADGELFF	2
CTGGAGTCGCCCAGCCCCAACCAGACCTCTCTGTACTTCTGTGCCAGCAGTTTTGGGGCAGGTACCTACGAGCAGTACTTCGGGCCA	CASSFGAGTYEQYF	1
ACATCGGCCCAAAAGAACCCGACAGCTTTCTATCTCTGTGCCAGTAGTATAGTCTGGGGGGTCTACAATGAGCAGTTCTTCGGGCCA	CASSIVWGVYNEQFF	1
ACCAGTGCCCATCCTGAAGACAGCAGCTTCTACATCTGCAGTGCTACTAAGGACGGGAAACCTAACTATGGCTACACCTTCGGTTCG	CSATKDGKPNYGYTF	1
TTGGAGCTGGGGGACTCGGCCCTTTATCTTTGCGCCAGCAGCTCCGAAAAGCTAGCGGGAGGGATGAATGAGCAGTTCTTCGGGCCA	CASSSEKLAGGMNEQFF	1
CTCCCTCCCAGACATCTGTGTACTTCTGTGCCAGCAGAAGACTAGCGGGGGGAAGAACAAAACACCGGGGAGCTGTTTTTTGGAGAA		1
CTGACGATCCAGCGCACACAGCAGGAGGACTCGGCCGTGTATCTCTGTGCCAGCAGCACCCCGAGGAACGAGCAGTACTTCGGGCCG	CASSTPRNEQYF	1
CCCTCAGAACCCAGGGACTCAGCTGTGTACTTCTGTGCCAGCAGTTTAGGGGACCCGAAGGGTTCCTACGAGCAGTACTTCGGGCCG	CASSLGDPKGSYEQYF	1
ACCAGTGCCCATCCTGAAGACAGCAGCTTCTACATCTGCAGTGCTAGAGAGGACGGCTCGAACACCGGGGAGCTGTTTTTTGGAGAA	CSAREDGSNTGELFF	1
CCTGCAGAACTGGAGGATTCTGGAGTTTATTTCTGTGCCAGCAGCCAAGGGGACAGGATATTGGGAGAGACCCAGTACTTCGGGCCA	CASSQGDRILGETQYF	1
AATGTGAGCACCTTGGAGCTGGGGGACTCGGCCCTTTATCTTTGCGCCAGCAGTCCGGACAGGGTCCACGAGCAGTACTTCGGGCCG	CASSPDRVHEQYF	1
GATTTCCCCCTCACGTTGGCGTCTGCTGTACCCTCTCAGACATCTGTGTACTTCTGTGCCAGCAGTGACAGAAACACCTTCGGTTCG	CASSDRNTF	1
CTGACGATCCAGCGCACAGAGCAGCGGGACTCGGCCATGTATCGCTGTGCCAGCAGCCTGCTGGGACAGCGGGCTTTCTTTGGACAA	CASSLLGQRAFF	1
CAGCAGGAGGACTCCGCCGTGTATCTCTGTGCCAGCAGCTTAGTGTTACCGGGGGCAATCATGAACACTGAAGCTTTCTTTGGACAA	CASSLVLPGAIMNTEAFF	1
GTGAACGCCTTGGAGCTGGACGACTCGGCCCTGTATCTCTGTGCCAGCAGCCTACAGGGGGCGGCTGAAAAACTGTTTTTTGGCAGT	CASSLQGAAEKLFF	1
ATTCTGGAGTCCGCCAGCACCAACCAGACATCTATGTACCTCTGTGCCACCCGCACAGGTAATGGAAACACCATATATTTTGGAGAG	CATRTGNGNTIYF	1
GGGTTGGAGTCGGCTGCTCCCTCCCAAACATCTGTGTACTTCTGTGCCAGCCGACTAGCGGGAGGTGTTGAGCAGTTCTTCGGGCCA	CASRLAGGVEQFF	1
AAGATCCGGTCCACAAAGCTGGAGGACTCAGCCATGTACCTCTGTGCCAGCCAACTGGGACCGGCCGGGGGCTACACCTTCGGTTCG	CASQLGPAGGYTF	1
ATCCTGAGGATCCAGCAGGTAGTGCGAGGAGATTCGGCAGCTTATTTCTGTGCCAGCTCCCCCAGTTACGAGCAGTACTTCGGGCCG	CASSPSYEQYF	1
AGTGACCAGTGCCCATCCTGAAGACAGCAGCTTCTACATCTGCAGTGCTAGAATGGACGGGAGTCAGATACGCAGTATTTTGGCCCA		3
ACCAGTGCCCATCCTGAAGACAGCAGCTTCTACATCTGCAGTGCTAGAGAGGGACAGGGGGACTACAATGAGCAGTTCTTCGGGCCA	CSAREGQGDYNEQFF	1
ACAGTGACCAGTGCCCATCCTGAAGACAGCAGCTTCTACATCTGCAGTGCTGAGGGACTAGCCAAAAACATTCAGTACTTCGGCGCC	CSAEGLAKNIQYF	1
ATCCAGCGCACAGAGCAGGGGGACTCGGCCATGTATCTCTGTGCCAGCAGCTTGGGGGGGCTTGGCTATGGCTACACCTTCGGTTCG	CASSLGGLGYGYTF	1
ACATCGGCCCAAAAGAACCCGACAGCTTTCTATCTCTGTGCCAGCTCCGCCACTAGCGGGCGCACAGATACGCAGTATTTTGGCCCA	CASSATSGRTDTQYF	3
GTGACATCGGCCCAAAAGAACCCGACAGCTTTCTATCTCTGTGCCAGTAGTATAGAGGGACGCAAGTCTGAAGCTTTCTTTGGACAA	CASSIEGRKSEAFF	1
GAGTCGGCTGCTCCCTCCCAGACATCTGTGTACTTCTGTGCCAGCAGTTACAGGGGATTGAATAATGAAAAACTGTTTTTTGGCAGT	CASSYRGLNNEKLFF	2
ACAGAGCAGGGGGACTCGGCCATGTATCTCTGTGCCAGCAGCTTAGCCCCTCCGGGCATAGCAAACTATGGCTACACCTTCGGTTCG	CASSLAPPGIANYGYTF	1
ACCTTGGAGCTGGGGGACTCGGCCCTTTATCTTTGCGCCAGCAGCGAAGTTTCAGCTGCCTTGGGAACTGAAGCTTTCTTTGGACAA	CASSEVSAALGTEAFF	1
TTGGAGATCCAGCGCACAGAGCAGGGGGACTCGGCCATGTATCTCTGTGCCAGCAGCTTAGGCGGGGGATCTCAGTACTTCGGCGCC	CASSLGGGSQYF	1
GAGCTCTCTGGAGCTGGGGGACTCAGCTTTGTATTTCTGTGCCAGCAGCGGATCGGACAGGGGGATCAGCCCCAGCATTTTGGTGAT		1
GTGCAGCCTGCAGAACTGGAGGATTCTGGAGTTTATTTCTGTGCCAGCAGCCAAGATACGTGGAACACTGAAGCTTTCTTTGGACAA	CASSQDTWNTEAFF	1
GAGTCGCCCAGCCCCAACCAGACCTCTCTGTACTTCTGTGCCAGCAGTTTATCCGGGACAGGGGATGAAAAACTGTTTTTTGGCAGT	CASSLSGTGDEKLFF	1
GTGACCAGTGCCCATCCTGAAGACAGCAGCTTCTACATCTGCAGTGCTAGAGACCGACAGGGCCTCTACGAGCAGTACTTCGGGCCG	CSARDRQGLYEQYF	1
ATCCAGCAGGTAGTGCGAGGAGATTCGGCAGCTTATTTCTGTGCCAGCTCACAATCCGGGGGGAACAATGAGCAGTTCTTCGGGCCA	CASSQSGGNNEQFF	1
CACACCCTGCAGCCAGAAGACTCGGCCCTGTATCTCTGTGCCAGCAGCCAAGGAACAGGGAATAACTATGGCTACACCTTCGGTTCG	CASSQGTGNNYGYTF	1
CTGGAGTCGCCCAGCCCCAACCAGACCTCTCTGTACTTCTGTGCCACCCGAAGAACGGACAGTGGCTATGGCTACACCTTCGGTTCG	CATRRTDSGYGYTF	1
CAGGTAGTGCGAGGAGATTCGGCAGCTTATTTCTGTGCCAGCTTACGACAGGGGACATTGAAAAACACTGAAGCTTTCTTTGGACAA	CASLRQGTLKNTEAFF	1
AAGATCCGGTCCACAAAGCTGGAGGACTCAGCCATGTACTTCTGTGCCAGCAGGCCACTGGGGTTGAAGCCCCAGCATTTTGGTGAT	CASRPLGLKPQHF	1
GGGTTGGAGTCGGCTGCTCCCTCCCAGACATCTGTGTACTTCTGTGCCAGCAGCGCGACAGGAGGGGAAAAACTGTTTTTTGGCAGT	CASSATGGEKLFF	1
CTCAGGCTGGAGTTGGCTGCTCCCTCCCAGACATCTGTGTACTTCTGTGCCAGCAACCGAAGGGGCGGGGAGCTGTTTTTTGGAGAA	CASNRRGGELFF	1
TTGGAGTCGGCTGCTCCCTCCCAAACATCTGTGTACTTCTGTGCCAGCAGTTATCTGACAGGGGGGAATGAGCAGTTCTTCGGGCCA	CASSYLTGGNEQFF	1
CAGCCCTCAGAACCCAGGGACTCAGCTGTGTACTTCTGTGCCAGCAGTTTAGCGCGGGGAGCGGGAGATACGCAGTATTTTGGCCCA	CASSLARGAGDTQYF	1
CTGGAGTCGGCTGCTCCCTCCCAGACATCTGTGTACTTCTGTGCCAGCATCCCACAGGGTTCTAATGAAAAACTGTTTTTTGGCAGT	CASIPQGSNEKLFF	1
CTGTCGGCTGCTCCCTCCCAGACATCTGTGTACTTCTGTGCCAGCAGAACTAGCGGGAGAGGTTTTAAAGAGCAGTACTTCGGGCCG	CASRTSGRGFKEQYF	1
GTGACCAGTGCCCATCCTGAAGACAGCAGCTTCTACATCTGCAGTGCTAGAGATATAACAGGGAACGGGGAGCTGTTTTTTGGAGAA	CSARDITGNGELFF	1
ATCCAGCGCACAGAGCAGGGGGACTCGGCCATGTATCTCTGTGCCAGCAGCCCCACCGGGCCTAGAAACACCATATATTTTGGAGAG	CASSPTGPRNTIYF	1
CCTAGAGTCTGCCATCCCCAACCAGACAGCTCTTTACTTCTGTGCCACCAGTGATGTGGGGACTTCATCGAGCAGTACTTCGGGCCA		1
CAGGTAGTGCGAGGAGATTCGGCAGCTTATTTCTGTGCCAGCTCACCCCCTCGTGGGGGGACCAACTACGAGCAGTACTTCGGGCCG	CASSPPRGGTNYEQYF	1
CTGCTGTCGGCTGCTCCCTCCCAGACATCTGTGTACTTCTGTGCCAGCACGAGGGTCTCTGGGGCCAACGTCCTGACTTTCGGGGCC	CASTRVSGANVLTF	1
TCCACAAAGCTGGAGGACTCAGCCATGTACTTCTGTGCCAGCAGTGATGCCGGGGCAGGCTATTCCTACGAGCAGTACTTCGGGCCA	CASSDAGAGYSYEQYF	1
CTGTCGGCTGCTCCCTCCCAGACATCTGTGTACTTCTGTGCCAGCAGCCGATCGGACGATCCCTCCTACGAGCAGTACTTCGGGCCG	CASSRSDDPSYEQYF	3
CTGCTGTCGGCTGCTCCCTCCCAGACATCTGTGTACTTCTGTGCCAGCAGCCCCCGGACAGTGGGGGGTGGCTACACCTTCGGTTCG	CASSPRTVGGGYTF	1
ATCCAGCGCACACAGCAGGAGGACTCGGCCGTGTATCTCTGTGCCAGCAGCTCAACAGGGCCCCCGGAGCCCCAGCATTTTGGTGAT	CASSSTGPPEPQHF	1
GAGTCCGCCAGCACCAACCAGACATCTATGTACCTCTGTGCCAGCAGGCGGGCACTAGCGGGAAAATACGAGCAGTACTTCGGGCCG	CASRRALAGKYEQYF	2
CTGATTCTGGAGTCCGCCAGCACCAACCAGACATCTATGTACCTCTGTGCCAGCGAAGACACCTTCTATGGCTACACCTTCGGTTCG	CASEDTFYGYTF	1
ACTGTGAGCAACATGAGCCCTGAAGACAGCAGCATATATCTCTGCAGCGCTCACGGACAGATCCAGGGCGAGCAGTACTTCGGGCCG	CSAHGQIQGEQYF	1
CAGCGCACAGAGCAGGGGGACTCGGCCATGTATCTCTGTGCCAGCAGCCGTAGCGGGGGGGCCTCAGATACGCAGTATTTTGGCCCA	CASSRSGGASDTQYF	1
AGCACCTTGGAGCTGGGGGACTCGGCCCTTTATCTTTGCGCCAGCAGCTTGGCGTCAATGAGTGGGGGACAGCAGTACTTCGGGCCG	CASSLASMSGGQQYF	1
CACATCAATTCCCTGGAGCTTGGTGACTCTGCTGTGTATTTCTGTGCCAGCAGCCCCCAAACTTCCCACGAGCAGTACTTCGGGCCG	CASSPQTSHEQYF	1
GAGTTGGCTGCTCCCTCCCAGACATCTGTGTACTTCTGTGCCAGCATGAGGCGGGGCGCGAACACCGGGGAGCTGTTTTTTGGAGAA	CASMRRGANTGELFF	1
GTCCACGGAGTCAGGGGACACAGCACTGTATTTCTGTGCCAGCAGCAAAGATTTTGAGCCGGGGGCAATGAGCAGTTCTTCGGGCCA		1
CAGCGCACAGAGCAGGGGGACTCGGCCATGTATCTCTGTGCCAGCTTGGGGCGGGGGAATGTTAACACTGAAGCTTTCTTTGGACAA	CASLGRGNVNTEAFF	2
TTGGAGTCGGCTGCTCCCTCCCAAACATCTGTGTACTTCTGTGCCAGCATGTTCCGGGGTCGCTCCTACGAGCAGTACTTCGGGCCA	CASMFRGRSYEQYF	4
GCTGCTCCCTCCCAGACATCTGTGTACTTCTGTGCCAGCAGTTACTCTGGACAGCTTATCTTAAACCACGAGCAGTACTTCGGGCCG	CASSYSGQLILNHEQYF	2
AACGCCTTGGAGCTGGAGGACTCGGCCCTGTATCTCTGTGCCAGCAGCTTTATGGGAAGTCGGAACTATGGCTACACCTTCGGTTCG	CASSFMGSRNYGYTF	1
CGCTCACCAGGCCTGGGGGACGCAGCCATGTACCTGTGTTCCTCCAGCAGAGATGTGGGGGAGGGCACTGAAGCTTTCTGTGGACAA	CSSSRDVGEGTEAFC	1
CGCCCAGCCCCAACCAGACCTCTCTGTACTTCTGTGCCAGCAGTTCGATGGACAAGGCGGGACACCGGGGAGCTGTTTTTTGGAGAA		1
GTGACCAGTGCCCATCCTGAAGACAGCAGCTTCTACATCTGCAGTGCTAGGTTAACAGGGAGGATGAAGACCCAGTACTTCGGGCCA	CSARLTGRMKTQYF	1
GTGAGCACCTTGGAGCTGGGGGACTCGGCCCTTTATCTTTGCGCCAGCAGATCGGGACAGGAGAACACTGAAGCTTTCTTTGGACAA	CASRSGQENTEAFF	1
ACAGTGACCAGTGCCCATCCTGAAGACAGCAGCTTCTACATCTGCAGTGCCACTAGCGGGAATGCGAATGAGCAGTTCTTCGGGCCA	CSATSGNANEQFF	1
TCGGCCCAAAAGAACCCGACAGCTTTCTATCTCTGTGCCAGTGCGAGGACGCAGGTCGGTGGGGCCAACGTCCTGACTTTCGGGGCC	CASARTQVGGANVLTF	1
ACAGTGACCAGTGCCCATCCTGAAGACAGCAGCTTCTACATCTGCAGTGCTAGAGAACGGTCGGACGAAAAACTGTTTTTTGGCAGT	CSARERSDEKLFF	1
AGGATCCAGCAGGTAGTGCGAGGAGGTTCGGCAGCTTATTTCTGTGCCAGCTCACCATCAGAAGATCAGCCCCAGCATTTTGGTGAT	CASSPSEDQPQHF	1
ACTCTGGAGTCTGCTGCCTCCTCCCAGACATCTGTATATTTCTGCGCCAGCAGATCTGGAAGTAGCGGGGAGCTGTTTTTTGGAGAA	CASRSGSSGELFF	1
AATCTTCACATCAATTCCCTGGAGCTTGGTGACTCTGCTGTGTATTTCTGTGCCAGCAGCCATCAGGGTGGCGCTTTCTTTGGACAA	CASSHQGGAFF	1
AAGATCCAGCGCACAGAGCAGGGGGACTCAGCTGTGTATCTCTGTGCCAGCAGCTTAGTTTAGGTGAAGGGCTACACCTTCGGTTCG	CASSLV*VKGYTF	2
AAGATCCGGTCCACAAAGCTGGAGGACTCAGCCATGTACTTCTGTGCCAGGGGACAGGGGTCTACTCAGCCCCAGCATTTTGGTGAT	CARGQGSTQPQHF	1
CAGGTAGTGCGAGGAGATTCGGCAGCTTATTTCTGTGCCAGCTCCAAAGGCCCAGCGGGACTCCAAGAGACCCAGTACTTCGGGCCA	CASSKGPAGLQETQYF	1
CTCAGGCTGGAGTCGGCTGCTCCCTCCCAGACATCTGTGTACTTCTGTGCCAGCAGAAAACAGGGGAATGAGCAGTTCTTCGGGCCA	CASRKQGNEQFF	1
CTGCTGTCGGCTGCTCCCTCCCAGACATCTGTGTACTTCTGTGCCAGCAGTTACTCTGGGGCGGAGTATGGCTACACCTTCGGTTCG	CASSYSGAEYGYTF	1
ATCAATTCCCTGGAGCTTGGTGACTCTGCTGTGTATTTCTGTGCCAGCAGCCAGCGGGAGTCGTACTATGGCTACACCTTCGGTTCG	CASSQRESYYGYTF	1
AAGATCCAGCGCACACAGCAGGAGGACTCCGCCGTGTATCTCTGTGCCAGCAGCTTCCAGGGGAAAACTGAAGCTTTCTTTGGACAA	CASSFQGKTEAFF	1
ACCAGTGCCCATCCTGAAGACAGCAGCTTCTACATCTGCAGTGCTAGAGATCCGGCGGGATCTTTAGCCGGCTACACCTTCGGTTCG	CSARDPAGSLAGYTF	1
AAGATCCAACCTGCAAAGCTTGAGGACTCGGCCGTGTATCTCTGTGCCAGCAGCTTAAGTATAACCGGGGAGCTGTTTTTTGGAGAA	CASSLSITGELFF	3
GAGTCCGCCAGCACCAACCAGACATCTATGTACCTCTGTGCCAGCTCCTCGCTCAGTCGCTTTAACTATGGCTACACCTTCGGTTCG	CASSSLSRFNYGYTF	3
TCGCCCAGCCCCAACCAGACCTCTCTGTACTTCTGTGCCAGCAGTTTATCCCCGGGGGGAGGGTCCTATGGCTACACCTTCGGTTCG	CASSLSPGGGSYGYTF	1
AGTCTGCTGCCTCCTCCCAGACATCTGTATATTTCTGCGCCACCACTTAAGCGGGAGGGCCGAGCAGATACGCAGTATTTTGGCCCA		2
GCACAGAGCAGCGGGACTCGGCCATGTATCGCTGTGCCAGCAGCTGGCCCAGGAAAGGGAATCAGGGAGACCCAGTACTTCGGGCCA		2
GCTGCTCCCTCCCAGACATCTGTGTACTTCTGTGCCAGCAGTTACTCGGGAATAGCGGGGGGTGACAATGAGCAGTTCTTCGGGCCA	CASSYSGIAGGDNEQFF	1
TTGGAGATCCAGCGCACAGAGCAGGGGGACTCGGCCATGTATCTCTGTGCCAGCAGCTTTCTAAATCAGCCCCAGCATTTTGGTGAT	CASSFLNQPQHF	1
AGCCCCAACCAGACCTCTCTGTACTTCTGTGCCAGCAGTTTATCCGCCCTACTAGCGGCGGGTGAAGATACGCAGTATTTTGGCCCA	CASSLSALLAAGEDTQYF	1
CACGGAGTCAGGGGACACAGCACTGTATTTCTGTGCCAGCAACCCCTGGTGTCCAGTCCGAACACCGGGGAGCTGTTTTTTGGAGAA		1
CTGAAGATCCAGCCCTCAGAACCCAGGGACTCAGCTGTGTACTTCTGTGCCAGCAGTTTCGGGGAACGTGGCTACACCTTCGGTTCG	CASSFGERGYTF	1
ACAGTGACCAGTGCCCATCCTGAAGACAGCAGCTTCTACATCTGCAGTGCCGCGACAAACTCTGGAAACACCATATATTTTGGAGAG	CSAATNSGNTIYF	3
GAGCAACATGAGCCCTGAAGACAGCAGCATATATCTCTGCAGCGTTGAAGCAAGGGGGTGAGAGCCTACGAGCAGTACTTCGGGCCG		1
ACACAGCAGGAGGACTCGGCCGTGTATCTCTGTGCCAGCAGCCCCCACGGATATTCTCGGGCCCAAGAGACCCAGTACTTCGGGCCA	CASSPHGYSRAQETQYF	2
AGCACCTTGGAGCTGGGGGACTCGGCCCTTTATCTTTGCGCCAGCTCCCACAAGGGACTAGCCCCGGAGACCCAGTACTTCGGGCCA	CASSHKGLAPETQYF	4
AGGATCCAGCAGGTAGTGCGAGGAGATTCGGCAGCTTATTTCTGTGCCAGCTCACCACCCAACTCCTACGAGCAGTACTTCGGGCCG	CASSPPNSYEQYF	2
TGAGCAACATGAGCCCTGAAGACAGCAGCATATATCTCTGCAGCGTTGCGACAGGGACCCTCCTACAATGAGCAGTTCTTCGGGCCA		1
ACCAGTGCCCATCCTGAAGACAGCAGCTTCTACATCTGCAGTGCTAGAGATAGGCAGACCCCAAATCAGCCCCAGCATTTTGGTGAT	CSARDRQTPNQPQHF	1
CGCACACAGCAGGAGGACTCGGCCGTGTATCTCTGTGCCAGCAGCTACATTACGACAGGGCCTACAGATACGCAGTATTTTGGCCCA	CASSYITTGPTDTQYF	1
CCCAGGGACTCAGCTGTGTACTTCTGTGCCAGCAGGGTAGCTACAGGGGGCAGGGCCTTAGGCACAGATACGCAGTATTTTGGCCCA	CASRVATGGRALGTDTQYF	1
ATCCAGCCTGCAGAGCTTGGGGACTCGGCCGTGTATCTCTGTGCCAGCAGCCCGGGAGCGGCGGGGACTGAAGCTTTCTTTGGACAA	CASSPGAAGTEAFF	1
CTGCTGTCGGCTGCTCCCTCCCAGACATCTGTGTACTTCTGTGCCAGCACCACGGGGGGTTCCGGAAACACCATATATTTTGGAGAG	CASTTGGSGNTIYF	1
ATGAATGTGAGCACCTTGGAGCTGGGGGACTCGGCCCTTTATCTTTGCGCCAGCAGCTTGGTCCAAGAGACCCAGTACTTCGGGCCA	CASSLVQETQYF	1
ACTCTGACGATCCAGCGCACAGAGCAGCGGGACTCGGCCATGTATCGCTGTGCCAGCAGCTTGGGGGGAGGCTACACCTTCGGTTCG	CASSLGGGYTF	1
AGCACCTTGGAGCTGGGGGACTCGGCCCTTTATCTTTGCGCCAGCAGCCCCCAGGGTGCGGGGGGGAGCGAGCAGTACTTCGGGCCG	CASSPQGAGGSEQYF	1
CTGGAGTCCGCTACCAGCTCCCAGACATCTGTGTACTTCTGTGCCATCAGTAGCGGTCATAGCAATCAGCCCCAGCATTTTGGTGAT	CAISSGHSNQPQHF	1
AGCTCTCTGGAGCTGGGGGACTCAGCTTTGTATTTCTGTGCCAGCAGCGTAGAAGGATTGGGTAACTATGGCTACACCTTCGGTTCG	CASSVEGLGNYGYTF	3
ACGATCCAGCGCACAGAGCAGCGGGACTCGGCCATGTATCGCTGTGCCAGCACTGGACAGGGGTCCTATGGCTACACCTTCGGTTCG	CASTGQGSYGYTF	1
AGCACCTTGGAGCTGGGGGACTCGGCCCTTTATCTTTGCGCCAGCAGCTTACTAGCGGGAGCCGGAAATGAGCAGTTCTTCGGGCCA	CASSLLAGAGNEQFF	1
GAGTCGGCTGCTCCCTCCCAGACATCTGTGTACTTCTGTGCCAGCAGCGCCAGGGGTCAGAGCGGTGAAAAACTGTTTTTTGGCAGT	CASSARGQSGEKLFF	1
AACGCCTTGGAGCTGGAGGACTCGGCCCTGTATCTCTGTGCCAGCAGCTTGGGCAGGGGTGGTTCGGAGACCCAGTACTTCGGGCCA	CASSLGRGGSETQYF	5
TCGGCTGCTCCCTCCCAAACATCTGTGTACTTCTGTGCCAGCAGTTACTCGAGGGACAGTTCTCTGCCTGAAGCTTTCTTTGGACAA	CASSYSRDSSLPEAFF	2
AAGATCCAGCCCTCAGAACCCAGGGACTCAGCTGTGTACTTCTGTGCCAGCAGCAAAGATCTTGGTGAAAAACTGTTTTTTGGCAGT	CASSKDLGEKLFF	1
ATCCTGAGTTCTAAGAAGCTCCTTCTCAGTGACTCTGGCTTCTATCTCTGTGCCTGGGGCGCCGGGGGTACGCAGTATTTTGGCCCA	CAWGAGGTQYF	3
ACCAGTGCCCATCCTGAAGACAGCAGCTTCTACATCTGCAGTGCTAAGGACCGTCCAGGGTTCAGGTACGAGCAGTACTTCGGGCCG	CSAKDRPGFRYEQYF	5
TCGGCTGCTCCCTCCCAAACATCTGTGTACTTCTGTGCCAGCAGTTATGGTTTTCACGAATCGAACTATGGCTACACCTTCGGTTCG	CASSYGFHESNYGYTF	1
AAGATCCGGTCCACAAAGCTGGAGGACTCAGCCATGTACTTCTGTGCCAGCAGTGATCAGGGTTCCGAGACCCAGTACTTCGGGCCA	CASSDQGSETQYF	1
GGATTCTGGAGTTTATTTCTGTGCCAGCAGCCAAGAATGATCGGCAGGGCCCCCTACCAGGGGAATTCACCCCTCCACTTTGGGAAC		1
AAGATCCAGCCCTCAGAACCCAGGGACTCAGCTGTGTACTTCTGTGCCAGCAGTCCGCTGGAGGGCGCGGCAGCTTTCTTTGGACAA	CASSPLEGAAAFF	2
CTGGAGTCTGCCAGGCCCTCACATACCTCTCAGTACCTCTGTGCCAGCAGCCGGGGGTCACAGAATTCACCCCTCCACTTTGGGAAC	CASSRGSQNSPLHF	2
GAGTCGGCTGCTCCCTCCCAAACATCTGTGTACTTCTGTGCCAGCAGGGCCTTAGCGGGCATACGCTACGAGCAGTACTTCGGGCCG	CASRALAGIRYEQYF	1
AAGAAGCTCCTTCTCAGTGACTCTGGCTTCTATCTCTGTGCCTGGATGCCCTTTTCGTCCGGGACAAATGAAGCTTTCTTTGGACAA	CAWMPFSSGTNEAFF	1
CTGGGGTTGGAGTCGGCTGCTCCCTCCCAAACATCTGTGTACTTCTGTGCCTCAGGACGACCCCGCCAGCCCCAGCATTTTGGTGAT	CASGRPRQPQHF	1
ATCAATTCCCTGGAGCTTGGTGACTCTGCTGTGTATTTCTGTGCCAGCAGCCAAGACCACTCTGGAAACACCATATATTTTGGAGAG	CASSQDHSGNTIYF	1
TCGGCTGCTCCCTCCCAGACATCTGTGTACTTCTGTGCCAGCAGCGGGGGTGGGACAGGCTTAAACCAGCCCCAGCATTTTGGTGAT	CASSGGGTGLNQPQHF	1
CACATCAATTCCCTGGAGCTTGGTGACTCTGCTGTGTATTTCTGTGCCAGCAGCCCGCAGGGGGTCGGGGAGCTGTTTTTTGGAGAA	CASSPQGVGELFF	1
CGGTCCACAAAGCTGGAGGACTCAGCCATGTACTTCTGTGCCAGCAGTGAAGGGACAGGGTTCTCCGGGGAGCTGTTTTTTGGAGAA	CASSEGTGFSGELFF	1
ACCAGTGCCCATCCTGAAGACAGCAGCTTCTACATCTGCAGTGCTAGGTCAGGTACGGGACGGGAGCATGGCTACACCTTCGGTTCG	CSARSGTGREHGYTF	1
GTGAGCACCTTGGAGCTGGGGGACTCGGCCCTTTATCTTTGCGCCACCTCGAAAAACGGAGCTCCTGAAAAACTGTTTTTTGGCAGT	CATSKNGAPEKLFF	1
CGCACACAGCAGGAGGACTCGGCCGTGTATCTCTGTGCCAGCAGCTTATCGGGACTAGCGGGATTCTACGAGCAGTACTTCGGGCCA	CASSLSGLAGFYEQYF	1
AACGCCTTGTTGCTGGGGGACTCGGCCCTCTATCTCTGTGCCAGCAGCTTCGCAGGTAGTGGGGCCAACGTCCTGACTTTCGGGGCC	CASSFAGSGANVLTF	1
GTCCCTAGAGTCTGCCATCCCCAACCAGACAGCTCTTTACTTCTGTGCCACCAGAGGAGGGCCTACAATGAGCAGTTCTTCGGGCCA		1
CACGCCCTGCAGCCAGAAGACTCAGCCCTGTATCTCTGCGCCAGCAGCCAAAAATTCCCTATTAACGGTACGCAGTATTTTGGCCCA	CASSQKFPINGTQYF	1
CAGTCCACGGAGTCAGGGGACTCAGCCCTGTACTTCTGTGCCAGCAGCGTCGGGACTAGTTGGGCAGATACGCAGTATTTTGGCCCA	CASSVGTSWADTQYF	1
AAGATCCAGCGCACAGAGCAGGGGGACTCAGCCGTGTATCTCCGTGCCAGCAGCTTAAGACCCCAAGAGACCCAGTACTTCGGGCCA	RASSLRPQETQYF	1
CACATCAATTCCCTGGAGCTTGGTGACTCTGCTGTGTATTTCTGTGCCAGCAGCCAAGGGCCTCAAGAGACCCAGTACTTCGGGCCA	CASSQGPQETQYF	1
GCTACGAAGCTTGAGGATTCAGCAGTGTATTTTTGTGCCAGCAGCCCGCTTGGGGGTAGCTCCTACAATGAGCAGTTCTTCGGGCCA	CASSPLGGSSYNEQFF	1
GAGTCGCCCAGCCCCAACCAGACCTCTCTGTACTTCTGTGCCAGCAGTTGGGCCGGGACAGGGGCCTACGAGCAGTACTTCGGGCCA	CASSWAGTGAYEQYF	1
ACTGTGAGCAACATGAGCCCTGAAGACAGCAGCATATATCTCTGCAGCGTTGACGAGGGGACCACTTATGGCTACACCTTCGGTTCG	CSVDEGTTYGYTF	1
TCCACTCTGACAGTGACCAGTGCCCATCCTGAAGACAGCAGCTTCTACATCTGCAGTGCTAGCTGGGGGGCCCAGTACTTCGGGCCA	CSASWGAQYF	2
ATCCAGCCCTCAGAACCCAGGGACTCAGCTGTGTACTTCTGTGCCAGCAGTTTAAATTTGTGGGAGTATGGCTACACCTTCGGTTCG	CASSLNLWEYGYTF	1
CTGACAGTGACCAGTGCCCATCCTGAAGACAGCAGCTTCTACATCTGCAGTTTCCGACAGGAAGCCTACGAGCAGTACTTCGGGCCG	CSFRQEAYEQYF	2
GTGACCAGTGCCCATCCTGAAGACAGCAGCTTCTACATCTGCAGTGCTAGCCGGACTAGCGGGGCCTATGAGCAGTTCTTCGGGCCA	CSASRTSGAYEQFF	3
CTGGAGTCGGCTGCTCCCTCCCAGACATCTGTGTACTTCTGTGCCAGCAGGATTAGCGGGGGGGCCAATGAGCAGTTCTTCGGGCCA	CASRISGGANEQFF	1
ACAGTGACCAGTGCCCATCCTGAAGACAGCAGCTTCTACATCTGCAGTGCTAGCAGGACAGGGGGAAACGAGCAGTACTTCGGGCCG	CSASRTGGNEQYF	1
GTGACCAGTGCCCATCCTGAAGACAGCAGCTTCTACATCTGCAGTGCTACAAAACACGTCGGGTCGGTCGAGCAGTACTTCGGGCCG	CSATKHVGSVEQYF	1
GAGTCGGCTGCTCCCTCCCAAACATCTGTGTACTTCTGTGCCAGCAGTTACGAGGAGCTAGCGGCAGATACGCAGTATTTTGGCCCA	CASSYEELAADTQYF	1
CTGACAGTGACCAGTGCCCATCCTGAAGACAGCAGCTTCTACATCTGCAGTGCAGGACAGGCCAGCGAGCCCCAGCATTTTGGTGAT	CSAGQASEPQHF	1
AGCACCTTGGAGCTGGGGGACTCGGCCCTTTATCTTTGCGCCAGCAGCTTCCAGACAGGCTATGGTAACGAGCAGTACTTCGGGCCG	CASSFQTGYGNEQYF	1
CTGGGGGACTCAGCTTTGTATTTCTGTGCCAGCAGCGTCGGACAGGGGGGAAGATTTTCTGGGGCCAACGTCCTGACTTTCGGGGCC	CASSVGQGGRFSGANVLTF	1
ACCTTGGAGCTGGGGGACTCGGCCCTTTATCTTTGCGCCAGCAGCATTTTAGCGGGGGAGATTTACAATGAGCAGTTCTTCGGGCCA	CASSILAGEIYNEQFF	1
GCCTTGGAGCTGGACGACTCGGCCCTGTATCTCTGTGCCAGCAGCTTGGTTCGATCTAGCGGGGTCGATGAGCAGTTCTTCGGGCCA	CASSLVRSSGVDEQFF	1
AACCTGAGCTCTCTGGAGCTGGGGGACTCAGCTTTGTATTTCTGTGCCAGCAGCCGCCGGGAGGACACTGAAGCTTTCTTTGGACAA	CASSRREDTEAFF	2
GAGCTGGGGGACTCGGCCCTTTATCTTTGCGCCAGCAGCTTCCCCGACGATGGACAGAGTCTCAACTATGGCTACACCTTCGGTTCG	CASSFPDDGQSLNYGYTF	2
GTGAGCACCTTGGAGCTGGGGGACTCGGCCCTTTATCTTTGCGCCAGCAGCTTCGACGGGTTCCAAGAGACCCAGTACTTCGGGCCA	CASSFDGFQETQYF	1
CCTGCAGAACTGGAGGATTCTGGAGTTTATTTCTGTGCCAGCAGCCAAGGGACTAGCGGATTCTCCTACGAGCAGTACTTCGGGCCG	CASSQGTSGFSYEQYF	1
AGCAACATGAGCCCTGAAGACAGCAGCATATATCTCTGCAGCGTTGAAGATCGTCAGGGGATTGGTTCCGAGCAGTACTTCGGGCCG	CSVEDRQGIGSEQYF	1
AAGATCCAGCCCTCAGAACCCAGGGACTCAGCTGTGTACTTCTGTGCCAGCAGTTTAGGCAGCTACTATGGCTACACCTTCGGTTCG	CASSLGSYYGYTF	1
CTGAGGATCCAGCAGGTAGTGCGAGGAGATTCGGCAGCTTATTTCTGTGCCAGCTCGGGTTTCAGTCTTGGGCAGTTCTTCGGGCCA	CASSGFSLGQFF	1
ACAGTGACCGGTGCCCATCCTGAAGACAGCAGCTTCTACATCTGCAGTGCTAGAGACGGGGTTACCGGGGAGCTGTTTTTTGGAGAA	CSARDGVTGELFF	2
GCCCAGCCCCAACCAGACCTCTCTGTACTTCTGTGCCAGCAGCCCTGAGGTGGGACAGACGCCAAAAACATTCAGTACTTCGGCGCC		1
ACACAGCAAGAGGACTCGGCCGTGTATCTCTGTGCCAGCAGCTTAGGGGGCATCGGACAGGGGCTTAGTGAGCAGTACTTCGGGCCG	CASSLGGIGQGLSEQYF	1
GAAGACTCGGCCCTGTATCTCTGCGCCAGCACCCTTCTAAGCCCGGGACAGGCCCGGCTGAGCAATCAGCCCCAGCATTTTGGTGAT	CASTLLSPGQARLSNQPQHF	1
ACATCGGCCCAAAAGAACCCGACAGCTTTCTATCTCTGTGCCAGTAGCACGGACATACTCTCCTACAATGAGCAGTTCTTCGGGCCA	CASSTDILSYNEQFF	1
TCGCTCAGGCTGGAGTCGGCTGCTCCCTCCCAGACATCTGTGTACTTCTGTGCCAGCGGACAGGGCTACGAGCAGTACTTCGGGCCG	CASGQGYEQYF	1
GTGCCCATCCTGAAGACAGCAGCTTCTACATCTGCAGTGCTAGAGATCACTAGCGGGAGGGCTCGGCACGAGCAGTACTTCGGGCCG		1
ATCAGTGCCCATCCTGAAGACAGCAGCTTCTACATCTGCAGTGCTAGAGATTGGCTAGCGGGAGCAGATACGCAGTATTTTGGCCCA	CSARDWLAGADTQYF	1
ACGATCCAGCGCACACAGCAGGAGGACTCGGCCGTGTATCTCTGTGCCAGCAGGACCGGGGGGGGCTACGAGCAGTACTTCGGGCCG	CASRTGGGYEQYF	1
CTGATTCTGGAGTCCGCCAGCACCAACCAGACATCTATGTACCTCTGTGCCAGCAGACAAGCAGTCTATGGCTACACCTTCGGTTCG	CASRQAVYGYTF	1
CAGCGCACAGAGCAGGGGGACTCGGCCATGTATCTCTGTGCCAGCAGCCCCCCCACTGTCCGGGGGGAAAAACTGTTTTTTGGCAGT	CASSPPTVRGEKLFF	1
CTGCTGTCGGCTGCTCCCTCCCAGACATCTGTGTACTTCTGTGCCAGCAGTACGTATATGGGATCCTACGAGCAGTACTTCGGGCCG	CASSTYMGSYEQYF	1
CGCCCAGCCCCAACCAGACCTCTCTGTACTTCTGTGCCAGCAGTTTAGACATCTAGCGGGAGCTCCTACGAGCAGTACTTCGGGCCG		1
CTCAGGCTGCTGTCGGCTGCTCCCTCCCAGACATCTGTGTACTTCTGTGCCAGCAGTATGCCGTCAGGCGAGCAGTACTTCGGGCCG	CASSMPSGEQYF	1
AAGATCCAGCCTGCAAAGCTTGAGGACTCGGCCGTGTATCTCTGTGCCAGTGTAGCGTCACGCACAGATACGCAGTATTTTGGCCCA	CASVASRTDTQYF	1
GGGTTGGAGTCGGCTGCTCCCTCCCAAACATCTGTGTACTTCTGTGCCAGCAGTCCAGCGGGTGGCTATGGCTACACCTTCGGTTCG	CASSPAGGYGYTF	1
ACAGTGACCAGTGCCCATCCTGAAGACAGCAGCTTCTACATCTGCAGTGCTAGCAGGACCGGAACAAATACGCAGTATTTTGGCCCA	CSASRTGTNTQYF	1
GTGAGCAACATGAGCCCTGAAGACAGCAGCATATATCTCTGCAGCGTGAACCGGGACAGGGGGCCAGATACGCAGTATTTTGGCCCA	CSVNRDRGPDTQYF	1
CGCACACAGCAGGAGGACTCGGCCGTGTATCTCTGTGCCAGCAGTCGGGACAGGGTGAATTCCTACAATGAGCAGTTCTTCGGGCCA	CASSRDRVNSYNEQFF	1
GATCCAGTCCACGGAGTCAGGGGACACAGCACTGTATTTCTGTGCCAGCAGCAAAGCGGTCGGGGTTCACCCCTCCACTTTGGGAAC		1
ATCCAGCGCACACAGCAGGAGGACTCGGCCGTGTATCTCTGTGCCAGCAGCTTAATGCCAGGAAACACTGAAGCTTTCTTTGGACAA	CASSLMPGNTEAFF	1
TCCGCCAGCACCAACCAGACATCTATGTACCTCTGTGCCAGCAGTTTATCCGCGGGACAGAGATCCTACGAGCAGTACTTCGGGCCG	CASSLSAGQRSYEQYF	1
AGGCTGCTGTCGGCTGCTCCCTCCCAGACATCTGTGTACTTCTGTGCCAGCAGTCGCCGTGACAGCTATGGCTACACCTTCGGTTCG	CASSRRDSYGYTF	1
CTGCCAGGCCCTCACATACCTCTCAGTACCTCTGTGCCAGCAGTGAAGAATGGGTCGCGGGGGAGGCCTGAAGCTTTCTTTGGACAA		1
TGAACGCCTTGTTGCTGGGGGACTCGGCCCTGTATCTCTGTGCCAGCAGCTTGGAGGGGGTCTACCTACGAGCAGTACTTCGGGCCG		1
CTGGAGTCGCCCAGCCCCAACCAGACCTCTCTGTACTTCTGTGCCAGCAGTTTAATAGGGCAAACCCATGGCTACACCTTCGGTTCG	CASSLIGQTHGYTF	1
GAGTCGGCTGCTCCCTCCCAGACATCTGTGTACCTCTGTGCCAGCAGTGAAAGGTGGCAGTCCAACTATGGCTACACCTTCGGTTCG	CASSERWQSNYGYTF	1
CAGCGCACAGAGCAGCGGGACTCGGCCATGTATCGCTGTGCCAGCAGCTTAGGAGGGGGCGTAAACAATGAGCAGTTCTTCGGGCCA	CASSLGGGVNNEQFF	1
ACGATCCAGCGCACACAGCAGGAGGACTCGGCCGTGTATCTCTGTGCCAGCAGCTTAGGTATGGGGTATGGCTACACCTTCGGTTCG	CASSLGMGYGYTF	1
GCCTGGCAATCCTGTCCTCAGAACCGGGAGACACGGCACTGTATCTCTGCGCCAGCAGTCTGCGGTCGTGGCTACACCTTCGGTTCG		1
AGGATCCAGCAGGTAGTGCGAGGAGATTCGGCAGCTTATTTCTGTGCCAGCTCACCAGGAGGGACACAGCCCCAGCATTTTGGTGAT	CASSPGGTQPQHF	1
CACACCCTGCAGCCAGAAGACTCGGCCCTGTATCTCTGTGCCAGCAGCCAACTAGCGGGCCACACAGATACGCAGTATTTTGGCCCA	CASSQLAGHTDTQYF	1
ACCTTGGAGCTGGGGGACTCGGCCCTTTATCTTTGCGCCAGCAGCCCTGGAGCGGGGTATACCTACAATGAGCAGTTCTTCGGGCCA	CASSPGAGYTYNEQFF	1
AGGCTGGAGTTGGCTGCTCCCTCCCAGACATCTGTGTACTTCTGTGCCAGCAGTGGCAGGGTAAATCAGCCCCAGCATTTTGGTGAT	CASSGRVNQPQHF	5
GTGACCAGTGCCCATCCTGAAGACAGCAGCTTCTACATCTGCAGTGCTTCGGGGAGTTATAGCAATCAGCCCCAGCATTTTGGTGAT	CSASGSYSNQPQHF	1
ACTGTGAGCAACATGAGCCCTGAAGACAGCAGCATATATCTCTGCAGCGTTGGGGGGACAGGCAATCAGCCCCAGCATTTTGGTGAT	CSVGGTGNQPQHF	1
CTGAGCTCTCTGGAGCTGGGGGACTCAGCTTTGTATTTCTGTGCCAGCAGCGTAGATTGGGGGGCGGATACGCAGTATTTTGGCCCA	CASSVDWGADTQYF	3
GAGAGAAGAAGGAGCGCTTCTCCCTGATTCTGGAGTCCGCCAGCACCAACCAGACATCTATGTACCTCTGTGCCAGCAGCGGGACAA		1
CTGCTGGGGTTGGAGTCGGCTGCTCCCTCCCAAACATCTGTGTACTTCTGTGCCAGCAGTCGCACAGATACGCAGTATTTTGGCCCA	CASSRTDTQYF	1
AACATGAGCTCCTTGGAGCTGGGGGACTCAGCCCTGTACTTCTGTGCCAGCAGTGGCCAGGACAATCAGCCCCAGCATTTTGGTGAT	CASSGQDNQPQHF	1
GAGTCGGCTGCTCCCTCCCAAACATCTGTGTACTTCTGTGCCAGCAGTTCCGTGACCATCAGCTACAATGAGCAGTTCTTCGGGCCA	CASSSVTISYNEQFF	1
ATCCAGCAGGTAGTGCGAGGAGATTCGGCAGCTTATTTCTGTGCCAGCTCATCGGGACAGACGAACACTGAAGCTTTCTTTGGACAA	CASSSGQTNTEAFF	1
GTGACCAGTGCCCATCCTGAAGACAGCAGCTTCTACATCTGCAGTGCTAGGATGGGGTATAGCAATCAGCCCCAGCATTTTGGTGAT	CSARMGYSNQPQHF	1
ATCCAGCCCTCAGAACCCAGGGACTCAGCTGTGTACTTCTGTGCCAGCAGTTTGAGGGATAATTCTTCACCCCTCCACTTTGGGAAC	CASSLRDNSSPLHF	1
CGGTCCACAAAGCTGGAGGACTCAGCCATGTACTTCTGTGCCAGCAAAACGCAGGGTCTAAGCACAGATACGCAGTATTTTGGCCCA	CASKTQGLSTDTQYF	1
AGGATCCAGCAGGTAGTGCGAGGAGATTCGGCAGCTTATTTCTGTGCCAGCTCACTCCTCTCCGTGGATGAGCAGTTCTTCGGGCCA	CASSLLSVDEQFF	1
AGATCCAGTCCACGGAGTCAGGGGACACAGCACTGTATTTCTGTGCCAGCATGGGCCCGACTGGGCTATGGCTACACCTTCGGTTCG		1
CTGACAGTGACCAGTGCCCATCCTGAAGACAGCAGCTTCTACATCTGCAGTGCTAGTAGTGGAAGTACTGGCTACACCTTCGGTTCG	CSASSGSTGYTF	1
GCCCATCCTGAAGACAGCAGCTTCTACATCTGCAGTGCCAAGCAGTGGGACAGGGGGCCCCTTAATGAAAAACTGTTTTTTGGCAGT	CSAKQWDRGPLNEKLFF	2
GTGCGAGGAGATTCGGCAGCTTATTTCTGTGCCAGCTCACCTTCATCGGTGGCTGCCTCCGGGACCGGGGAGCTGTTTTTTGGAGAA	CASSPSSVAASGTGELFF	2
GAGTCCGCCAGCACCAACCAGACATCTATGTACCTCTGTGCCAGCAGTACGCCGGGACAGGGGATTTCTGGCTACACCTTCGGTTCG	CASSTPGQGISGYTF	1
CAGCGCACACAGCAGGAGGACTCGGCCGTGTATCTCTGTGCCAGCAGCTACCTCAGACGGAACTCCTACGAGCAGTACTTCGGGCCG	CASSYLRRNSYEQYF	1
AGCGCACACAGCAGGAGGACTCGGCCGTGTATCTCTGTGCCAGCAGCTCGCTAGCGGGAGGGCCTCGACGGGCAGTACTTCGGGCCG		1
AGTTCTAAGAAGCTCCTTCTCAGTGACTCTGGCTTCTATCTCTGTGCCTGGAGGGCAAGCGGGATAGGCGAGCAGTACTTCGGGCCG	CAWRASGIGEQYF	2
AGCAACATGAGCCCTGAAGACAGCAGCATATATCTCTGCAGCGTTGAGGGCCCGAGGAAAGACACCGGGGAGCTGTTTTTTGGAGAA	CSVEGPRKDTGELFF	1
ATCCAGCGCACAGAGCAGGGGGACTCGGCCATGTATCTCTGTGCCAGCAGCGGGACAGGGGTTAATGAAAAACTGTTTTTTGGCAGT	CASSGTGVNEKLFF	1
GTGAACGCCTTGGAGCTGGACGACTCGGCCCTGTATCTCTGTGCCAGCAGCCCTGGGGGGGCTGGGGGTACGCAGTATTTTGGCCCA	CASSPGGAGGTQYF	1
CAGCGCACACAGCAGGAGGACTCGGCCGTGTATCTCTGTGCCAGCAGCCTAGACAGGGACTCCTACAATGAGCAGTTCTTCGGGCCA	CASSLDRDSYNEQFF	1
AACATGAGCCCTGAAGACAGCAGCATATATCTCTGCAGCGTTGAAGATTTACCCCCGGGAGGGGGTGTCAGACAGTACTTCGGGCCG	CSVEDLPPGGGVRQYF	1
AGTCCACGGGGTCAGGGGACACAGCACTGTATTTCTGTGCCAGCAGCAAAGCGGGACAGGGCCGTTCAGCCCCAGCATTTTGGTGAT		1
AGTGACCAGTGCCCATCCTGAAGACAGCAGCTTCTACACCGGAAGGCCAGGGGACATTATAGCAATCAGCCCCAGCATTTTGGTGAT		1
ACTCTGACTGTGAGCAACATGAGCCCTGAAGACAGCAGCATATATCTCTGCAGCGTTCGTAATTCGTACGAGCAGTACTTCGGGCCG	CSVRNSYEQYF	2
ATCCAGCAGGTAGTGCGAGGAGATTCGGCAGCTTATTTCTGTGCCAGCTCACCCGGGTCACAGGGGACTGAAGCTTTCTTTGGACAA	CASSPGSQGTEAFF	1
GACAGTGACCAGTGCCCATCCTGAAGACAGCAGCTTCTACATCTGCAGCGCCGGGCGGGGGGCTTCAATGAGCAGTTCTTCGGGCCA		1
AATGTGAGCACCTTGGAGCTGGGGGACTCGGCCCTTTATCTTTGCGCCAGCCAAACACAGGCCTACAATGAGCAGTTCTTCGGGCCA	CASQTQAYNEQFF	1
CGCACACAGCAGGAGGACTCGGCCGTGTATCTCTGTGCCAGCACCACAGACCCGGGGGGCCGTGGAAACACCATATATTTTGGAGAG	CASTTDPGGRGNTIYF	1
ATCCAGCAGGTAGTGCGAGGAGATTCGGCAGCTTATTTCTGTGCCAGCTCACCTGGGCCTGGGTGGGATACGCAGTATTTTGGCCCA	CASSPGPGWDTQYF	1
CTGCAAAGCTTGAGGACTCGGCCGTGTATCTCTGTGCCAGCAGCTTACGGGCAGGGGGCTGAAGATTATGGCTACACCTTCGGTTCG		1
CATCCTGAAGACAGCAGCTTCTACATCTGCAGTGCTCCCATGAGTTCTAGCGGGAGTACTATCGGGGGAGAGCAGTTCTTCGGGCCA	CSAPMSSSGSTIGGEQFF	1
GTGAGCACCTTGGAGCTGGGGGACTCGGCCCTTTATCTTTGCGCCAGCAGCTTGGAGGGCCCCCGGGAGACCCAGTACTTCGGGCCA	CASSLEGPRETQYF	1
ACGATCCAGCGCACACAGCAGGAGGACTCGGCCGTGTATCTCTGTGCCAGCAGCTTGTGGGGGGACAATGAGCAGTTCTTCGGGCCA	CASSLWGDNEQFF	1
ATCCAGCCCTCAGAACCCAGGGACTCAGCTGTGTACTTCTGTGCCAGCAGTTTAGTGGGGAACCAAGAGACCCAGTACTTCGGGCCA	CASSLVGNQETQYF	1
AACGCCTTGTTGCTGGGGGACTCGGCCCTCTATCTCTGTGCCAGCAGCTTGGGAGACAGGGCCTACAATGAGCAGTTCTTCGGGCCA	CASSLGDRAYNEQFF	1
GACATCCGCTCACCAGGCCTGGGGGACGCAGCCATGTACCTGTGTGCCACCAGCAGAGATAGGGCGGCAGGCTACACCTTCGGTTCG	CATSRDRAAGYTF	1
GTGCCCATCCTGAAGACAGCAGCTTCTACATCTGCAGTCCCAAATCCCCTTGGGTGGGAGGACTCCTACGAGCAGTACTTCGGGCCG		1
ATCCAGCGCACACAGCAGGAGGACTCGGCCGTGTATCTCTGTGCCAGCATCAGTGGACGAGGGGATGGTGGCTACACCTTCGGTTCG	CASISGRGDGGYTF	1
ATCCAGCGCACACAGCAGGAGGACTCGGCCGTGTATCTCTGTGCCAGCAGCTTATCGGGTCTCGTAGGGCCCCAGCATTTTGGTGAT	CASSLSGLVGPQHF	1
AGGCTGGAGTTGGCTGCTCCCTCCCAGACATCTGTGTACTTCTGTGCCAGCAGTTACAAGGAGTCCAATGAGCAGTTCTTCGGGCCA	CASSYKESNEQFF	1
TGCAAAGCTTGAGGACTCGGCCGTGTATCTCTGTGCCAGCAGCTTAGCTCAGGGACAGGGGGCATCTAGTAAGCTTTCTTTGGACAA		1
GAGTCTGCCATCCCCAACCAGACAGCTCTTTACTTCTGTGCCACCAGTGACTCGGGGGCCGCGCGACCTGAAGCTTTCTTTGGACAA	CATSDSGAARPEAFF	1
ACAGAGCAGGGGGACTCGGCCATGTATCTCTGTGCCAGCAGCCCTCGGGGACTAGCAACCAAGGGGGAGACCCAGTACTTCGGGCCA	CASSPRGLATKGETQYF	1
GTGAGCACCTTGGAGCTGGGGGACTCGGCCCTTTATCTTTGCGCCAGCAGCCCGGGATCGAACTCAGATACGCAGTATTTTGGCCCA	CASSPGSNSDTQYF	1
AGCACCAACCAGACATCTATGTACCTCTGTGCCACCAAACCTTCTTTGGGGATGTATGCAACTAATGAAAAACTGTTTTTTGGCAGT	CATKPSLGMYATNEKLFF	2
GCCTTGGAGCTGGACGACTCGGCCCTGTATCTCTGTGCCAGCAGCTTGGATGCCGGGCCTGGGGTGGACATTCAGTACTTCGGCGCC	CASSLDAGPGVDIQYF	1
AGCTCTCTGGAGCTGGGGGACTCAGCTTTGTATTTCTGTGCCAGCAGCGTCGGGACAGTTAACACCGGGGAGCTGTTTTTTGGAGAA	CASSVGTVNTGELFF	3
ACCCTGCAGCCAGAAGACTCGGCCCTGTATCTCTGCGCCAGCAGCCTACAAGGTGGGACGACCTACAATGAGCAGTTCTTCGGGCCA	CASSLQGGTTYNEQFF	1
TTGGAGCTGGGGGACTCGGCCCTTTATCTTTGCGCCAGCAGCCCCGCCGGGACAGGGAGCGCGGTGAATGGCTACACCTTCGGTTCG	CASSPAGTGSAVNGYTF	1
CAGCCTGCAAAGCTTGAGGACTCGGCCGTGTATCTCTGTGCCAGCAGAATACTAGCGGGAGGGACAGATACGCAGTATTTTGGCCCA	CASRILAGGTDTQYF	1
CCCTCAGAACCCAGGGACTCAGCTGTGTACTTCTGTGCCAGCAGCCCTCGACAGGCCTCACCGGGAAACATTCAGTACTTCGGCGCC	CASSPRQASPGNIQYF	1
CAGCCTGCAAAGCTTGAGGACTCGGCCGTGTATCTCTGTGCCAGCAGCTCCCTAGCGGGAGATCGGCCTGAGCAGTTCTTCGGGCCA	CASSSLAGDRPEQFF	1
TTGGCTGCTCCCTCCCAGACATCTGTGTACTTCTGTGCCAGCAGTCGCCGGGACAGGAGTAACACCGGGGAGCTGTTTTTTGGAGAA	CASSRRDRSNTGELFF	1
CTGAGGATCCAGCAGGTAGTGCGAGGAGATTCGGCAGCTTATTTCTGTGCCACCCGGGAGGAGAATCGGGAGCTGTTTTTTGGAGAA	CATREENRELFF	1
GCCAGAAGACTCAGCCCTGTATCTCTGCGCCAGCAGCCCCGTCCGGACTAGCGGGGCCTCCGCACAGATACGCAGTATTTTGGCCCA		2
ACAGTGACCAGTGCCCATCCTGAAGACAGCAGCTTCTACATCTGCAGTGCCCGTATTGACCGCAATCAGCCCCAGCATTTTGGTGAT	CSARIDRNQPQHF	1
CAGCGCACACAGCAGGAGGACTCGGCCGTGTATCTCTGTGCCAGCAGCTTACCTAGCGGGAGAGCGGGTGAGCAGTTCTTCGGGCCA	CASSLPSGRAGEQFF	1
GCCATCCCCAACCAGACAGCTCTTTACTTCTGTGCCACCAGTGACCCTGCGACTAGCGGGAGAGGCAATGAGCAGTTCTTCGGGCCA	CATSDPATSGRGNEQFF	1
CACGCCCTGCAGCCAGAAGACTCAGCCCTGTATCTCTGCGCCAGCAGCCATGGGCGGGGTTCCGGGACTGAAGCTTTCTTTGGACAA	CASSHGRGSGTEAFF	1
GTGACCAGTGCCCATCCTGAAGACAGCAGCTTCTACATCTGCAGTGCGAAGGAAGGGGGGCAGATGGAGACCCAGTACTTCGGGCCA	CSAKEGGQMETQYF	1
GCTGCTCCCTCCCAAACATCTGTGTACTTCTGTGCCAGCAGAAATCCCTACTTCACAGGGGTAGGAGAGACCCAGTACTTCGGGCCA	CASRNPYFTGVGETQYF	1
GCACACAGCAGGAGGACTCGGCCGTGTATCTCTGTGCCAGCAGCTTATGTCCAGGTTTGCCCTAATGAAAAACTGTTTTTTGGCAGT		1
AGGCTGCTGTCGGCTGCTCCCTCCCAGACATCTGTGTACTTCTGTGCCAGCGGGCCGGGACAGGGGTATGAGCAGTACTTCGGGCCG	CASGPGQGYEQYF	1
CAGCGCACAGAGCAGGGGGACTCGGCCATGTATCTCTGTGCCAGCAGCTTATATGCCGGGGGCAACACTGAAGCTTTCTTTGGACAA	CASSLYAGGNTEAFF	1
GTGACCAGTGCCCATCCTGAAGACAGCAGCTTCTACATCTGCAGTGCTAGCGCGAGCGGGGGGCCAGATACGCAGTATTTTGGCCCA	CSASASGGPDTQYF	3
CCCTCAGAACCCAGGGACTCAGCTGTGTACTTCTGTGCCATTACTCTCGGGGGACACTCTGGGGCCAACGTCCTGACTTTCGGGGCC	CAITLGGHSGANVLTF	1
ACAGTGACCAGTGCCCATCCTGAAGACAGCAGCTTCTACATCTGCAGTGCTAGAAAAGTCCTAGCGTACGAGCAGTACTTCGGGCCA	CSARKVLAYEQYF	2
TCTGCTGTACCCTCTCAGACATCTGTGTACTTCTGTGCCAGCAGTGACATCAGGCGCCTTGGGGGTCAGCCCCAGCATTTTGGTGAT	CASSDIRRLGGQPQHF	1
ATCCAGCGCACACAGCAGGAGGACTCCGCCGTGTATCTCTGTGCCAGCAGCTTAAGCGGGTTCTCCTACGAGCAGTACTTCGGGCCG	CASSLSGFSYEQYF	1
CCAGAAGACTCGGCCCTGTATCTCTGCGCCAGCAGCCAAGAAGTTCGATTAGGACAGGGAAACACCGGGGAGCTGTTTTTTGGAGAA	CASSQEVRLGQGNTGELFF	1
CTGGCAATCCTGTCCTCAGAACCGGGAGACACGGCACTGTATCTCTGCGCCAGCAGTCGTGAGGATCGCGAGCAGTACTTCGGGCCG	CASSREDREQYF	2
CTGAGTTCTAAGAAGCTCCTTCTCAGTGACTCTGGCTTCTATCTCTGTGCCTGGAGCCGACAGGGCAATGAAGCTTTCTTTGGACAA	CAWSRQGNEAFF	1
CTGAAGATCCAGCCCTCAGAACCCAGGGACTCAGCTGTGTACTTCTGTGCCAGCAGTTCAGGGGCCGAGACCCAGTACTTCGGGCCA	CASSSGAETQYF	1
ACAGAGCAGGGGGACTCGGCCATGTATCTCTGTGCCAGCAGCCCGACTAGCGGGAGGTCGAACACCGGGGAGCTGTTTTTTGGAGAA	CASSPTSGRSNTGELFF	1
AGTCTGCCATCCCCAACCAGACAGCTCTTTACTTCTGTGCCACCACTCCGGCGGAGTCTAGCCAAAAACATTCAGTACTTCGGCGCC		1
TCCCAGACATCTGTGTACTTCTGTGCCAGCAGACAGACAGGGGGCGGGTTGCCCTGGGCTGGGGCCAACGTCCTGACTTTCGGGGCC	CASRQTGGGLPWAGANVLTF	1
GAGATGAATGTGAGCACCTTGGAGCTGGGGGACTCGGCCCTTTATCTTTGCGCCAGCAGCTCGTCATATGGCTACACCTTCGGTTCG	CASSSSYGYTF	1
ACACAGCAGGAGGACTCGGCCGTGTATCTCTGTGCCAGCAGCTTAATGCCTAGCGGGGTGAACACCGGGGAGCTGTTTTTTGGAGAA	CASSLMPSGVNTGELFF	1
CAGCGCACACAGCAGGAGGACTCGGCCGTGTATCTCTGTGCCAGCAGCACTAGCGGGAGCGTGGGCGGGGAGCTGTTTTTTGGAGAA	CASSTSGSVGGELFF	2
ATCCGGTCCACAAAGCTGGAGGACTCAGCCATGTACTTCTGTGCCAGCGGGTCTATAAGCTCCTACAATGAGCAGTTCTTCGGGCCA	CASGSISSYNEQFF	1
AGGCTGCTGTCGGCTGCTCCCTCCCAGACATCTGTGTACTTCTGTGCCAGCAGATTGGGTACCGCCCAAGGCTACACCTTCGGTTCG	CASRLGTAQGYTF	1
GAGTCGGCTGCTCCCTCCCAAACATCTGTGTACTTCTGTGCCAGCAGTGAACTAGCGGGGGACTACAATGAGCAGTTCTTCGGGCCA	CASSELAGDYNEQFF	1
AGCAACATGAGCCCTGAAGACAGCAGCATATATCTCTGCAGCCTAACCCCGGGACAGGGTTTGGACAATGAGCAGTTCTTCGGGCCA	CSLTPGQGLDNEQFF	2
CAGCCAGAAGACTCGGCCCTGTATCTCTGTGCCAGCAGCCAAGACTTCTCCCCCACCCAGGCGGGTAATGAGCAGTTCTTCGGGCCA	CASSQDFSPTQAGNEQFF	1
CTCAAGATCCAGCCTGCAGAGCTTGGGGACTCGGCCGTGTATCTCTGTGCCAGCAGCTCGGGCCCCAGGACCCAGTACTTCGGGCCA	CASSSGPRTQYF	7
CCCAGCCCCAACCAGACCTCTCTGTACTTCTGTGCCAGCAGTCGCACCCTGGACAGCTCTTACCAAGAGACCCAGTACTTCGGGCCA	CASSRTLDSSYQETQYF	1
AAGATCCAGCCCTCAGAACCCAGGGACTCAGCTGTGTACTTCTGTGCCAGCAGTCTGGACAGGGGCTATGGCTACACCTTCGGTTCG	CASSLDRGYGYTF	1
AAGGTGCAGCCTGCAGAACTGGAGGATTCTGGAGTTTATTTCTGTGCCAGCAGCCAAGCAGGGTCGGCGACGCAGTATTTTGGCCCA	CASSQAGSATQYF	1
CGCACACAGCAGGAGGACTCGGCCGTGTATCTCTGTGCCAGCAGCTTAGCGGTGACGGCATCTAGGGATGAGCAGTTCTTCGGGCCA	CASSLAVTASRDEQFF	1
GCTGCTCCCTCCCAAACATCTGTGTACTTCTGTGCCAGCATCCTATGATGTACGGTGTATAGCAATCAGCCCCAGCATTTTGGTGAT	CASIL*CTVYSNQPQHF	1
GAGTCCGCCAGCACCAACCAGACATCTATGTACCTCTGTGCCAGCAGGACCTCCGGGACAGGGGCGGGCGAGCAGTACTTCGGGCCG	CASRTSGTGAGEQYF	1
GCCCATCCTGAAGACAGCAGCTTCTACATCTGCAGTGCTAGAGCACACAGGGGTCGGGCGATGAACACTGAAGCTTTCTTTGGACAA	CSARAHRGRAMNTEAFF	1
CTCACTGTGACATCGGCCCAAAAGAACCCGACAGCTTTCTATCTCTGTGCCAGTAGTATGGGGATGCCTGGCTACACCTTCGGTTCG	CASSMGMPGYTF	1
ATCCTGAGGATCCAGCAGGTAGTGCGAGGAGATTCGGCAGCTTATTTCTGTGCCAGCTCACCACGCAGTGAAGCTTTCTTTGGACAA	CASSPRSEAFF	1
CAGCGCACACAGCAGGAGGACTCGGCCGTGTATCTCTGTGCCAGCAGCAAACACGCCCTCCTCGGAGAGACCCAGTACTTCGGGCCA	CASSKHALLGETQYF	1
GAGTCCGCCAGCACCAACCAGACATCTATGTACCTCTGTGCCAGCAGTAACCGAGGAGACTTCACAGATACGCAGTATTTTGGCCCA	CASSNRGDFTDTQYF	1
TCTGCCATCCCCAACCAGACAGCTCTTTACTTCTGTGCCACCAGTGATCCATCCAACCGGGGGACAGATACGCAGTATTTTGGCCCA	CATSDPSNRGTDTQYF	1
GAATTTCCCCCTGATCCTGGAGTCGCCCAGCCCCAACCAGACCTCTCTGTACTTCTGTGCCAGCAATTACAGGGCCTCTTCGGCGCC		1
GCCTGCAGAACTGGAGGATTCTGGAGTTTATTTCTGTGCCAGCAGCCAAGCATGCCCAGCTCCTACAATGAGCAGTTCTTCGGGCCA		1
AGTTCTAAGAAGCTCCTTCTCAGTGACTCTGGCTTCTATCTCTGTGCCTGGAGTCGGACAGGGGGGACGACCCAGTACTTCGGGCCA	CAWSRTGGTTQYF	6
ACAGTGACCAGTGCCCATCCTGAAGACAGCAGCTTCTACATCTGCAGTGTCCCGGGACAGGCCTCCTACGAGCAGTACTTCGGGCCG	CSVPGQASYEQYF	1
CAGCGCACACAGCAGGAGGACTCGGCCGTGTATCTCTGTGCCAGCAGTCCTCACAGGGGGCAAGGCTATGGCTACACCTTCGGTTCG	CASSPHRGQGYGYTF	1
ATCCAGCCTGCAAAGCTTGAGGACTCGGCCGTGTATCTCTGTGCCAGCAGCACGGGACAGTACAGCTACGAGCAGTACTTCGGGCCG	CASSTGQYSYEQYF	1
CTGCAGCCAGAAGACTCGGCCCTGTATCTCTGTGCCAGCAGCCAAGATGGCGCGGGGGCGGGCACAGATACGCAGTATTTTGGCCCA	CASSQDGAGAGTDTQYF	1
CTGATCCTGGAGTCGCCCAGCCCCAACCAGACCTCTCTGTACTTCTGTGCCAGCAGTTCACGCACAGATACGCAGTATTTTGGCCCA	CASSSRTDTQYF	1
CTCAGGCTGCTGTCGGCTGCTCCCTCCCAGACATCTGTGTACTTCTGTGCCAGCAGTTACCACGGGTCACCCCTCCACTTTGGGAAC	CASSYHGSPLHF	1
ACATCGGCCCAAAAGAACCCGACAGCTTTCTATCTCTGTGCCAGTAACACGGGACAGTCTGGGGCCAACGTCCTGACTTTCGGGGCC	CASNTGQSGANVLTF	1
CTGCTGTCGGCTGCTCCCTCCCAGACATCTGTGTACTTCTGTGCCAGCAGGGTTACAGGGGACGGAACTTCGCAGTTCTTCGGGCCA	CASRVTGDGTSQFF	1
AACGCCTTGTTGCTGGGGGACTCGGCCCTGTATCTCTGTGCCAGCAGCTTGATGGGGGGAGATACCGGGGAGCTGTTTTTTGGAGAA	CASSLMGGDTGELFF	2
GTGAGCAACATGAGCCCTGAAGACAGCAGCATATATCTCTGCAGCGTTGAAGAAAATGCAGGGGACACTGAAGCTTTCTTTGGACAA	CSVEENAGDTEAFF	1
CCTGTCCTCAGAACCGGGAGACACGGCACTGTATCTCTGCGCCAGCAGTCCTTGTAGACACCAAGCTATGGCTACACCTTCGGTTCG		1
AGTGCCCATCCTGAAGACAGCAGCTTCTACATCTGCAGTGCTATATCCCCTCGGGGGACACAAGGAAACACCATATATTTTGGAGAG	CSAISPRGTQGNTIYF	2
GAGTTGGCTGCTCCCTCCCAGACATCTGTGTACTTCTGTGCCAGCAGAAGGGGGACAGGGGGGACAGATACGCAGTATTTTGGCCCA	CASRRGTGGTDTQYF	1
ACGATCCAGCGCACACAGCAGGAGGACTCGGCCGTGTATCTCTGTGCCAGCAGCTTAGCTAGGGACACTGAAGCTTTCTTTGGACAA	CASSLARDTEAFF	2
CGCCTTGGAGCTGGACGACTCGGCCCTGTATCTCTGTGCCAGCAGCCGTCCCGGGACAGGTCGGGTGAAAAACTGTTTTTTGGCAGT		1
CTGACTGTGAGCAACATGAGCCCTGAAGACAGCAGCATATATCTCTGCAGCGCGTTCCGGGGTCAGAGGGAGCAGTACTTCGGGCCG	CSAFRGQREQYF	2
AGCAACGTGAGCCCTGAAGACAGCAGCATATATCTCTGCAGCGCAAGACAGGGGGAGGTAACTAATGAAAAACTGTTTTTTGGCAGT	CSARQGEVTNEKLFF	1
CTAGAGTCTGCCATCCCCAACCAGACAGCTCTTTACTTCTGTGCCACCAGTGAGGGACCCCCTAACTATGGCTACACCTTCGGTTCG	CATSEGPPNYGYTF	1
CTGCTGTCGGCTGCTCCCTCCCAGACATCTGTGTACTTCTGTGCCAGCAGTTACTCTCCCCTCAGCGGGAAGAGGTTCTTCGGGCCA	CASSYSPLSGKRFF	1
ACCAGTGCCCATCCTGAAGACAGCAGCTTCTACATCTGCAGTGCTAGAGATTGGGAGGGCCTACCAGATACGCAGTATTTTGGCCCA	CSARDWEGLPDTQYF	1
GCGCACAGAGCAGGGGGACTCAGCCGTGTATCTCCGTGCCAGCAGCTCGAAATGACAGAGACCACCGGGGAGCTGTTTTTTGGAGAA		1
CAGCGCACAGAGCAGCGGGACTCGGCCATGTATCGCTGTGCCAGCAGCCTAACTAGCGGGGGGGCGTATGAGCAGTTCTTCGGGCCA	CASSLTSGGAYEQFF	1
ACAGTGACCAGTGCCCATCCTGAAGACAGCAGCTTCTACATCTGCAGCTTAGCGGGAGCCTCCTACAATGAGCAGTTCTTCGGGCCA	CSLAGASYNEQFF	1
TTGGAGATCCAGCGCACAGAGCAGGGGGACTCGGCCATGTATCTCTGTGCCAGCAGCACAGGGATGGAGACCCAGTACTTCGGGCCA	CASSTGMETQYF	1
TGGAGCTGGGGGACTCGGCCCTGTATCTCTGTGCCAGAAGGAACGAACCCCCCGGGGGCTAGCACAGATACGCAGTATTTTGGCCCA		1
TGTGACATCGGCCCAAAAGAACCCGACAGCTTTCTATCTCTGTGCCAGACAGGCTGCAGGACAGGGTATGGCTACACCTTCGGTTCG		1
CTGCTGTCGGCTGCTCCCTCCCAGACATCTGTGTACTTCTGTGCCAGCAGTTACTCGATAGGGACAGATACGCAGTATTTTGGCCCA	CASSYSIGTDTQYF	1
GAGTCGGCTGCTCCCTCCCAGACATCTGTGTACTTCTGTGCCAGCAGGCCCGGACAGGGGGCTACCTACGAGCAGTACTTCGGGCCG	CASRPGQGATYEQYF	1
ACAGTGACCAGTGCCCATCCTGAAGACAGCAGCTTCTACATCTGCAGTGCTAGTAGGGACGGGGGGACTGAAGCTTTCTTTGGACAA	CSASRDGGTEAFF	1
GAGTTGGCTGCTCCCTCCCAGACATCTGTGTACTTCTGTGCCAGCAGTTACGACAGGTCGGGCAATCAGCCCCAGCATTTTGGTGAT	CASSYDRSGNQPQHF	1
GAGATCCAGCGCACAGAGCAGGGGGACTCGGCCATGTATCTCTGTGCCAGCAGCCCGGACCGGCCAGGGCCCCAGCATTTTGGTGAT	CASSPDRPGPQHF	1
AATTCCCTGGAGCTTGGTGACTCTGCTGTGTATTTCTGTGCCAGCAGCCGATTCTATACAGGGTTGGATACGCAGTATTTTGGCCCA	CASSRFYTGLDTQYF	1
CTGACAGTGACCAGTGCCCATCCTGAAGACAGCAGCTTCTACATCTGCAGTGCGTTAGCGGGAGAATACGAGCAGTACTTCGGGCCG	CSALAGEYEQYF	1
GCCCATCCTGAAGACAGCAGCTTCTACATCTGCAGTGCTAGAGGGGATAGGAGGCTGGGTAGCACAGATACGCAGTATTTTGGCCCA	CSARGDRRLGSTDTQYF	1
GGCGTCTGCTGTACCCTCTCAGACATCTGTGTACTTCTGTGCCAGCAGTGTGATAAGGGGACTTGGCGCGAGCAGTTCTTCGGGCCA		1
CAGCGCACAGAGCAGGGGGACTCGGCCATGTATCTCTGTGCCAGCAGTCCCCAGGGGCTTCGGTTGGATGAGCAGTTCTTCGGGCCA	CASSPQGLRLDEQFF	1
GTGAACGCCTTGGAGCTGGAGGACTCGGCCCTGTATCTCTGTGCCAGCAGCCCAAGACGGGGGAATCAGCCCCAGCATTTTGGTGAT	CASSPRRGNQPQHF	2
GTGAACGCCTTGTTGCTGGGGGACTCGGCCCTCTATCTCTGTGCCAGCAGCTTGGGACTAACGGGAGATACGCAGTATTTTGGCCCA	CASSLGLTGDTQYF	1
TTGGAGTCGGCTGCTCCCTCCCAAACATCTGTGTACTTCTGTGCCAGCAGTTACTTCTTGGACACCGGGGAGCTGTTTTTTGGAGAA	CASSYFLDTGELFF	1
TCAGAACCCAGGGACTCAGCTGTGTACTTCTGTGCCAGCAGTTTAGTGGGCAGGGGGGTCTCTGGAAACACCATATATTTTGGAGAG	CASSLVGRGVSGNTIYF	1
TCCTGAAGACAGCAGCTTCTACATCTGCAGTGCTAGTCTCTCTGGCCCGACAGGGGGAGCAGCAATCAGCCCCAGCATTTTGGTGAT		1
ACAGTGACCAGTGCCCATCCTGAAGACAGCAGCTTCTACATCTGCAGTCAGCGGGGGACTGGCACAGATACGCAGTATTTTGGCCCA	CSQRGTGTDTQYF	1
ATCCAGCAGGTAGTGCGAGGAGATTCGGCAGCTTATTTCTGTGCCAGCTCACCAAGTACACCGGATCAGCCCCAGCATTTTGGTGAT	CASSPSTPDQPQHF	1
TCGGCCCAAAAGAACCCGACAGCTTTCTATCTCTGTGCCAGTAGCTCGGATGCAGGGACGCCAGGCGGGGAGCTGTTTTTTGGAGAA	CASSSDAGTPGGELFF	1
CTGAGGATCCAGCAGGTAGTGCGAGGAGATTCGGCAGCTTATTTCTGTGCCAGCTCACCATATGCGGGAGGCTACACCTTCGGTTCG	CASSPYAGGYTF	2
ATCCAGCCCTCAGAACCCAGGGACTCAGCTGTGTACTTCTGTGCCAGCAGCGGACAGACGCTCAAGACCGAGCAGTACTTCGGGCCG	CASSGQTLKTEQYF	1
CAGCGCACAGAGCAGGGGGACTCGGCCATGTATCTCTGTGCCAGCAGCTCCCAGACAGGGGTGCCTTCCGAGCAGTACTTCGGGCCG	CASSSQTGVPSEQYF	1
ACGATCCAGCGCACACAGCAGGAGGACTCGGCCGTGTATCTCTGTGCCAGCAGCTTAGCGCGCGAAGAGACCCAGTACTTCGGGCCA	CASSLAREETQYF	3
ACCAGTGCCCATCCTGAAGACAGCAGCTTCTACATCTGCAGTGCTAGAGACCCCGGGACTTCCTACAATGAGCAGTTCTTCGGGCCA	CSARDPGTSYNEQFF	1
AGTCGGCTGCTCCCTCCCAAACATCTGTGTACTTCTGTGCCACCGAATACGACTAGCGGGAGGGCGGGTGAGCAGTTCTTCGGGCCA		2
CTGCTCCCTCCCAAACATCTGTGTACTTCTGTGCCAGCAGTGGGGGTAGCGGGAGGACGGGGAATAGAGACCCAGTACTTCGGGCCA		2
CTACACGCCCTGCAGCCAGAAGACTCAGCCCTGTATCTCTGCGCCAGCAGCCAAGGGGCGCGCGGTCCTGAAGCTTTCTTTGGACAA	CASSQGARGPEAFF	2
ACGATCCAGCGCACAGAGCAGCGGGACTCGGCCATGTATCGCTGTGCCAGCAGCCACGGGACAGCCTACGAGCAGTACTTCGGGCCG	CASSHGTAYEQYF	1
TCCCTGGAGCTTGGTGACTCTGCTGTGTATTTCTGTGCCAGCAGCTATGAGTGTCCCATTTCGTTAGACGAGCAGTACTTCGGGCCG	CASSYECPISLDEQYF	4
ATCCAGCGCACAGAGCAGGGGGACTCGGCCATGTATCTCTGTGCCAGCAGCTGGGGACTGACGAACACTGAAGCTTTCTTTGGACAA	CASSWGLTNTEAFF	1
GCCCATCCTGAAGACAGCAGCTTCTACATCTGCAGTGCTAGAGATCTCAGTCGGATGAGCTCCTACAATGAGCAGTTCTTCGGGCCA	CSARDLSRMSSYNEQFF	1
ACCAGTGCCCATCCTGAAGACAGCAGCTTCTACATCTGCAGTGCCGACCGGCGGGGGTCGGCATCCTACGAGCAGTACTTCGGGCCG	CSADRRGSASYEQYF	1
TCAGAACCCAGGGACTCAGCTGTGTATTTTTGTGCTAGTGGCCGTGGACAGGGCAGTTGGAAAGGCACTGAAGCTTTCTTTGGACAA	CASGRGQGSWKGTEAFF	1
ATTCTGGAGTCCGCCAGCACCAACCAGACATCTATGTACCTCTGTGCCAGCACCATGCCGGGAACCTACGAGCAGTACTTCGGGCCG	CASTMPGTYEQYF	1
ACTGTGACATCGGCCCAAAAGAACCCGACAGCTTTCTATCTCTGTGCCAGTAGTATAAGTGGGACGGATACGCAGTATTTTGGCCCA	CASSISGTDTQYF	1
CAGCAGGTAGTGCGAGGAGATTCGGCAGCTTATTTCTGTGCCAGCTCACCACCGATCATAGACAGCTATGGCTACACCTTCGGTTCG	CASSPPIIDSYGYTF	1
TCGGCTGCTCCCTCCCAGACATCTGTGTACTTCTGTGCCAGCAGACCCCTCCCAACAGGGAAGCAAGAGACCCAGTACTTCGGGCCA	CASRPLPTGKQETQYF	2
GCCAGCACCAACCAGACATCTATGTACCTCTGTGCCAGCAGCGCTCTAACACAGGGGAACAGGAACACTGAAGCTTTCTTTGGACAA	CASSALTQGNRNTEAFF	6
ACCTTGGAGCTGGGGGACTCGGCCCTTTATCTTTGCGCCAGCAGCGGTGGGACAGGGGGAACTAATGAAAAACTGTTTTTTGGCAGT	CASSGGTGGTNEKLFF	1
CAAAAGAACCCGACAGCTTTCTATCTCTGTGCCAGTAGTATCCCCCGGGATAGAGGGACTAAGGATCAGCCCCAGCATTTTGGTGAT	CASSIPRDRGTKDQPQHF	1
ATCCAGCAGGTAGTGCGAGGAGATTCGGCAGCTTATTTCTGTGCCAGCTCACCCGGGACAGGGAACACTGAAGCTTTCTTTGGACAA	CASSPGTGNTEAFF	2
CTGACCCTGGAGTCTGCCAGGCCTTCACATACCTCTCAGTACCTCTGTGCCAGCAGATATTACACAGATACGCAGTATTTTGGCCCA	CASRYYTDTQYF	1
AGTGACCAGTGCCCATCCTGAAGACAGCAGCTTCTACATCTGCAGTGCCATGGGGGGGGTGCCTTTTATGGCTACACCTTCGGTTCG		1
TCCGCCAGCACCAACCAGACATCTATGTACCTCTGTGCCAGCAGCTTCGTTGTGGGACAGAGCTCCTACGAGCAGTACTTCGGGCCG	CASSFVVGQSSYEQYF	1
ACTCTGACAGTGACCAGTGCCCATCCTGAAGACAGCAGCTTCTACATCTGCAGTGCTAGTAGAACCGGGGAGCTGTTTTTTGGAGAA	CSASRTGELFF	1
TGAGATGAATGTGAGCACCTTGGAGCTGGGGGACTCGGCCCTTTATCTTTGCGCCACCACTGAGTTGAGACCCAGTACTTCGGGCCA		1
GTGAGCAACATGAGCCCTGAAGACAGCAGCATATATCTCTGCAGCACCGGACAAGGGGCGGGAACAGAGACCCAGTACTTCGGGCCA	CSTGQGAGTETQYF	1
GATCCAGCCTGCAGAGCTTGGGGACTCGGCCGTGTATCTCTGTGCCAGCAGCCCCGACAGGGCGGTGAAAAACTGTTTTTTGGCAGT		1
CCTGCAAAGCTTGAGGACTCGGCCGTGTATCTCTGTGCCAGCAGCTTAGAAACCGGACTGGTTGCGAACATTCAGTACTTCGGCGCC	CASSLETGLVANIQYF	1
CCACGGAGTCAGGGGACACAGCACTGTATTTCTGTGCCAGCAGTTAGCGGGACCTACGGCGACACCGGGGAGCTGTTTTTTGGAGAA		2
TGGTCGCACTGCAGCAAGAAGACTCAGCTGCGTATCTCTGCACCAGCAGCCGCGGGTCCTCTCTACAATGAGCAGTTCTTCGGGCCA		1
TCGGCTGCTCCCTCCCAAACATCTGTGTACTTCTGTGCCCACACAACGGGCGGACAGGGTAGCAATCAGCCCCAGCATTTTGGTGAT	CAHTTGGQGSNQPQHF	1
GAGTCGCCCAGCCCCAACCAGACCTCTCTGTACTTCTGTGCCAGCGGGCGCGCGGGCGTAGCTAATGAAAAACTGTTTTTTGGCAGT	CASGRAGVANEKLFF	1
CCAGCGCACAGAGCAGGGGGACTCGGCCATGTATCTCTGTGCCAGCAGCCCTATCGGGACTACAACAATGAGCAGTTCTTCGGGCCA		1
AATGTGAACGCCTTGTTGCTGGGGGACTCGGCCCTCTATCTCTGTGCCAGCACCCCTTTGCGGGGTGAGACCCAGTACTTCGGGCCA	CASTPLRGETQYF	8
AGCACCTTGGAGCTGGGGGACTCGGCCCTTTATCTTTGCGCCAGCAGCCTTGGGTCAGGGGTGTATGAAAAACTGTTTTTTGGCAGT	CASSLGSGVYEKLFF	1
TCGGCCCAAAAGAACCCGACAGCTTTCTATCTCTGTGCCAGTAGTCCGAATACGTCGCGGGGGGGAAGAGGCTACACCTTCGGTTCG	CASSPNTSRGGRGYTF	1
TCAACTCTGACTGTGAGCAACATGAGCCCTGAAGACAGCAGCATATATCTCTGCAGCGGCCACAGCACTGAAGCTTTCTTTGGACAA	CSGHSTEAFF	2
GTGCCCATCCTGAAGACAGCAGCTTCTACATCTGCAGTGCTAGCGGGCTGACAGTGAGATTACTCCTACGAGCAGTACTTCGGGCCG		1
AAGAAGCTCCTTCTCAGTGACTCTGGCTTCTATCTCTGTGCCTGGAAGATCGGTGGCAGGCCCCGAGAGACCCAGTACTTCGGGCCA	CAWKIGGRPRETQYF	1
CACATCAATTCCCTGGAGCTTGGTGACTCTGCTGTGTATTTCTGTGCCAGCAGGGCCGGGACAGACACTGAAGCTTTCTTTGGACAA	CASRAGTDTEAFF	1
TCGGCTGCTCCCTCCCAGACATCTGTGTACTTCTGTGCCAGCAGTTCGTCGGGGGGGCTCCTCTCCTACGAGCAGTACTTCGGGCCG	CASSSSGGLLSYEQYF	2
CTCAGGCTGCTGTCGGCTGCTCCCTCCCAGACATCTGTGTACTTCTGCAAACCGGGCACGCCTGGAAACACCATATATTTTGGAGAG	CKPGTPGNTIYF	1
ATCCAGCGCACAGAGCAGGGGGACTCAGCCGCGTATCTCCGTGCCAGCAGCCAGACGGGACTCCGGCACGAGCAGTACTTCGGGCCG	RASSQTGLRHEQYF	2
ATCCAGCGCACACAGCAGGAGGACTCGGCCGTGTATCTCTGTGCCAGCAGTCGGGACAGAAGTACCTACGAGCAGTACTTCGGGCCG	CASSRDRSTYEQYF	1
CTGACGATCCAGCGCACACAGCAGGAGGACTCGGCCGTGTATCTCTGTGCCAGCAGCTTAGTTCCCTACGAGCAGTACTTCGGGCCG	CASSLVPYEQYF	1
TCCGCCAGCACCAACCAGACATCTATGTACCTCTGTGCCAGCAGCCCCGGGGGACTAGCGGTCACAGATACGCAGTATTTTGGCCCA	CASSPGGLAVTDTQYF	1
ACGATCCAGCGCACAGAGCAGGGGGACTCGGCCATGTATCTCTGTGCCAGCAGCGATTCGACATTGGCTGGCTACACCTTCGGTTCG	CASSDSTLAGYTF	1
TGGAGTCCGCCAGCACCAACCAGACATCTATGTACCTCTGTGCCAGCAGTTTTAGGGGGGAGCCCCTACGAGCAGTACTTCGGGCCG		1
GAGTCGGCTGCTCCCTCCCAAACATCTGTGTACTTCTGTGCCAGCAGTACTAGACCCGGGACAGGAAGGAAAGCTTTCTTTGGACAA	CASSTRPGTGRKAFF	1
CTCACTCTGGAGTCCGCTACCAGCTCCCAGACATCTGTGTACTTCTGTGCCATCAGTGAGTCGAGGGATACGCAGTATTTTGGCCCA	CAISESRDTQYF	4
AGGATCCAGCAGGTAGTGCGAGGAGATTCGGCAGCTTATTTCTGTGCCAGCTCACCTCAGGGGGCGCGTGGCTACACCTTCGGTTCG	CASSPQGARGYTF	1
AGGATCCAGCAGGTAGTGCGAGGAGATTCGGCAGCTTATTTCTGTGCCAGCTCACCTGACTGGGGTCAGCCCCAGCATTTTGGTGAT	CASSPDWGQPQHF	1
GCCCATCCTGAAGACAGCAGCTTCTACATCTGCAGTGCCTTGCCGGGACTAGCGGGGTACTCCTACAATGAGCAGTTCTTCGGGCCA	CSALPGLAGYSYNEQFF	1
CTGCTGTCGGCTGCTCCCTCCCAGACATCTGTGTACTTCTGTGCCAGCAGGTATCGGACAGGGGGTACTGAAGCTTTCTTTGGACAA	CASRYRTGGTEAFF	1
ATCCGGTCCACAAAGCTGGAGGACTCAGCCATGTACTTCTGTGCCAGCCAGCAGTACACTAGCACAGATACGCAGTATTTTGGCCCA	CASQQYTSTDTQYF	1
CTCTGGAGCTGGGGGACTCAGCTTTGTATTTCTGTGCCAGCAGCGTACCTAGCGGGAGGGTCCTACAATGAGCAGTTCTTCGGGCCA		1
TTGGAGTCGGCTGCTCCCTCCCAAACATCTGTGTACTTCTGTGCCAGCAGTTACCGGGGGAGCAATCAGCCCCAGCATTTTGGTGAT	CASSYRGSNQPQHF	1
ATCCAGCGCACAGAGCAGGGGGACTCGGCCATGTATCTCTGTGCCAGAACACTAGTGGGAAACACCGGGGAGCTGTTTTTTGGAGAA	CARTLVGNTGELFF	1
AAGATCCAGCCCTCAGAACCCAGGGACTCAGCTGTGTACTTCTGTGCCAGCAGTTTAGCGGCGAACACTGAAGCTTTCTTTGGACAA	CASSLAANTEAFF	1
ACATCGGCCCAAAAGAACCCGACAGCTTTCTATCTCTGTGCCAGTAGTAACCCCCGGAACAGCCTCTCTGGCTACACCTTCGGTTCG	CASSNPRNSLSGYTF	1
GCTCAGTCTGGAGTTGGCTGCTCACTCCCAGACATCTGTGTACTTCTGTGCCAGCAGTTACAGGGAGCTGAAGCTTTCTTTGGACAA		1
ACCAGTGCCCATCCTGAAGACAGCAGCTTCTACATCTGCAGTGCTAGTCGGGCGGGAGTAGCCAAAAACATTCAGTACTTCGGCGCC	CSASRAGVAKNIQYF	1
AGCTGGGGGACTCGGCCCTGTATCTCTGTGCCAGAAGTTTGCACCTGGGACTAGCGGGGGGGATCGGATGAGCAGTTCTTCGGGCCA		1
AGCACCTTGGAGCTGGGGGACTCGGCCCTCTATCTTTGCGCCAGCAGCTTAGCCCAGGGGATGAACACTGAAGCTTTCTTTGGACAA	CASSLAQGMNTEAFF	2
AGGCTGGAGTCGGCTGCTCCCTCCCAGACATCTGTGTACTTCTGTGCCAGCACTCGACAGGGGGCGCACGAGCAGTACTTCGGGCCG	CASTRQGAHEQYF	1
CTGTCGGCTGCTCCCTCCCAGACATCTGTGTACTTCTGTGCCAGCAGTTATGCTAGCGGGAGAAGTGGTGAGCAGTTCTTCGGGCCA	CASSYASGRSGEQFF	2
ATCCAGCGCACACAGCAGGAGGACTCGGCCGTGTATCTCTGTGCCAGCAGCTTAGCTAGCGGGGCCTACGAGCAGTACTTCGGGCCG	CASSLASGAYEQYF	1
GTGAACGCCTTGTTGCTGGGGGACTCGGCCCTGTATCTCTGTGCCAGCAGGCCTGACAGGGGCCCAAAGGGCTACACCTTCGGTTCG	CASRPDRGPKGYTF	7
GCTGCTCCCTCCCAGACATCTGTGTACTTCTGTGCCAGCAGTGAATGGGGAAGGGCTAGCGGGAGCGACGAGCAGTACTTCGGGCCG	CASSEWGRASGSDEQYF	1
CTCAGGCTGCTGTCGGCTGCTCCCTCCCAGACATCTGTGTACTTCTGTGCCAGCACCGCTAGGGACACTGAAGCTTTCTTTGGACAA	CASTARDTEAFF	1
GTCGGCTGCTCCCTCCCAAACATCTGTGTACTTCTGTGCCAGCAGCCCGAGACAGGGGGCTAGAGTCAGCCCCAGCATTTTGGTGAT		1
ACTGTGAGCAACATGAGCCCTGAAGACAGCAGCATATATCTCTGCAGCGTTTGGACAGGGGGCGGCCAGCCCCAGCATTTTGGTGAT	CSVWTGGGQPQHF	4
CTGGAGTCGCCCAGCCCCAACCAGACCTCTCTGTACTTCTGTGCCAGCAGAATGAGTAGCGGAGAGAGGGGGCAGTACTTCGGGCCG	CASRMSSGERGQYF	1
ATTCTGGAGTCCGCCAGCACCAACCAGACATCTATGTACCTCTGTGCCAGCAGCCCCCCGGGGAGCAATGAGCAGTTCTTCGGGCCA	CASSPPGSNEQFF	1
ACCAGTGCCCATCCTGAAGACAGCAGCTTCTACATCTGCAGTGCTAGAGACTTACCGGGACTCAAAGAGACCCAGTACTTCGGGCCA	CSARDLPGLKETQYF	1
GAGTCCGCCAGCACCAACCAGACATCTATGTACCTCTGTGCCAGCAGGGGTGGGGACAGCTCCGCAAGGCCCCAGCATTTTGGTGAT	CASRGGDSSARPQHF	1
CTGAGCTCTCTGGAGCTGGGGGACTCAGCTTTGTATTTCTGTGCCAGCAGCGTTTTGCGGTAGCGCAACATTCAGTACTTCGGCGCC	CASSVLR*RNIQYF	1
AATGTGAACGCCTTGTTGCTGGGGGACTCGGCCCTGTATCTCTGTGCCAGCAGCTGGCGCGCAGGGGACGAACAGTACTTCGGGCCG	CASSWRAGDEQYF	1
GTGAACGCCTTGTTGCTGGGGGACTCGGCCCTCTATCTCTGTGCCAGCAGCCGGACGGGGGGAGGCGAGACCCAGTACTTCGGGCCA	CASSRTGGGETQYF	1
GCTGCTCCCTCCCAGACATCTGTGTACTTCTGTGCCAGCAGTCCAGAAGCGGGACTACTCCACTCCTACGAGCAGTACTTCGGGCCA	CASSPEAGLLHSYEQYF	1
ATCCAGCGCACAGAGCAGGGGGACTCGGCCATGTATCTCTGTGCCAGCAGCCCCGAGCCGGGGGGGACTGAAGCTTTCTTTGGACAA	CASSPEPGGTEAFF	1
TGACATCGGCCCAAAAGAACCCGACAGCTTTCTATCTCTGTGCCATCCCGAACAGGGGGCGTGGAAGAGACCCAGTACTTCGGGCCA		1
AGGCTGGAGTCGGCTGCTCCCTCCCAGACATCTGTGTACTTCTGTGCCAGCAGTGAAGGGGCTGTCGGTGGCTACACCTTCGGTTCG	CASSEGAVGGYTF	1
ATTCTGGAGTCCGCCAGCACCAACCAGACATCTATGTACCTCTGTGCCAGCATGGGGGCGAAAGGGACTGAAGCTTTCTTTGGACAA	CASMGAKGTEAFF	1
CCGCTCAGGCTGGAGTTGGCTGCTCCCTCCCAGACATCTGTGTACTTCTGTGCCAGCAGTTATGACGCTGAAGCTTTCTTTGGACAA	CASSYDAEAFF	1
ATCCAGCAGGTAGTGCGAGGAGATTCGGCAGCTTATTTCTGTGCCAGCTCACCAGCCGGAAACAATCAGCCCCAGCATTTTGGTGAT	CASSPAGNNQPQHF	1
ACATCGGCCCAAAAGAACCCGACAGCTTTCTATCTCTGTGCCAGTACCGGAAGGACAGGGGGCACCTCACCCCTCCACTTTGGGAAC	CASTGRTGGTSPLHF	1
GAGCTTGGTGACTCTGCTGTGTATTTCTGTGCCAGCAGCCAAGATTCGCCTAGCGGGGGCCTTTACAATGAGCAGTTCTTCGGGCCA	CASSQDSPSGGLYNEQFF	1
GGTGCAGCCTGCAGAACTGGAGGATTCTGGAGTTTATTTCTGTGCCAGCAGCCCGACCGGTGGGGTCAGCCCCAGCATTTTGGTGAT		1
TGCTCCCTCCCAGACATCTGTGTACTTCTGTGCCAGCAGGGAAACCGGGACAGGTAACAGATTGGCTACGAGCAGTACTTCGGGCCG		1
ACAGTGACCAGTGCCCATCCTGAAGACAGCAGCTTCTACATCTGCAGTGCCCCGGGGAGGGGAGCCGGGGAGCTGTTTTTTGGAGAA	CSAPGRGAGELFF	3
AGGATCCAGCAGGTAGTGCGAGGAGATTCGGCAGCTTATTTCTGTGCCAGCTCAGTGGGGGACTCCTACGTCTACACCTTCGGTTCG	CASSVGDSYVYTF	2
CGCCCAGCCCCAACCAGACCTCTCTGTACTTCTGTGCCAGCAGCCCTTATCCGGGACAGGGGGCACTACGAGCAGTACTTCGGGCCG		1
CTGGGGTTGGAGTCGGCTGCTCCCTCCCAAACATCTGTGTACTTCTGTGCCAGCAGTTACGAAAGAAGGCCCCAGCATTTTGGTGAT	CASSYERRPQHF	1
TCCACAAAGCTGGAGGACTCAGCCATGTACTTCTGTGCCAGCAGTTCCACAGGGCTGGGGATGAACACTGAAGCTTTCTTTGGACAA	CASSSTGLGMNTEAFF	1
GCCAGCACCAACCAGACATCTATGTACCTCTGTGCCAGCAGTTCAAACAGGCTAGCGGCTCGCACAGATACGCAGTATTTTGGCCCA	CASSSNRLAARTDTQYF	1
GTGACCAGTGCCCATCCTGAAGACAGCAGCTTCTACATCTGCAGTGCCCCCACGGCGGTAAGCAATCAGCCCCAGCATTTTGGTGAT	CSAPTAVSNQPQHF	1
CTGACAGTGACCAGTGCCCATCCTGAAGACAGCAGCTTCTACATCTGCAGTGCCAGAAGATCTAATCAGCCCCAGCATTTTGGTGAT	CSARRSNQPQHF	1
ACTCTCAAGATCCAGCCTGCAGAGCTTGGGGACTCGGCCGTGTATCTCTGTGCCAGCAGTCTTGGACAGGGCCCGTTCTTCGGGCCA	CASSLGQGPFF	1
GAGCAGGGGGACTCGGCCATGTATCTCTGTGCCAGCAGCTTAGAACGTCCGACAGGGGGGTCCAACTATGGCTACACCTTCGGTTCG	CASSLERPTGGSNYGYTF	1
ATCCAGCGCACACAGCAGGAGGACTCGGCCGTGTATCTCTGTGCCAGCAGCTTAGCACAGGGGAGGGAGACCCAGTACTTCGGGCCA	CASSLAQGRETQYF	1
CACCTACACACCCTGCAGCCAGAAGACTCGGCCCTGTATCTCTGTGCCAGCAGCCAGGACGCACTCCGCGGTCCGTACTTCGGGCCG	CASSQDALRGPYF	1
CATCCCCAACCAGACAGCTCTTTACTTCTGTGCCACCAGTGTCGGGGAATCATATACGCAACTAATGAAAAACTGTTTTTTGGCAGT		1
CTGGAGTTGGCTGCTCCCTCCCAGACATCTGTGTACTTCTGTGCCAGCAGCCCACGGGGCGGGGGTTTGGGCTACACCTTCGGTTCG	CASSPRGGGLGYTF	1
ATCCAGCCTGCAGAGCTTGGGGACTCGGCCGTGTATCTCTGTGCCAGCAGCCTCCCGACAGGGGCAGAGACCCAGTACTTCGGGCCA	CASSLPTGAETQYF	1
GAGTCGCCCAGCCCCAACCAGACCTCTCTGTACTTCTGTGCCAGCAAAACCGGACTAGCAGTTTACAATGAGCAGTTCTTCGGGCCA	CASKTGLAVYNEQFF	1
GTGACCAGTGCCCATCCTGAAGACAGCAGCTTCTACATCTGCAGTGCTAGGGGTTCAGGGAGAGCGGGTGGCTACACCTTCGGTTCG	CSARGSGRAGGYTF	1
CTTCACATCAATTCCCTGGAGCTTGGTGACTCTGCTGTGTATTTCTGTGCCAGCAGCCAAGTTAGGGAGGGCTACACCTTCGGTTCG	CASSQVREGYTF	1
GCAGCCTGCAGAACTGGAGGATTCTGGAGTTTATTTCTGTGCCAGCACCAAGATGGGGTAGAGTATGAAAAACTGTTTTTTGGCAGT		1
AGGCTGGAGTTGGCTGCTCCCTCCCAGACATCTGTGTACTTCTGTGCCAGCAGTCGACAGACCACCGGGGAGCTGTTTTTTGGAGAA	CASSRQTTGELFF	1
CTGATCCTGGAGTCGCCCAGCCCCAACCAGACCTCTCTGTACTTCTGTGCCAGCAGAGACAGGGGGCATGGCTACACCTTCGGTTCG	CASRDRGHGYTF	2
ACTGTGAGCAACATGAGCCCTGAAGACAGCAGCATATATCTCTGCAGCGTTGAAAGTCAGAAAAACACTGAAGCTTTCTTTGGACAA	CSVESQKNTEAFF	1
GTGACCAGTGCCCATCCTGAAGACAGCAGCTTCTACATCTGCAGTGCTAGTATAATAGGAATGAACACTGAAGCTTTCTTTGGACAA	CSASIIGMNTEAFF	3
CTGGAGTCTGCTGCCTCCTCCCAGACATCTGTATATTTCTGCGCCAGCAGTGAGACGCGGACAGGCGGGGAGCTGTTTTTTGGAGAA	CASSETRTGGELFF	1
GTGAACGCCTTGTTGCTGGGGGACTCGGCCCTGTATCTCTGTGCCAGCAGCTTGGATTCAGGGTGGGGGGAGCAGTTCTTCGGGCCA	CASSLDSGWGEQFF	3
CATCAATTCCCTGGAGCTTGGTGACTCTGCTGTGTATTTCTGTGCCAGCAGCTAAAGGGACCGTACGAAAAACTGTTTTTTGGCAGT		1
GTGACCAGTGCCCATCCTGAAGACAGCAGCTTCTACATCTGCAGTGCTATAATCGGGAGGGGGACCTACGAGCAGTACTTCGGGCCG	CSAIIGRGTYEQYF	1
GCTGCTCCCTCCCAGACATCTGTGTACTTCTGTGCCAGCAGTGAATCGGTAGGGGGGCACGGCTACAATGAGCAGTTCTTCGGGCCA	CASSESVGGHGYNEQFF	1
ACATCGGCCCAAAAGAACCCGACAGCTTTCTATCTCTGTGCCAGTAGTACCGAATCGACCCCTCGGGATGAGCAGTTCTTCGGGCCA	CASSTESTPRDEQFF	1
ATCCTGAGTTCTAAGAAGCTCCTTCTCAGTGACTCTGGCTTCTATCTCTGTGCCTGGAGTGTAGGCGGTGAAGCTTTCTTTGGACAA	CAWSVGGEAFF	1
CCAGTCCACGGAGTCAGGGGACACAGCACTGTATTTCTGTGCCAGCAGCAAAGTAGGGTTTTGGCCTACGAGCAGTACTTCGGGCCG		1
CTGAAGATCCAGCCCTCAGAACCCAGGGACTCAGCTGTGTATTTTTGTGCTAGTGGTTTTGAAGGCCCTGAGCAGTTCTTCGGGCCA	CASGFEGPEQFF	1
CAGCCTGCAGAGCTTGGGGACTCGGCCGTGTATCTCTGTGCCAGCAGCAAGGGACAGGGGTTGGAAGAGACCCAGTACTTCGGGCCA	CASSKGQGLEETQYF	1
CGGTCCACAAAGCTGGAGGACTCAGCCATGTACTTCTGTGCCAGCAGTGATAAGGAAGGAGGGCTCTACGAGCAGTACTTCGGGCCG	CASSDKEGGLYEQYF	1
TGAGCTCCTTGGAGCTGGGGGACTCAGCCCTGTACTTCTGTGCCAGCCCCGGGACACGAGAGCTCCTACGAGCAGTACTTCGGGCCA		1
CTACACGCCCTGCAGCCAGAAGACTCAGCCCTGTATCTCTGCGCCAGCAGCCAAGTGTGGGGGCGGGCTGAAGCTTTCTTTGGACAA	CASSQVWGRAEAFF	1
AATGTGAACGCCTTGGAGCTGGACGACTCGGCCCTGTATCTCTGTGCCAGCAGCTTCCGGACAGAAGAGACCCAGTACTTCGGGCCA	CASSFRTEETQYF	1
CTAGAGTCTGCCATCCCCAACCAGACAGCTCTTTACTTCTGTGCCACCAGTGATTCCATAACTGGAAACACCATATATTTTGGAGAG	CATSDSITGNTIYF	1
GTGAGCAACATGAGCCCTGAAGACAGCAGCATATATCTCTGCAGCGTTGCGAGGGGAGGGAACACCGGGGAGCTGTTTTTTGGAGAA	CSVARGGNTGELFF	3
TCCACGGAGTCAGGGGACACAGCACTGTATTTCTGTGCCAGCAGCAAAGGAGGACTAGCGGGAGGACGTGAGCAGTTCTTCGGGCCA	CASSKGGLAGGREQFF	2
CTAGAGTCTGCCATCCCCAACCAGACAGCTCTTTACTTCTGTGCCACCAGTCACACTAGCGGGAAGAATGAGCAGTTCTTCGGGCCA	CATSHTSGKNEQFF	1
TAGAGTCTGCCATCCCCAACCAGACAGCTCTTTACTTCTGTGCCACCCCTCGGACTAGGAAGCACCGGGGAGCTGTTTTTTGGAGAA		1
CAGGTAGTGCGAGGAGATTCGGCAGCTTATTTCTGTGCCAGCTCCGACGAGGAGGGAGTGGGCACAGATACGCAGTATTTTGGCCCA	CASSDEEGVGTDTQYF	1
GTGACATCGGCCCAAAAGAACCCGACAGCTTTCTATCTCTGTGCCACGTCGACAGGGGCAATTGGAAACACCATATATTTTGGAGAG	CATSTGAIGNTIYF	2
GTGAACGCCTTGTTGCTGGGGGACTCGGCCCTCTATCTCTGTGCCAGCAGCTCGGCGACAGGGCACTACGAGCAGTACTTCGGGCCG	CASSSATGHYEQYF	1
CAGCGCACAGAGCAGCGGGACTCGGCCATGTATCGCTGTGCCAGCAGCCCGGGGGCGGGTGGGTCTTACGAGCAGTACTTCGGGCCG	CASSPGAGGSYEQYF	1
TCGGCCCAAAAGAACCCGACAGCTTTCTATCTCTGTGCCAGTAAGGCCCAGGGACAGGACCACACAGATACGCAGTATTTTGGCCCA	CASKAQGQDHTDTQYF	1
AATGTGAACGCCTTGGAGCTGGACGACTCGGCCCTGTATCTCTGTGCCAGCAGCTTGGAACGATACAATGAGCAGTTCTTCGGGCCA	CASSLERYNEQFF	1
CTGAAGGTGCAGCCTGCAGAACTGGAGGATTCTGGAGTTTATTTCTGTGCCAGCAGCCAAGATAATCGCGGCTACACCTTCGGTTCG	CASSQDNRGYTF	1
ATTCTCAACTCTGACTGTGAGCAACATGAGCCCTGAAGACAGCAGCATATATCTCTGCAGCGTACCGGGGAGCTGTTTTTTGGAGAA		1
GTGAGCACCTTGGAGCTGGGGGACTCGGCCCTTTATCTTTGCGCCAGCAGCTGGCTTCCGGACAACTACGAGCAGTACTTCGGGCCG	CASSWLPDNYEQYF	1
CTTGACATCCGCTCACCAGGCCTGGGGGACGCAGCCATGTACCTGTGTGCCACCAGCATATGGCCAGATACGCAGTATTTTGGCCCA	CATSIWPDTQYF	1
ACATCGGCCCAAAAGAACCCGACAGCTTTCTATCTCTGTGCCAGTACCGCGGGACAGGTATCTGGAAACACCATATATTTTGGAGAG	CASTAGQVSGNTIYF	1
AATGTGAACGCCTTGTTGCTGGGGGACTCGGCCCTGTATCTCTGTGCCAGCAGGATTTACTCCTACAATGAGCAGTTCTTCGGGCCA	CASRIYSYNEQFF	2
AGGCTGGAGTCGGCTGCTCCCTCCCAGACATCTGTGTACTTCTGTGCCAGCAGTGAAATTAGTATCACTGAAGCTTTCTTTGGACAA	CASSEISITEAFF	2
CTGTCGGCTGCTCCCTCCCAGACATCTGTGTACTTCTGTGCCAGCAGTTTCGGACAGGGTATCGGCGGGGAGCTGTTTTTTGGAGAA	CASSFGQGIGGELFF	1
AAGGTGCAGCCTGCAGAACTGGAGGATTCTGGAGTTTATTTCTGTGCCAGCAGCCCTTTTGAGGGCACTGAAGCTTTCTTTGGACAA	CASSPFEGTEAFF	1
ACCTTGGAGCTGGGGGACTCGGCCCTTTATCTTTGCGCCAGCAGCTTGCAGGTAGCGGGGGGCATGGAGACCCAGTACTTCGGGCCA	CASSLQVAGGMETQYF	2
CTGGAGTCGGCTGCTCCCTCCCAGACATCTGTGTACTTCTGTGCCAGCAGGGGACTAGCGAACACCGGGGAGCTGTTTTTTGGAGAA	CASRGLANTGELFF	1
GAGTCGGCTGCTCCCTCCCAAACATCTGTGTACTTCTGTGCCAGCAGTCGCGGGACTAGCGGGAGACATGAGCAGTTCTTCGGGCCA	CASSRGTSGRHEQFF	1
AGGATCCAGCAGGTAGTGCGAGGAGATTCGGCAGCTTATTTCTGTGCCAGCTCCACGGGGGGCTACGCTGAAGCTTTCTTTGGACAA	CASSTGGYAEAFF	1
ATCCAGCGCACAGAGCAGGGGGACTCGGCCATGTATCTCTGTGCCAGCAGCTTAGCCCGCGAAGCCTACGAGCAGTACTTCGGGCCG	CASSLAREAYEQYF	1
GCTACCCGCTCCCAGACATCTGTGTATTTCTGCGCCAGCAGTGAGGACTAGCGGGAGGAGAAGAACAATGAGCAGTTCTTCGGGCCA	CASSED*REEKNNEQFF	3
AAGATCCAGCCCTCAGAACCCAGGGACTCAGCTGTGTATTTTTGTGCTAGTGGTAGACAGGGGGACCAGCCCCAGCATTTTGGTGAT	CASGRQGDQPQHF	1
TCGGCCCAAAAGAACCCGACAGCTTTCTATCTCTGTGCCAGTAGATTGGACTAGATTCAGTGGGATCATGAGCAGTTCTTCGGGCCA	CASRLD*IQWDHEQFF	1
ACAGTGACCAGTGCCCATCCTGAAGACAGCAGCTTCTACATCTGCAGTGCCCAAGGGACTAGCTCCCACGAGCAGTACTTCGGGCCG	CSAQGTSSHEQYF	19
CTGCAGAACTGGAGGATTCTGGAGTTTATTTCTGTGCCAGTTGACCTGTGGGGCAGCCTTTATGGGTACGAGCAGTACTTCGGGCCG		1
CTGACAGTGACCAGTGCCCATCCTGAAGACAGCAGCTTCTACATCTGCAGTGTCAGCCGGAACACCGGGGAGCTGTTTTTTGGAGAA	CSVSRNTGELFF	1
AACATGAGCCCTGAAGACAGCAGCATATATCTCTGCAGCGTTGAGGTAGATGGGAGGTCAATCTCCTACGAGCAGTACTTCGGGCCG	CSVEVDGRSISYEQYF	1
AATTCCCTGGAGCTTGGTGACTCTGCTGTGTATTTCTGTGCCAGCAGCCGGACAGGGGGCCTAGGTTCACCCCTCCACTTTGGGAAC	CASSRTGGLGSPLHF	1
CAAAGCTGGAGGACTCAGCCATGTACTTCTGTGCCAGCAGTGAAAAGCCCCCAGGGCAGGGCGCCAGATACGCAGTATTTTGGCCCA		1
ATCAATTCCCTGGAGCTTGGTGACTCTGCTGTGTATTTCTGTGCCAGCAGCCAACTACCGTTGAACACTGAAGCTTTCTTTGGACAA	CASSQLPLNTEAFF	2
CAGGTAGTGCGAGGAGATTCGGCAGCTTATTTCTGTGCCAGCTCACAGACCGGGACAGGGGGCTTAAATGAGCAGTTCTTCGGGCCA	CASSQTGTGGLNEQFF	1
GAGTTGGCTGCTCCCTCCCAGACATCTGTGTACTTCTGTGCCAGCAGCGCACTCGAGGGGGCGGGCTACGAGCAGTACTTCGGGCCG	CASSALEGAGYEQYF	1
AATCTTCACATCAATTCCCTGGAGCTTGGTGACTCTGCTGTGTATTTCTGTGCCAGCGGTGTCGGTTACGAGCAGTACTTCGGGCCG	CASGVGYEQYF	1
AAGGTGCAGCCTGCAGAACTGGAGGATTCTGGAGTTTATTTCTGTGCCAGCAGCCTACTAGGGGCGTACGAGCAGTACTTCGGGCCG	CASSLLGAYEQYF	1
GCGCACACAGCAGGAGGACTCGGCCGTGTATCTCTGTGCCAGCAGCACACGAGGGGGGTAAGCAATCAGCCCCAGCATTTTGGTGAT		1
CTGGAGTCGGCTGCTCCCTCCCAGACATCTGTGTACTTCTGTGCCACCCTTACGGACTTTCCCCTCTATGGCTACACCTTCGGTTCG	CATLTDFPLYGYTF	1
TCGGCTGCTCCCTCCCAGACATCTGTGTACTTCTGTGCCAGCAGTTACTCGTTTACAGGATTCACCTACGAGCAGTACTTCGGGCCG	CASSYSFTGFTYEQYF	1
CTAAACCTGAGCTCTCTGGAGCTGGGGGACTCAGCTTTGTATTTCTGTGCCAGCAGGGGTATGGGGGAGACCCAGTACTTCGGGCCA	CASRGMGETQYF	1
CCTGCAGAGCTTGGGGACTCGGCCGTGTATCTCTGTGCCAGCAGCTTAAGGGTCGGGGGGAGCAGAAATGAGCAGTTCTTCGGGCCA	CASSLRVGGSRNEQFF	1
AACATGAGCCCTGAAGACAGCAGCATATATCTCTGCAGCGCCAAACCCTTCAGCGACCCTTTTGGGTACGAGCAGTACTTCGGGCCG	CSAKPFSDPFGYEQYF	1
ATCCAGCAGGTAGTGCGGGGAGATTCGGCAGCTTATTTCTGTGCCAGCTCACCCGGACAGGGCAATCAGCCCCAGCATTTTGGTGAT	CASSPGQGNQPQHF	1
ACAGAGCAGGGGGACTCGGCCATGTATCTCTGTGCCAGCAGCTTATTTTATTCTAGCGGGAGGGAAGATGAGCAGTTCTTCGGGCCA	CASSLFYSSGREDEQFF	1
GGAGTCAGGGGACACAGCACTGTATTTCTGTGCCAGCAGCAAGAAGCCTTCCCCGGGACAGAGAACACTGAAGCTTTCTTTGGACAA		1
ACAGTGACCAGTGCCCATCCTGAAGACAGCAGCTTCTACATCTGCAGTGCTAGGGATTTCTATAATTCACCCCTCCACTTTGGGAAC	CSARDFYNSPLHF	2
TGCTCCCTCCCAGACATCTGTGTACTTCTGTGCCAGCAACCCCGACGGAACGGCGGTGCGTAGGACTATGGCTACACCTTCGGTTCG		1
AAGCTTGAGGACTCGGCCGTGTATCTCTGTGCCAGCAGCTTAAGAACGGGACAGCCCCCGAACACCGGGGAGCTGTTTTTTGGAGAA	CASSLRTGQPPNTGELFF	1
TTTCCCCCTGATCCTGGAGTCGCCCAGCCCCAACCAGACCTCTCTGTACTTCTGTGCCAGCCCTCGGCGGGCTACACCTTCGGTTCG		1
CAGGCTGGAGTCGGCTGCTCCCTCCCACACATCTGTGTACTTCTGTGCCAGCTGGGGACAGGGGCTTCTGGCTACCCCTTCGGTTCG		1
AGGATCCAGCAGGTAGTGCGAGGAGATTCGGCAGCTTATTTCTGTGCCAGCTCACCGGGGGTGAGGGAGACCCAGTACTTCGGGCCA	CASSPGVRETQYF	1
GAGTCAGCTACCCGCTCCCAGACATCTGTGTATTTCTGCGCCAGCAGTGAAGTTTCTTCCCTTCGTCAGCCCCAGCATTTTGGTGAT	CASSEVSSLRQPQHF	1
AGCACCTTGGAGCTGGGGGACTCGGCCCTTTATCTTTGCGCCAGCAGCTTTGGGGATAGCATGAACACTGAAGCTTTCTTTGGACAA	CASSFGDSMNTEAFF	1
GTGACATCGGCCCAAAAGAACCCGACAGCTTTCTATCTCTGTGCCAGTAGTATACGGGGGTTAACCGGGGAGCTGTTTTTTGGAGAA	CASSIRGLTGELFF	1
ACTCTGACGATCCAGCGCACACAGCAGGAGGACTCGGCCGTGTATCTCTGTGCCAGCATCGATGGGGTCTTGGCTTTCTTTGGACAA	CASIDGVLAFF	1
ATCCAGCGCACACAGCAGGAGGACTCGGCCGTGTATCTCTGTGCCAGCAGTAGTACAGGGTGGGACACTGAAGCTTTCTTTGGACAA	CASSSTGWDTEAFF	1
GCCTTGGAGCTGGACGACTCGGCCCTGTATCTCTGTGCCAGCAGCGTCCGGGACAGGGGGCGCGGAACTGAAGCTTTCTTTGGACAA	CASSVRDRGRGTEAFF	1
CAGCGCACACAGCAGGAGGACTCCGCCGTGTATCTCTGTGCCAGCAGACTTAGCGGGAGGAGGGACAATGAGCAGTTCTTCGGGCCA	CASRLSGRRDNEQFF	1
CACGCCCTGCAGCCAGAAGACTCAGCCCTGTATCTCTGCGCCAGCAGCCAACGGGAGAACTCGGTCAATGAGCAGTTCTTCGGGCCA	CASSQRENSVNEQFF	1
GCCCTGCAGCCAGAAGACTCAGCCCTGTATCTCTGCGCCAGCAGCCAAGATCTTACGGGGGGTTACAATGAGCAGTTCTTCGGGCCA	CASSQDLTGGYNEQFF	1
TCGCTCAGGCTGGAGTCGGCTGCTCCCTCCCAGACATCTGTGTACTTCTGTGCCAGCAGGTCATTTACTGAAGCTTTCTTTGGACAA	CASRSFTEAFF	1
TGACGATCCAGCGCACAGAGCAGCGGGACTCGGCCATGTATCGCTGTGCCAGCAGCTTGGACCGGGAATACGCAGTATTTTGGCCCA		2
CTGAGGATCCAGCAGGTAGTGCGAGGAGATTCGGCAGCTTATTTCTGTGCCAGCTCACCGGGGGGCACCGAAGCTTTCTTTGGACAA	CASSPGGTEAFF	1
GGCCTGGGGGACGCAGCCATGTACCTGTGTGCCACCAGCTCGGACAGGGAGGGGTCAGGAGGGGCCAACGTCCTGACTTTCGGGGCC	CATSSDREGSGGANVLTF	1
AGCCCTGAAGACAGCAGCATATATCTCTGCAGCGTCCCCTCGTCCCCGTCTAGCGGGGGGGCGAATGGCGAGCAGTACTTCGGGCCG	CSVPSSPSSGGANGEQYF	1
CAGCGCACACAGCAGGAGGACTCGGCCGTGTATCTCTGTGCCAGCAGCTTTCTACAGGGCGGCACCGGGGAGCTGTTTTTTGGAGAA	CASSFLQGGTGELFF	1
AATGTGAGCACCTTGGAGCTGGGGGACTCGGCCCTTTATCTTTGCGCCAGCAGCTTGGCTGACAGGGGTGGCTACACCTTCGGTTCG	CASSLADRGGYTF	1
ACCAGTGCCCATCCTGAAGACAGCAGCTTCTACATCTGCAGTGCTAGCAATCCGGGACGGAGCACAGATACGCAGTATTTTGGCCCA	CSASNPGRSTDTQYF	1
CTGGGGTTGGAGTCGGCTGCTCCCTCCCAAACATCTGTGTACTTCTGTGCCAGCAGCCACAGGGTTCAGCCCCAGCATTTTGGTGAT	CASSHRVQPQHF	1
CTGTACCCTCTCAGACATCTGTGTACTTCTGTGCCAGCAGTGAATAGGGGGGCTAGCGGGAGAAACCCCGAGCAGTACTTCGGGCCG		1
AACCTGAGCTCTCTGGAGCTGGGGGACTCAGCTTTGTATTTCTGTGCCAGCAGCGTGGCCCCTCCGGCTGAAGCTTTCTTTGGACAA	CASSVAPPAEAFF	1
ATCCAGCAGGTAGTGCGAGGAGATTCGGCAGCTTATTTCTGTGCCAGCTCACTTAACCAGGGTTTCGACGAGCAGTACTTCGGGCCG	CASSLNQGFDEQYF	1
CAGCCTGCAGAACTGGAGGATTCTGGAGTTTATTTCTGTGCCAGCAGCCGCACACCGACAATGGGGGAAAAACTGTTTTTTGGCAGT	CASSRTPTMGEKLFF	1
ACTGTGAGCAACATGAGCCCTGAAGACAGCAGCATATATCTCTGCAGCGTTGAAATGGCGGCACAAGAGACCCAGTACTTCGGGCCA	CSVEMAAQETQYF	6
GAGTCGCCCAGCCCCAACCAGACCTCTCTGTACTTCTGTGCCAGCAGTCTCGCTGCGGACAGGGGCTACGAGCAGTACTTCGGGCCG	CASSLAADRGYEQYF	1
AGGCTGGAGTCGGCTGCTCCCTCCCAGACATCTGTGTACTTCTGTGCCAGCAGCTTACCGGGACGGACACCGAGGCACTTCGGGCCG	CASSLPGRTPRHF	1
CTGAGTTCTAAGAAGCTCCTTCTCAGTGACTCTGGCTTCTATCTCTGTGCCTGGAGTGTACATGGTTACGAGCAGTACTTCGGGCCG	CAWSVHGYEQYF	1
TCCAGCGCACAGAGCAGGGGGACTCGGCCATGTATCTCTGTGCCAGCAGCGAGGGAGGACCCGAATTAGCCCCAGCATTTTGGTGAT		1
TCCACAAAGCTGGAGGACTCAGCCATGTACTTCTGTGCCAGCAGCCGCGGTGAGGGGCGAGATCTTGATACGCAGTATTTTGGCCCA	CASSRGEGRDLDTQYF	1
GAGATCCAGCGCACAGAGCAGGGGGACTCGGCCATGTATCTCTGTGCCAGCACCCCCATACAGGGCGGAAAACTGTTTTTTGGCAGT	CASTPIQGGKLFF	1
GTGAGCACCTTGGAGCTGGGGGACTCGGCCCTTTATCTTTGCGCCAGCAGGGAGGGTACCACTAACTATGGCTACACCTTCGGTTCG	CASREGTTNYGYTF	1
CAGGTAGTGCGAGGAGATTCGGCAGCTTATTTCTGTGCCAGCTCACTAGGACTAGCGGTAAACACCGGGGAGCTGTTTTTTGGAGAA	CASSLGLAVNTGELFF	1
GCCCTGAAGACAGCAGCATATATCTCTGCAGCGTACCTGGGACTGCGATATCCACCCTCCTACTCCTACGAGCAGTACTTCGGGCCG		1
CAGCGGGACTCGGCCATGTATCGCTGTGCCAGCAGCTTAGATCCTGGGGCCGGACAGGGTACCACAGATACGCAGTATTTTGGCCCA	CASSLDPGAGQGTTDTQYF	2
CTGCTGGGGTTGGAGTCGGCTGCTCCCTCCCAAACATCTGTGTACTTCTGTGCCAGCGGTAGCGGGAGCGGGCAGTACTTCGGGCCG	CASGSGSGQYF	1
CTGCTGTCGGCTGCTCCCTCCCAGACATCTGTGTACTTCTGTGCCAGCAGTCGGGAATGGGGAAAAAATGGCTACACCTTCGGTTCG	CASSREWGKNGYTF	2
GTCTGCTGCCTCCTCCCAGACATCTGTATATTTCTGCGCCAGCAGAGACACCCTCCCAGCGGGAACTACGAGCAGTACTTCGGGCCA		1
CTTCACATCAATTCCCTGGAGCTTGGTGACTCTGCTGTGTATTTCTGTGCCAGCAGCCAAGGAGGTCGTAGCTACACCTTCGGTTCG	CASSQGGRSYTF	1
AATGTGAGCACCTTGGAGCTGGGGGACTCGGCCCTTTATCTTTGCGCCAGCGACCCGGGACAGGGAAATGGCTACACCTTCGGTTCG	CASDPGQGNGYTF	1
CTAAGAAGCTCCTCCTCAGTGACTCTGGCTTCTATCTCTGTGCCTGGACAGCGGGCACGGTACTACAATGAGCAGTTCTTCGGGCCA		1
GTGCAGCCTGCAGAACTGGAGGATTCTGGAGTTTATTTCTGTGCCAGCAGTGGGGACAGAGGCACAGATACGCAGTATTTTGGCCCA	CASSGDRGTDTQYF	1
CACTCTGACGATCCAGCGCACAGAGCAGCGGGACTCGGCCATGTATCGCTGTGCAACGGGGGGAACGACGGCTACACCTTCGGTTCG		3
AATGTGAACGCCTTGTTGCTGGGGGACTCGGCCCTCTATCTCTGTGCCAGCAGTCAGGACAGGGATTATGGCTACACCTTCGGTTCG	CASSQDRDYGYTF	1
CAGCAGGTAGTGCGAGGAGATTCGGCAGCTTATTTCTGTGCCAGCTCACAGAGCGGGTACTCCTACAATGAGCAGTTCTTCGGGCCA	CASSQSGYSYNEQFF	2
CTCAGGCTGGAGTCGGCTGCTCCCTCCCAGACATCTGTGTACTTCTGTGCCAGCAGTGAAAGCAGTTACGAGCAGTACTTCGGGCCG	CASSESSYEQYF	1
CTGTCGGCTGCTCCCTCCCAGACATCTGTGTACTTCTGTGCCAGCAGTTTCTCTCAGGGTTCTGGAAACACCATATATTTTGGAGAG	CASSFSQGSGNTIYF	1
TCCAGTCCACGGAGTCAGGGGACACAGCACTGTATTTCTGTGCCAGCAGCAAAGGGGTGTGGGGGGAATGAGCAGTTCTTCGGGCCA		1
GAGCTGGAGGACTCGGCCCTGTATCTCTGTGCCAGCAGCTTGGTTTACGGCCTAGCGGATTCCACAGATACGCAGTATTTTGGCCCA	CASSLVYGLADSTDTQYF	1
GAGTCCGCCAGCACCAACCAGACATCTATGTACCTCTGTGCCAGCAGTGTATCCGGGACTTTAACCTATGGCTACACCTTCGGTTCG	CASSVSGTLTYGYTF	1
CACTCTGAAGATCCAGCCCTCAGAACCCAGGGACTCAGCTGTGTACTTCTGTGCCATCGAGGCATAGACACCATATATTTTGGAGAG		1
GTGACATCGGCCCAAAAGAACCCGACAGCTTTCTATCTCTGTGCCAGTAGTCCTGTCCCCAACACCGGGGAGCTGTTTTTTGGAGAA	CASSPVPNTGELFF	1
AAGATCCAGCCCTCAGAACCCAGGGACTCAGCTGTGTACTTCTGTGCCAGCAGTTCCCAGTCAGGCTACGAGCAGTACTTCGGGCCG	CASSSQSGYEQYF	1
GGAGTCTGCTGCCTCCTCCCAGACATCTGTATATTTCTGCGCCAGCAGCGCTGACTAGTCGACACCGGGGAGCTGTTTTTTGGAGAA		1
TGCCAGGCCCTCACATACCTCTCAGTACCTCTGTGCCAGCAGTGAATCCGTGGGGACAGGGAGAACAATGAGCAGTTCTTCGGGCCA		1
ACTGTGACATCGGCCCAAAAGAACCCGACAGCTTTCTATCTCTGTGCCAGTAGGCGGATTGGGAACACTGAAGCTTTCTTTGGACAA	CASRRIGNTEAFF	5
ACTGTGAGCAACATGAGCCCTGAAGACAGCAGCATATATCTCTGCAGCGTGCTAGCGGGAGCTTCAAACATTCAGTACTTCGGCGCC	CSVLAGASNIQYF	1
AGCCCCAACCAGACCTCTCTGTACTTCTGTGCCAGCAGTTTAAGTGATCCGAGCCGATCTTCTAACTATGGCTACACCTTCGGTTCG	CASSLSDPSRSSNYGYTF	1
GAGTCCGCCAGCACCAACCAGACATCTATGTACCTCTGTGCCAGCACTAATCTGGGGACTAGCCAGTACGAGCAGTACTTCGGGCCG	CASTNLGTSQYEQYF	1
AGCCCTCTGGAGCTGGGGGACTCAGCTTTGTATTTCTGTGCCAGCAGCGTCGGAGCGGGAGGAACCTACGAGCAGTACTTCGGGCCG	CASSVGAGGTYEQYF	1
GAGATCCAGCGCACAGAGCAGGGGGACTCGGCCATGTATCTCTGTGCCAGCCAAAGGGGGGGCGGAGAGACCCAGTACTTCGGGCCA	CASQRGGGETQYF	1
AATCTTCACATCAATTCCCTGGAGCTTGGTGACTCTGCTGTGTATTTCTGTGCCAGCAGCCAAGTCGGGGAGCTGTTTTTTGGAGAA	CASSQVGELFF	1
ACGATCCAGCGCACGCAGCAGGAGGACTCGGCCGTGTATCTCTGTGCCAGCAGCTCATTTCGCACAGATACGCAGTATTTTGGCCCA	CASSSFRTDTQYF	1
ACTCTGGAGTCTGCTGCCTCCTCCCAGACATCTGTATATTTCTGCGCCAGCAGTGACCCGACAGGGACTGAAGCTTTCTTTGGACAA	CASSDPTGTEAFF	1
CAGGCTGGAGTCGGCTGCTCCCTCCCAGACATCTGTGTACTTCTGTGACAGCTGTGGACAGGGGCTTCTGGCTACACCTTCGGTTCG		1
AGGCTGGAGTCGGCTGCTCCCTCCCAAACATCTGTGTACTTCTGTGCCACCAAGCGGGACGCAACCTACGAGCAGTACTTCGGGCCG	CATKRDATYEQYF	1
CTGTCGGCTGCTCCCCCCCAGACATCTGTGTACTTCTGTGCCAGCAGTTACAATCCGGAGTCACCCACTGAAGCTTTCTTTGGACAA	CASSYNPESPTEAFF	1
CCTCTCACTGTGACATCGGCCCAAAAGAACCCGACAGCTTTCTATCTCTGTGCCAGTCGGACTAACTATGGCTACACCTTCGGTTCG	CASRTNYGYTF	1
AGCTCTCTGGAGCTGGGGGACTCAGCTTTGTATTTCTGTGCCAGCAGCGAGGGGGGGGGTAGAAGCCACGAGCAGTACTTCGGGCCG	CASSEGGGRSHEQYF	1
GGAGATCCAGCGCACAGAGCAGGGGGACTCGGCCATGTATCTCTGTGCCAGCAGCCTCGGGGACTTTGTGGCTACACCTTCGGTTCG		2
TCAGAACCCAGGGACTCAGCTGTGTACTTCTGTGCCAGCCGAACTGACAGGGGGCGTACAGGGGCCAACGTCCTGACTTTCGGGGCC	CASRTDRGRTGANVLTF	1
CTGGAGTCGGCTGCTCCCTCCCAGACATCTGTGTACTTCTGTGCCAGCAGGGGGGGCCTCTTTAATTCACCCCTCCACTTTGGGAAC	CASRGGLFNSPLHF	3
AGCTGGGGGACTCAGCTTTGTATTTCTGTGCCAGCAGCACCGACCGGGACTGACGTCTCTGGGGCCAACGTCCTGACTTTCGGGGCC		1
ATCCGGTCCACAAAGCTGGAGGACTCAGCCATGTACTTCTGTGCCAGCAGTGTGTCTCCGGGGAATCAGCCCCAGCATTTTGGTGAT	CASSVSPGNQPQHF	1
CATCGGCCCAAAAGAACCCGACAGCTTTCTATCTCTGTGCCAGAATCTAGCGGGGCCCCTAGCACAGATACGCAGTATTTTGGCCCA		1
ACATCGGCCCAAAAGAACCCGACAGCTTTCTATCTCTGTGCCAGTAGTATTCTAGGACAGGGCTTCTACGAGCAGTACTTCGGGCCG	CASSILGQGFYEQYF	6
CAGCGCACACAGCAGGAGGACTCGGCCGTGTATCTCTGTGCCAGCAGCTACGGGGGGGGCTGGGGAGATACGCAGTATTTTGGCCCA	CASSYGGGWGDTQYF	1
CCCTCAGAACCCAGGGACTCAGCTGTGTACTTCTGTGCCAGCAGCCCAGGGGGCGCTTTTCGTAGTCAGCCCCAGCATTTTGGTGAT	CASSPGGAFRSQPQHF	1
TCGGCCCAAAAGAACCCGACAGCTTTCTATCTCTGTGCCAGTAGGGTTTCCGGGACAGGTTTGACCTATGAGCAGTTCTTCGGGCCA	CASRVSGTGLTYEQFF	1
CCTGAAGACAGCAGCTTCTACATCTGCAGTGCTAGGGGGACTAGCGGGGGCCCACGCTCTGGGGCCAACGTCCTGACTTTCGGGGCC	CSARGTSGGPRSGANVLTF	1
TGACCAGTGCCCATCCTGAAGACAGCAGCTTCTACATCTGCAGTGCTTCCCTATCGCGGGAGTCTCCCCGAGCAGTACTTCGGGCCG		1
GTGCCCATCCTGAAGACAGCAGCTTCTACATCTGCAGTGCTTGGGCGACTAGCGGGAGGAAACACCGGGGAGCTGTTTTTTGGAGAA		1
TCGGCTGCTCCCTCCCAGACATCTGTGTACTTCTGTGCCAGCAGAAAGAGACTAGCGGGGGGCCAAGAGACCCAGTACTTCGGGCCA	CASRKRLAGGQETQYF	4
GAGTCGCCCAGCCCCAACCAGACCTCTCTGTACTTCTGTGCCAGCAGGACTGCACAGAACTCCTACAATGAGCAGTTCTTCGGGCCA	CASRTAQNSYNEQFF	1
TCGGCCCAAAAGAACCCGACAGCTTTCTATCTCTGTGCCAGTAGTAAGACAGGGGGCGTTGGCACCGGGGAGCTGTTTTTTGGAGAA	CASSKTGGVGTGELFF	1
TCCACTCTGACAGTGACCAGTGCCCATCCTGAAGACAGCAGCTTCTACATCTGCAGTGCCCAATCCAGCGTGCGGTACTTCGGCGCC	CSAQSSVRYF	1
AGCACCTTGGAGCTGGGGGACTCGGCCCTTTATCTTTGCGCCAGCAGCGATCCCGCCGGGACAGGTTCAAAACTGTTTTTTGGCAGT	CASSDPAGTGSKLFF	1
TGCTGTCGGCTGCTCCCTCCCAGACATCTGTGTACTTCTGTGCCAGCAGCTACAGACAGGGTGGACACTGAAGCTTTCTTTGGACAA		1
CAGCGCACACAGCAGGAGGACTCGGCCGTGTATCTCTGTGCCAGCAGTCACCAGAGCGGGAGACCCTACGAGCAGTACTTCGGGCCG	CASSHQSGRPYEQYF	1
CACAGCAGGAGGACTCGGCCGTGTATCTCTGTGCCAGCACCTACCCAGGAGAGCTACCCCGATAATTCACCCCTCCACTTTGGGAAC		1
GATCCAGCGCACAGAGCAGGGGGACTCAGCCGTGTATCTCCGTGCCAGCAGCTTATTAGGGGTAATGAAAAACTGTTTTTTGGCAGT		2
ATCCAGCGCACACAGCAGGAGGACTCGGCCGTGTATCTCTGTGCCAGCAGCTTAGCGGGACTCACAGATACGCAGTATTTTGGCCCA	CASSLAGLTDTQYF	1
ATCCAGCGCACACAGCAGGAGGACTCGGCCGTGTATCTCTGTGCCAGCACCCAGACTAGTTTTGACAATGAGCAGTTCTTCGGGCCA	CASTQTSFDNEQFF	2
CTGACTGTGAGCAACATGAGCCCTGAAGACAGCAGCATATATCTCTGCAGCGTTGGGGTCCCGAATGAAAAACTGTTTTTTGGCAGT	CSVGVPNEKLFF	1
CAGCAGGTAGTGCGAGGAGATTCGGCAGCTTATTTCTGTGCCAGCTCCTTCGGACAGGGAGGCTCCGGGGAGCTGTTTTTTGGAGAA	CASSFGQGGSGELFF	1
GTTCTAAGAAGCTCCTCCTCAGTGACTCTGGCTTCTATCTCTGTGTCCGAGTTAGGGACAAAGAATGAAAAACTGTTTTTTGGCAGT		1
CTGGAGGACTCAGCCATGTACTTCTGTGCCAGCACTCGGAGGGCACTAGCGGAAAGGAGCTCCTACAATGAGCAGTTCTTCGGGCCA	CASTRRALAERSSYNEQFF	1
CTGCTATCGGCTGCTCCCTCCCAGACATCTGTGTACTTCTGTGCCAGCAGCTCCCCGGGGATTAACTATGGCTACACCTTCGGTTCG	CASSSPGINYGYTF	1
CTGTACCCTCTCAGACATCTGTGTACTTCTGTGCCAGCAGTGACTCGATCCCCACGGGAGGGCCGACACGAGCAGTACTTCGGGCCG		1
AGCACCTTGGAGCTGGGGGACTCGGCCCTTTATCTTTGCGCCAGCAGCTTGGTACAGGGCTATTACAATGAGCAGTTCTTCGGGCCA	CASSLVQGYYNEQFF	1
AATTCCCTGGAGCTTGGTGACTCTGCTGTGTATTTCTGTGCCAGCAGCCAAGTTCGGAGCTCTGGAAACACCATATATTTTGGAGAG	CASSQVRSSGNTIYF	1
CTGGAGTCGGCTGCTCCCTCCCAGACATCTGTGTACTTCTGTGCCAGCAGAAGACTAGCGGAGAAGCACATTCAGTACTTCGGCGCC	CASRRLAEKHIQYF	1
CAGCCCTCAGAACCCAGGGACTCAGCTGTGTATTTTTGTGCTAGTGCCCCTGACAGGGGGATTGGCAATGAGCAGTTCTTCGGGCCA	CASAPDRGIGNEQFF	1
ACATCGGCCCAAAAGAACCCGACAGCTTTCCATCTCTGTGCCAGTAGTACCGAATCGACCCCTCGGGATGAGCAGTTCTTCGGGCCA	CASSTESTPRDEQFF	1
CTGGAGTCCGCCAGCACCAACCAGACATCTATGTACCTCTGTGCCAGCACCATAACAGGGGATCGCACTGAAGCTTTCTTTGGACAA	CASTITGDRTEAFF	1
GAGTCAGGGGACACAGCACTGTATTTCTGTGCCAGCATAGCAAGTCGACTAGCGGGGGCCTTTACCTGCGAGCAGTACTTCGGGCCG	CASIASRLAGAFTCEQYF	1
ATCCAGCCTGCAAAGCTTGAGGACTCGGCCGTGTATCTCTGTGCCAGCACCCAACGCCTGGACAGATACGAGCAGTACTTCGGGCCG	CASTQRLDRYEQYF	1
GTGAGTAACATGAGCCCTGAAGTCAGCAGCATATATCTCTGCAGCGTTGTGCTAAGGGGGCAGGACTATGGCTACACCTTCGGTTCG	CSVVLRGQDYGYTF	5
CCTGGAGTCGCCCAGCCCCAACCAGACCTCTCTGTACTTCTGTGCCAGTTGGGGGGGACTAGGGCCAATGAGCAGTTCTTCGGGCCA		1
GCTGCTCCCTCCCAGACATCTGTGTACTTCTGTGCCAGCAGTGAAGCGGTGACAGGGTCTATAGGCACTGAAGCTTTCTTTGGACAA	CASSEAVTGSIGTEAFF	1
TCACCAGGCCTGGGGGACGCAGCCATGTACCTGTGTGCCACCAGCAGAGGGTGGACTGTTACAAACACTGAAGCTTTCTTTGGACAA	CATSRGWTVTNTEAFF	1
TCGGCTGCTCCCTCCCAAACATCTGTGTACTTCTGTGCCAGCAGCCCGAGAGGGCTAGCGGGGGTCTACGAGCAGTACTTCGGGCCG	CASSPRGLAGVYEQYF	1
ATCCAACCTGCAAAGCTTGAGGACTCGGCCGTGTATCTCTGTGCCAGCGTAGACAGCCACTCTGGAAACACCATATATTTTGGAGAG	CASVDSHSGNTIYF	1
AATGTGAATGCCTTGGAGCTGGAGGACTCGGCCCTGTATCTCTGTGCCAGCAGCCTCTCTGGGGCCAACGTCCTGACTTTCGGGGCC	CASSLSGANVLTF	1
AACGCCTTGGAGCTGGTCGACTCGGCCCTGGATCTCCGTGCCAGCAGCCATTCGGGTGGGTTACTCTATGGCTACACCTTCGGTTCG	RASSHSGGLLYGYTF	1
GTGAACGCCTTGTTGCTGGGGGACTCGGCCCTCTATCTCTGTGCCAGCAGCTTGTCCGGCGGGGTGCAGCCCCAGCATTTTGGTGAT	CASSLSGGVQPQHF	2
GCCCATCCTGAAGACAGCAGCTTCTACATCTGCAGTGCTAGACTCTTCGGACTAGCGGGAGACACCGGGGAGCTGTTTTTTGGAGAA	CSARLFGLAGDTGELFF	1
AACCAGACCTCTCTGTACTTCTGTGCCAGCAGTTTGGGGAACCCCGGGACAGGAAGCTCCTATAATTCACCCCTCCACTTTGGGAAC	CASSLGNPGTGSSYNSPLHF	1
ACATCGGCCCAAAAGAACCCGACAGCTTTCTATCTCTGTGCCAGCAAGGCCGGGGGGTCCATGAACACTGAAGCTTTCTTTGGACAA	CASKAGGSMNTEAFF	1
GATTCAGCGCACAGAGCAGCGGGACTCAGCCATGTATCGCTGTGCCAGCAGCTCGGACAGGGTAAAAAGACCCAGTACTTCGGGCCA		1
CGCTCACCAGGCCTGGGGGACGCAGCCATGTACCTGTGTGCCACCAGCAGAGAGGACAGGTACAATCAGCCCCAGCATTTTGGTGAT	CATSREDRYNQPQHF	1
AGCGCACAGAGCAGGGGGACTCAGCCGCGTATCTCCGTGCCAGCAGCTTAAATCATTTCGGTTCAAGAGACCCAGTACTTCGGGCCA		1
GCCAGCACCAACCAGACATCTATGTACCTCTGTGCCAGCAGTTTAGGGCCCGGCGGCGGGATTATCTACGAGCAGTACTTCGGGCCG	CASSLGPGGGIIYEQYF	1
GTGAACGCCTTGGAGCTGGACGACTCGGCCCTTTATCTTTGCGCCAGCAGCTCTAAACAGGGGAACTATGGCTACACCTTCGGTTCG	CASSSKQGNYGYTF	1
ACTCTCAAGATCCAGCCTGCAGAGCTTGGGGACTCGGCCGTGTATCTCTGTGCCAGCCGAACCTTCTACGAGCAGTACTTCGGGCCG	CASRTFYEQYF	1
CAGCCCTCAGAACCCACGGACTCAGCTGTGTACTTCTGTGCCAGCAGTGCGGGGGGTCCGATCAGTGATTGCTACACCTTCGGTTCG	CASSAGGPISDCYTF	2
CCCTCCCAGACATCTGTGTACTTCTGTGCCAGCAGTTACGACCACCCGGCGGGGGGGACCTCCTACAATGAGCAGTTCTTCGGGCCA	CASSYDHPAGGTSYNEQFF	1
ACCAGTGCCCATCCTGAAGACAGCAGCTTCTACATCTGCAGTGCTAGTATCCGTACCCAGGTCACAGATACGCAGTATTTTGGCCCA	CSASIRTQVTDTQYF	1
CAGCCCTCAGAACCCAGGGACTCAGCTGTGTACTTCTGTGCCAGCAGTTCGCGGACTAGCCCTAATGAAAAACTGTTTTTTGGCAGT	CASSSRTSPNEKLFF	1
ATGAATGTGAGCACCTTGGAGCTGGGGGACTCGGCCCTTTATCTTTGCGCCAGCAGGGACCTGTTGTCTGAGCAGTTCTTCGGGCCA	CASRDLLSEQFF	1
ATCCAACCTGCAAAGCTTGAGGACTCGGCCGTGTATCTCTGTGCCAGCAGCTCGGGACAGGGGGCTACTGAAGCTTTCTTTGGACAA	CASSSGQGATEAFF	1
CTCCCAAACATCTGTGTACTTCTGTGCCAGCAGTTACGGGGGGACTAGCGGGAGAGGTCGGCCACCGGGGAGCTGTTTTTTGGAGAA		2
TCCACAAAGCTGGAGGACTCAGCCATGTACTTCTGTGCCAGCAGTGAAGTGGGAGGGACAGCCAACAATGAGCAGTTCTTCGGGCCA	CASSEVGGTANNEQFF	1
ACTCTCAAGATCCAGCCTGCAAAGCTTGAGGACTCGGCCGTGTATCTCTGTGCCAGCAGCTTAGAAGCAGAAGCTTTCTTTGGACAA	CASSLEAEAFF	1
GCCCTGCAGCCAGAAGACTCAGCCCTGTATCTCTGCGCCAGCAGCCAAGTGGACAGTAGCTCCTACAATGAGCAGTTCTTCGGGCCA	CASSQVDSSSYNEQFF	1
CTGATCCTGGAGTCGCCCAGCCCCAACCAGACCTCTCTGTACTTCTGTGCCAGCAGTCCTCAGGGTCAGCCCCAGCATTTTGGTGAT	CASSPQGQPQHF	1
TCCCTGGAGCTTGGTGACTCTGCTGTGTATTTCTGTGCCAGCAGCCAAGGTAGGTGCTAGCGGGGGGGAACGCAGTATTTTGGCCCA	CASSQGRC*RGGTQYF	1
CCGCTACCAGCTCCCAGACATCTGTGTACTTCTGTGCCATCCGAAAGACAGGGAATCCATCGGATCTATGGCTACACCTTCGGTTCG		1
CGGTCCACAAAGCTGGAGGACTCAGCCATGTACTTCTGTGCCAGCAGTGCACAGGGAGGAGGCGGTCAGCCCCAGCATTTTGGTGAT	CASSAQGGGGQPQHF	1
CATCCTGAAGACAGCAGCTTCTACATCTGCAGTGTTCTCCGGGCTAGCGGGGCGACAACAGCGGGGAATGAGCAGTTCTTCGGGCCA	CSVLRASGATTAGNEQFF	2
ATCCAGCGCACAGAGCAGGGGGACTCGGCCATGTATCTCTGTGCCAGCAGCTTAGTGGGCTTCGGGGAGACCCAGTACTTCGGGCCA	CASSLVGFGETQYF	1
CAATTCCCTGGAGCTTGGTGACTCTGCTGTGTATTTCTGTGCCAGCAGCCCAGAGGGGGAACCAATTCACCCCTCCACTTTGGGAAC		1
CTGACAGTGACCAGTGCCCATCCTGAAGACAGCAGCTTCTACATCTGCAGTGCTAGTCGCAGGAACACTGAAGCTTTCTTTGGACAA	CSASRRNTEAFF	1
GCCTTGGAGCTGGACGACTCGGCCCTGTATCTCTGTGCCAGCAGCCAAAGAGGGGGCCTAAGCACAGATACGCAGTATTTTGGCCCA	CASSQRGGLSTDTQYF	1
TTGCTGGGGGACTCGGCCCTCTATCTCTGTGCCAGCAGCTTGGAAGTTGACGCAATCCCGAGGGGAAACACCATATATTTTGGAGAG	CASSLEVDAIPRGNTIYF	1
ATCCAGCAGGTAGTGCGAGGAGATTCGGCAGCTTATTTCTGTGCCAGCCTCGGCGGGCAGCTTGAAAACATTCAGTACTTCGGCGCC	CASLGGQLENIQYF	1
TCTGCCATCCCCAACCAGACAGCTCTTTACTTCTGTGCCACCAGTGACGCCCAAGGACTTGGCACAGATACGCAGTATTTTGGCCCA	CATSDAQGLGTDTQYF	4
GCTCCCTCCCAAACATCTGTGTACTTCTGTGCCAGCAGACTTATAACCGGGACAGGTTACATGAACACTGAAGCTTTCTTTGGACAA	CASRLITGTGYMNTEAFF	1
GTGAACGCCTTGGAGCTGGAGGACTCGGCCCTGTATCTCTGTGCCAGCAGCCCACGGGACTTTCGGGAGACCCAGTACTTCGGGCCA	CASSPRDFRETQYF	1
ACTCTGGAGTCTGCTGCCTCCTCCCAGACATCTGTATATTTCTGCGCCAGCAGAGGAGTTCCCCCTGGAGAGCAGTACTTCGGGCCG	CASRGVPPGEQYF	1
GAGCTTGGTGACTCTGCTGTGTATTTCTGTGCCAGCAGCCAAGATAGAAGCCGGGATCCTTCCACAGATACGCAGTATTTTGGCCCA	CASSQDRSRDPSTDTQYF	1
CTCAAGATCCAGCCTGCAAAGCTTGAGGACTCGGCCGTGTATCTCTGTGCCAGCAGCTTAGTCGGGCAGCCCCAGCATTTTGGTGAT	CASSLVGQPQHF	1
GCCCATCCTGAAGACAGCAGCTTCTACATCTGCAGTGCTAGAGATTCAGTCAGCGGGAGTTACACCGGGGAGCTGTTTTTTGGAGAA	CSARDSVSGSYTGELFF	1
GTCTGCTGTACCCTCTCAGACATCTGTGTACTTCTGTGCCAGCAGTGCTCCTGGACAGGCAAAAATGAAAAACTGTTTTTTGGCAGT		1
ATCCAGCCTGCAAAGCTTGAGGACTCGGCCGTGTATCTCTGTGCCAGCAGATCGAACAGGGAACCCGGGGAGCTGTTTTTTGGAGAA	CASRSNREPGELFF	2
CAGCGCACAGAGCAGCGGGACTCGGCCATGTATCGCTGTGCCAGCAGCCCCGGAGCGGGTTCCTCCTACGAGCAGTACTTCGGGCCG	CASSPGAGSSYEQYF	1
ACTGTGACATCGGCCCAAAAGAACCCGACAGCTTTCTATCTCTGTGCCAGTAGTATTAGGGCCTCCTACGAGCAGTACTTCGGGCCG	CASSIRASYEQYF	1
TCGGCCCAAAAGAACCCGACAGCTTTCTATCTCTGTGCCAGTACCTACACCGAGGGGGCGAGGGGCCAGCCCCAGCATTTTGGTGAT	CASTYTEGARGQPQHF	1
TCTAAGAAGCTCCTTCTCAGTGACTCTGGCTTCTATCTCTGTGCCTGGACGACAGGTTCTGGGGCCAACGTCCTGACTTTCGGGGCC	CAWTTGSGANVLTF	1
TCCCTGATTCTGGAGTCCGCCAGCACCAACCAGACATCTATGTACCTCTGTGCCAGCAGGACAGGGGGCAGGGCTTTCTTTGGACAA	CASRTGGRAFF	1
CAGCGCACACAGCAGGAGGACTCCGCCGTGTATCTCTGTGCCAGCAGGAAAGTGGGACAATTGAACACTGAAGCTTTCTTTGGACAA	CASRKVGQLNTEAFF	2
AGCACCTTGGAGCTGGGGGACTCGGCCCTTTATCTTTGCGCCAGCACTCTACTAGCGGGGGCCAACAATGAGCAGTTCTTCGGGCCA	CASTLLAGANNEQFF	1
GTCTGCTGTACCCTCTCAGACATCTGTGTACTTCTGTGCCAGCAATTCCCCCTCGTTTAGCGGGAATACGAGCAGTACTTCGGGCCG		1
TCGGCTGCTCCCTCCCAGACATCTGTGTACTTCTGTGCCACTAGACCCGGAGGGACAGCATTCACCGGGGAGCTGTTTTTTGGAGAA	CATRPGGTAFTGELFF	1
GAGATCCAGCGCACAGAGCAGGGGGACTCGGCCATGTATCTCTGTGCCAGCAGCCCCCGGGTGAACACTGAAGCTTTCTTTGGACAA	CASSPRVNTEAFF	1
CAGCGCACAGAGCAGCGGGACTCAGCCATGTATCGCTGTGCCAGCAGCTTGGGGGGGCCGGGCACCGGGGAGCTGTTTTTTGGAGAA	CASSLGGPGTGELFF	1
CTGGAGCTTGGTGACTCTGCTGTGTATTTCTGTGCCAGCAGCCAAGATCTCTGATAGGGTATTATCAATGAGCAGTTCTTCGGGCCA	CASSQDL**GIINEQFF	1
ACTGTGACATCGGCCCAAAAGAACCCGACAGCTTTCTATCTCTGTGCCAGTAGTAAGGTGGCCACCGGGGAGCTGTTTTTTGGAGAA	CASSKVATGELFF	1
TCGGCTGCTCCCTCCCAGACATCTGTGTACTTCTGTGCCAGCAGTTACTCGGGACAGGGAAGTGGAAACACCATATATTTTGGAGAG	CASSYSGQGSGNTIYF	1
CTGCAGCCAGAAGACTCAGCCCTGTATCTCTGCGCCAGCAGCCAAGCAACCGGGACAGGGACAAATCAGCCCCAGCATTTTGGTGAT	CASSQATGTGTNQPQHF	1
AGCTCTCTGGAGCTGGGGGACTCAGCTTTGTATTTCTGTGCCAGCAGCTCCCGTTTGGGGCAGGGCCCTGAAGCTTTCTTTGGACAA	CASSSRLGQGPEAFF	1
TCGGCTGCTCCCTCCCAGACATCTGTGTACTTCTGTGCCAGCAGTGAATCACAGGGTTTAACCAAAAACATTCAGTACTTCGGCGCC	CASSESQGLTKNIQYF	1
CAGCCTGCAGAGCTTGGGGACTCGGCCGTGTATCTCTGTGCCAGCAGCTTTTCAGCGGGAGGGAACAATGAGCAGTTCTTCGGGCCA	CASSFSAGGNNEQFF	1
AGCACCTTGGAGCTGGGGGACTCGGCCCTTTATCTTTGCGCCAGCAGCTCGGACGTAAGCTCCTACAATGAGCAGTTCTTCGGGCCA	CASSSDVSSYNEQFF	2
CGCACACAGCAGGAGGACTCGGCCGTGTATCTCTGTGCCAGCAGCTTATCCCATCGTGTTGGCCGGGATACGCAGTATTTTGGCCCA	CASSLSHRVGRDTQYF	1
ATTCTGGAGTCCGCCAGCACCAACCAGACATCTATGTACCTCTGTGCCAGCAGTTCCTTACGAGCTGGGACCCAGTACTTCGGGCCA	CASSSLRAGTQYF	1
GAAGCTTGAGGATTCAGCAGTGTATTTTTGTGCCAGCAGATTAAAGGGGCAGGGAAGTCCTATAATTCACCCCTCCACTTTGGGAAC		1
ATCCAGCCCTCAGAACCCAGGGACTCAGCTGTGTACTTCTGTGCCAGCAGTTTATTACAGGCAAACACTGAAGCTTTCTTTGGACAA	CASSLLQANTEAFF	1
CAGCCCTCAGAACCCAGGGACTCAGCTGTGTACTTCTGTGCCAGCAGGCCCGCCCTAGCGGCCACAGATACGCAGTATTTTGGCCCA	CASRPALAATDTQYF	1
GAAGACAGCAGCTTCTACATCTGCAGTGCTAGAGATAGCAGAATTTGGGGGAACAGGGAGGTTTACGCTGAAGCTTTCTTTGGACAA	CSARDSRIWGNREVYAEAFF	1
CAGCGCACAGAGCAGGGGGACTCGGCCATGTATCTCTGTGCCAGCAGCTTAAAGGCGGGAACCCAAGAGACCCAGTACTTCGGGCCA	CASSLKAGTQETQYF	1
GGAGCTGGGGGACTCAGCTTTGTATTTCTGTGCCAGCTACCATCGGTACTCAAACAAAGCCGGGCCAACGTCCTGACTTTCGGGGCC		1
CTGCAGCCAGAAGACTCGGCCCTGTATCTCTGCGCCAGCAGCCAAGCCGGGACTAGCGGGAGCGCAGATACGCAGTATTTTGGCCCA	CASSQAGTSGSADTQYF	1
CGCACACAGCAGGAGGACTCCGCCGTGTATCTCTGTGCCAGCAGCTTAGGAAACAGGGGGCTCTTTGGTGAGCAGTTCTTCGGGCCA	CASSLGNRGLFGEQFF	3
ATCCAGCGCACACAGCAGGAGGACTCGGCCGTGTATCTCTGTGCCAGCAGCCCCGCGGGAGTTCGGGAGACCCAGTACTTCGGGCCA	CASSPAGVRETQYF	1
CTGAAGATCCAGCCCTCAGAACCCAGGGACTCAGCTGTGTATTTTTGTGCTAGTGGCCGAAACACCGGGGAGCTGTTTTTTGGAGAA	CASGRNTGELFF	1
GAGTCCGCCAGCACCAACCAGACATCTATGTACCTCTGTGCCAGCAGGTCGGGACAGGGTACGTCTCAGCCCCAGCATTTTGGTGAT	CASRSGQGTSQPQHF	1
CTGGAGTCCGCTACCAGCTCCCAGACATCTGTGTACTTCTGTGCCATCAGTGAGGGGCAGGGCCATGAAAAACTGTTTTTTGGCAGT	CAISEGQGHEKLFF	1
CACGTTGGCGTCTGCTGTACCCTCTCAGACATCTGTGTACTTCTGTGCCAGCAGTCCCAACCCTATTATGGCTACACCTTCGGTTCG		1
GAGTCCGCCAGCACCAACCAGACATCTATGTACCTCTGTGCCAGCAGTATCCTAGACAGACCTAACTATGGCTACACCTTCGGTTCG	CASSILDRPNYGYTF	1
ACTGTGAGCAACATGAGCCCTGAAGACAGCAGCATATATCTCTGCAGCGTTGAAGCAGCCTCTGGACAGCCCCAGCATTTTGGTGAT	CSVEAASGQPQHF	1
GCCTGCAGAACTGGAGGATTCTGGAGTTTATTTCTGTGCCAGCAGCCAACTCAGGGAATTAGCACAGATACGCAGTATTTTGGCCCA		1
GCCTTGGAGCTGGAGGACTCGGCCCTGTATCTCTGTGCCAGCAGCCAAGACTCAGCGGGGGGGCTCGGCGAGCAGTACTTCGGGCCG	CASSQDSAGGLGEQYF	7
GAATTTCCCCCTGATCCTGGAGTCGCCCAGCCCCAACCAGACCTCTCTGTACTTCTGTGCCAGCAGTAAGAGCAGTTCTTCGGGCCA		1
GTAGTGCGAGGAGATTCGGCAGCTTATTTCTGTGCCAGCTCACCACCGAGTTCCAGCGGGAAGAGCAATGAGCAGTTCTTCGGGCCA	CASSPPSSSGKSNEQFF	1
CTGGAGTTGGCTGCTCCCTCCCAGACATCTGTGTACTTCTGTGCCAGCAGTCCGCCTCTGTTCAGGTCCGAGCAGTACTTCGGGCCG	CASSPPLFRSEQYF	1
ATCCGCTCACCAGGCCTGGGGGACGCAGCCATGTACCTGTGTGCCACCAGCAGAGGCCAATGGGGTGAAAAACTGTTTTTTGGCAGT	CATSRGQWGEKLFF	1
CTGATTCTGGAGTCCGCCAGCACCAACCAGACATCTATGTACCTCTGTGCCAGCAGTCCCATTCGCTACGAGCAGTACTTCGGGCCG	CASSPIRYEQYF	1
TTGGAGCTGGGGGACTCGGCCCTTTATCTTTGCGCCAGCAGCCGGGGGGCTGGGCGGGAGAATGTCAATGAGCAGTTCTTCGGGCCA	CASSRGAGRENVNEQFF	1
GCTCTCTGGAGCTGGGGGACTCAGCTTTGTATTTCTGTGCCAGCAGTCCTTGTTGGGGGGAGGAGCTATGGCTACACCTTCGGTTCG		1
AGCACCTTGGAGCTGGGGGACTCGGCCCTTTATCTTTGCGCCAGCAGCTTGGCGCCCCAGGGGGACGGTGGCTACACCTTCGGTTCG	CASSLAPQGDGGYTF	1
GTCTGCTGCCTCCTCCCAGACATCTGTATATTTCTGCGCCAACATGCAACCGGGACTACGAACACCGGGGAGCTGTTTTTTGGAGAA		1
GCCTGCAGAACTGGAGGATTCTGGAGTTTATTTCTGTGCCAGCAGCCAAGATTGTGACAGGTTGGACAGCCCCAGCATTTTGGTGAT		1
GAGTCTGCCAGGCCCTCACATACCTCTCAGTACCTCTGTGCCACCAGACCGGGACTAGCGGGAGACGATGAGCAGTTCTTCGGGCCA	CATRPGLAGDDEQFF	14
ACGATCCAGCGCACACAGCAGGAGGACTCCGCCGTGTATCTCTGTGCCAGCAGCTTAGTGGGGTACACTGAAGCTTTCTTTGGACAA	CASSLVGYTEAFF	1
ATCCTGGAGTCGCCCAGCCCCAACCAGACCTCTCTGTACTTCTGTGCCAGCAATCGGGACGGAGGCACTGAAGCTTTCTTTGGACAA	CASNRDGGTEAFF	1
GAGTCGCCCAGCCCCAACCAGACCTCTCTGTACTTCTGTGCCAGCAGCCTCCCCGGCAGGGGGCCCTACGAGCAGTACTTCGGGCCG	CASSLPGRGPYEQYF	1
ATCCAGCGCACACAGCAGGAGGACTCCGCCGTGTATCTCTGTGCCAGCAGCGGCGACAGGGGCACCGGGGAGCTGTTTTTTGGAGAA	CASSGDRGTGELFF	1
GTGACCAGTGCCCATCCTGAAGACAGCAGCTTCTACATCTGCAGTGTCGAGGTGGCCAGACCACCAAATGAGCAGTTCTTCGGGCCA	CSVEVARPPNEQFF	2
ACAGAGCAGGGGGACTCGGCCATGTATCTCTGTGCCAGCAGCTCAGGCGGGGGGTCCGTAGCCAAAAACATTCAGTACTTCGGCGCC	CASSSGGGSVAKNIQYF	1
GAGTCCGCCAGCACCAACCAGACATCTATGTACCTCTGTGCCAGCAGTTTGCCTTCGGGACAGGGAGGCGAGCAGTACTTCGGGCCG	CASSLPSGQGGEQYF	1
GTGACCAGTGCCCATCCTGAAGACAGCAGCTTCTACATCTGCAGTGCTAGGCGGGGACAGGGCAGGTACGAGCAGTACTTCGGGCCG	CSARRGQGRYEQYF	1
CGCACAGAGCAGGGGGACTCGGCCATGTATCTCTGTGCCAGCAGTAATGCGGGAGGGCGAGGTGGATACGAGCAGTACTTCGGGCCG	CASSNAGGRGGYEQYF	1
TCTGCTGCCTCCTCCCAGACATCTGTATATTTCTGCGCCAGCAGTGCTCGGGGGGCGGGATCCCCCTACGAGCAGTACTTCGGGCCG	CASSARGAGSPYEQYF	1
ACATCGGCCCAAAAGAACCCGACAGCTTTCTATCTCTGTGCCAGTAGTCAAATCATCGCTGGGGCCAACGTCCTGACTTTCGGGGCC	CASSQIIAGANVLTF	1
ATCCAGCGCACACAGCAGGAGGACTCGGCCGTGTATCTCTGTGCCAGCAGCCAAGGGGAGGGGGCGAGGGAGCAGTACTTCGGGCCA	CASSQGEGAREQYF	1
ACGATCCAGCGCACACAGCAGGAGGACTCGGCCGTGTATCTCTGTGCCAGCAGTCCAGGGCTTGGGTATGGCTACACCTTCGGTTCG	CASSPGLGYGYTF	2
CTGGAGTCCGCCAGCACCAACCAGACATCTATGTACCTCTGTGCCAGCAGTCCTGGACAGGGGTCTGATGGCTACACCTTCGGTTCG	CASSPGQGSDGYTF	1
ACATCAATTCCCTGGAGCTTGGTGACTCTGCTGTGTATTTCTGTGCCGCCGTAGGACAGGGTCTCCTACGAGCAGTACTTCGGGCCG		3
ATCCAGCCCTCAGAACCCAGGGACTCAGCTGTGTACTTCTGTGCCAGCAGTGCGCACTGGGCGAACAACGAGCAGTACTTCGGGCCG	CASSAHWANNEQYF	2
TTGGAGATCCAGCGCACAGAGCAGGGGGACTCGGCCATGTATCTCTGTGCCAGCAGCTTGACGTCCTATGGCTACACCTTCGGTTCG	CASSLTSYGYTF	1
ATCCAGCGCACAGAGCAAGGGGACTCGGCCATGTATCTCTGTGCCAGCAGGCCGACAGGCCTGAACACTGAAGCTTTCTTTGGACAA	CASRPTGLNTEAFF	1
CTGGAGTCCGCCAGCACCAACCAGACATCTATGTACCTCTGTGCCAGCAGTAAAATAACGAACACCGGGGAGCTGTTTTTTGGAGAA	CASSKITNTGELFF	1
GAGTCCGCCAGCACCAACCAGACATCTATGTACCTCTGTGCCAGCAGTTTGACTAGTAACGGGAACAATGAGCAGTTCTTCGGGCCA	CASSLTSNGNNEQFF	1
ACTCTGACAGTGACCAGTGCCCATCCTGAAGACAGCAGCTTCTACATCTGCAGCCCCAATCAGGGAAATGAGCAGTTCTTCGGGCCA	CSPNQGNEQFF	1
ATCCAGCCCTCAGAACCCAGGGACTCAGCTGTGTACTTCTGTGCCAGCAGTTTACCGGGGTTTAACTATGGCTACACCTTCGGTTCG	CASSLPGFNYGYTF	1
AATGTGAGCACCTTGGAGCTGGGGGACTCGGCCCTTTATCTTTGCGCCAGCAGCTTGGTAGAACGAGAGACCCAGTACTTCGGGCCA	CASSLVERETQYF	1
CTTCACATCAATTCCCTGGAGCTTGGTGACTCTGCTGTGTATTTCTGTGCCAGCAGCCAGGACAATCAGCCCCAGCATTTTGGTGAT	CASSQDNQPQHF	1
GCTGTCGGCTGCTCCCTCCCAGACATCTGTGTACTTCTGTGCCAGCAGTACCGGACTAGTTACACCGGGGAGCTGTTTTTTGGAGAA		1
GCTCTGACTGTGAGCAACATGAGCCCTGAAGACAGCAGCATATATCTCTGCAGCGTGGCGGGGGAAGCTGAAGCTTTCTTTGGACAA	CSVAGEAEAFF	5
CAGAACCCAGGGACTCAGCTGTGTACTTCTGTGCCAGCAACTTGAGGGGAAGGAGACCTGATGAACACTGAAGCTTTCTTTGGACAA		1
CGCCTTGTTGCTGGGGGACTCGGCCCTCTATCTCTGTGCCAGCAGCTTGGGGCCTAGCGGGGGCCAGAGACCCAGTACTTCGGGCCA		1
ATTCTGGAGTCCGCCAGCACCAACCAGACATCTATGTACCTCTGTGCCAGCAGCCCCGCAGGGAACTATGGCTACACCTTCGGTTCG	CASSPAGNYGYTF	1
GAGTCCGCCAGCACCAACCAGACATCTATGTACCTCTGTGCCACGACCGTGCTAGCGGGAGGCCCCTACGAGCAGTACTTCGGGCCG	CATTVLAGGPYEQYF	1
CTGGAGTCCGCCAGCACCAACCAGACATCTATGTACCTCTGTGCCAGCACCTCCGGAGGGCCCCCCTACGAGCAGTACTTCGGGCCG	CASTSGGPPYEQYF	2
CACATCAATTCCCTGGAGCTTGGTGACTCTGCTGTGTATTTCTGTGCCAGCAGTCAAATCAGGGGGACTGAAGCTTTCTTTGGACAA	CASSQIRGTEAFF	2
CTGGAGTCGGCTGCTCCCTCCCAGACATCTGTGTACTTCTGTGCCAGCAGCTTGCAGGGAAGCACAGATACGCAGTATTTTGGCCCA	CASSLQGSTDTQYF	1
ATGAATGTGAGCACCTTGGAGCTGGGGGACTCGGCCCTTTATCTTTGCGCCAGCAGCTCTAAGGACACTGAAGCTTTCTTTGGACAA	CASSSKDTEAFF	1
CACGCCCTGCAGCCAGAAGACTCAGCCCTGTATCTCTGCGCCAGCAGCCCGATTGAGACAGGGATCTACGAGCAGTACTTCGGGCCG	CASSPIETGIYEQYF	2
GCCTTGTTGCTGGGGGACTCGGCCCTCTATCTCTGTGCCAGCAGCTTTCGTCGTCTAGCGGGTAACAATGAGCAGTTCTTCGGGCCA	CASSFRRLAGNNEQFF	1
GTGACCAGTGCCCACCCTGAAGACAGCAGCTTCTACATCTGCAGTGCTAATCCGGCGGGATTTTACGATGAGCAGTTCTTCGGGCCA	CSANPAGFYDEQFF	1
CCAGCACCAACCAGACATCTATGTACCTCTGTGCCAGCAGGGTATCATCATTATCCTTTGAGGGGCCAGCCCCAGCATTTTGGTGAT		1
GAGCAGGGGGACTCGGCCATGTATCTCTGTGCCAGCAGCTTCTCGGAGGGCCGGGACAGACGAATTTACGAGCAGTACTTCGGGCCG	CASSFSEGRDRRIYEQYF	1
ACAGAGCAGCGGGACTCGGCCATGTATCGCTGTGCCAGCAGCAAGTCCCGGGACAGGGCGGCTGGAAACACCATATATTTTGGAGAG	CASSKSRDRAAGNTIYF	1
TCTGAAGATCCAGCCCTCAGAACCCAGGGACTCAGCTGTGTACTTCTGTGCCAGCAGTTTTTTGGCCAGCCCCAGCATTTTGGTGAT		1
GTGACCAGTGCCCATCCTGAAGACAGCAGCTTCTACATCTGCAGTGCTAGAGATCCAGGGATTTCAGGGGAGCAGTACTTCGGGCCG	CSARDPGISGEQYF	1
GTGAGCACCTTGGAGCTGGGGGACTCGGCCCTTTATCTTTGCGCCAGCAGCCCGGACAGGGGGCGAGACATTCAGTACTTCGGCGCC	CASSPDRGRDIQYF	1
GCCCATCCTGAAGACAGCAGCTTCTACATCTGCAGTGCTAGAGGGTTTAGAGGTACCACTAGCACAGATACGCAGTATTTTGGCCCA	CSARGFRGTTSTDTQYF	2
CAGCCAGAAGACTCAGCCCTGTATCTCTGCGCCAGCAGCCAAGATTTCTCGGACAGGGGGAGGTATCAGCCCCAGCATTTTGGTGAT	CASSQDFSDRGRYQPQHF	1
AAGATCCGGTCCACAAAGCTGGAGGACTCAGCCATGTACTTCTGTGCCAGCAGGGCGGACAGCAATCAGCCCCAGCATTTTGGTGAT	CASRADSNQPQHF	1
CAGCCCTCAGAACCCAGGGACTCAGCTGTGTACTTCTGTGCCAGCAGTTCAGGGACGGCGAACACCGGGGAGCTGTTTTTTGGAGAA	CASSSGTANTGELFF	1
ATTCTGGAGTCCGCCAGCACCAACCAGACATCTATGTACCTCTGTGCCAGCAGTTTAAACAGTCTAAACGAGCAGTACTTCGGGCCG	CASSLNSLNEQYF	1
CACACCCTGCAGCCAGAAGACTCGGCCCTGTATCTCTGCGCCAGCAGCCAAGTTGCGGACTATTCCTACGAGCAGTACTTCGGGCCG	CASSQVADYSYEQYF	1
CAGCCTGCAGAACTGGAGGATTCTGGAGTTTATTTCTGTGCCAGCAGCCAGACAACTCGACAGTCCTATGGCTACACCTTCGGTTCG	CASSQTTRQSYGYTF	1
ACATCGGCCCAAAAGAACCCGACAGCTTTCTATCTCTGTGCCAGTAGTAAGCTATCAGGGGATGGTCAGCCCCAGCATTTTGGTGAT	CASSKLSGDGQPQHF	1
ATCCAGCCCTCAGAACCCAGGGACTCAGCTGTGTACTTCTGTGCCAGCAGCTATACCGACAGCTACAATGAGCAGTTCTTCGGGCCA	CASSYTDSYNEQFF	1
CTGGGGTTGGAGTCGGCTGCTCCCTCCCAAACATCTGTGTACTTCTGTGCCAGCAGTTCGACTTCTGGTAGGCAGTATTTTGGCCCA	CASSSTSGRQYF	1
TTCCTCCTCACTCTGGAGTCCGCTACCAGCTCCCAGACATCTGTGTACTTCTGTGCCGCAGGAAAAGAGACCCAGTACTTCGGGCCA	CAAGKETQYF	2
ACCCTGGAGTCTGCCAGGCCCTCACATACCTCTCAGTACCTCTGTGCCAGCAGTGAATTAGGTGCAGATACGCAGTATTTTGGCCCA	CASSELGADTQYF	6
GTGAACGCCTTGTTGCTGGGGGACTCGGCCCTGTATCTCTGTGCCAGCAGCTTGATTTTGAGCACAGATACGCAGTATTTTGGCCCA	CASSLILSTDTQYF	1
AGCACCTTGGAGCTGGGGGACTCGGCCCTTTATCTTTGCGCCAGCAGCTTAGGGGGGGCGCGTGGGCAGCCCCAGCATTTTGGTGAT	CASSLGGARGQPQHF	2
GTGACATCGGCCCAAAAGAACCCGACAGCTTTCTATCTCTGTGCCAGTAGCCCCAGGGGCGGCGGAGATACGCAGTATTTTGGCCCA	CASSPRGGGDTQYF	2
ATCCAGCCCTCAGAACCCAGGGACTCAGCTGTGTACTTCTGTGCCAGCAGTTTAGCGACAGGTCCCTACGAGCAGTACTTCGGGCCG	CASSLATGPYEQYF	1
TTGTTGCTGGGGGACTCGGCCCTCTATCTCTGTGCCAGCAGCTTTTCGCCGGGGGGGGCTAGCACAGATACGCAGTATTTTGGCCCA	CASSFSPGGASTDTQYF	1
TCAGGCTGCTGTCGGCTGCTCCCTCCCAGACATCTGTGTACTTCTGTGCCAGCAGTTCAACTCACAGATACGCAGTATTTTGGCCCA		1
ATTCTGGAGTCCGCCAGCACCAACCAGACATCTATGTACCTCTGTGCCAGCAGTTCGGGGGCCTATCAGCCCCAGCATTTTGGTGAT	CASSSGAYQPQHF	1
TCTAAGAAGCTCCTTCTCAGTGACTCTGGCTTCTATCTCTGTGCCTGGAGAACTAGCGGAACCTACAATGAGCAGTTCTTCGGGCCA	CAWRTSGTYNEQFF	1
AGGCTGGAGTCGGCTGCTCCCTCCCAGACATCTGTGTACTTCTGTGCCAGCAGCGGACGAGGGAACACTGAAGCTTTCTTTGGACAA	CASSGRGNTEAFF	1
GACACGGCACTGTATCTCTGCGCCAGCAGTCAGTCGACAGGGGGATCGGGGTTGTCCTCCTATAATTCACCCCTCCACTTTGGGAAC	CASSQSTGGSGLSSYNSPLHF	1
CTCTCACTGTGACATCGGCCCAAAAGAACCCGACAGCTTTCTATCTCTGTGCCAGTATCCAGGGGTCAGCCCCAGCATTTTGGTGAT		1
TCCCTGGAGCTTGGTGACTCTGCTGTGTATTTCTGTGCCAGCAGCCAAGACAGGACCCCCTGGAATTCACCCCTCCACTTTGGGAAC	CASSQDRTPWNSPLHF	1
ATTCTGGAGTCCGCCAGCACCAACCAGACATCTATGTACCTCTGTGCCAGCTCATCAGGACAGGGCTACGAGCAGTACTTCGGGCCG	CASSSGQGYEQYF	1
TCCGCTACCAGCTCCCAGACATCTGTGTACTTCTGTGCCATCAGTGACCCCAGCAGAGGTGGGGAATATGGCTACACCTTCGGTTCG	CAISDPSRGGEYGYTF	5
GCTGGAGGACTCAGCCATGTACTTCTGTGCCAGCAGTGAATCGACTAGCGGGATGATCCTAGCACAGATACGCAGTATTTTGGCCCA		1
CTCAGGCTGCTGTCGGCTGCTCCCTCCCAGACATCTGTGTACTTCTGTGCCAGCAGTCCGTGGGCGGAGCCCCAGCATTTTGGTGAT	CASSPWAEPQHF	1
GGCTGCTCCCTCCCAGACATCTGTGTACTTCTGTGCCAGCAGTTACTCCAGACTAGCCGGCCCTCGGATGAGCAGTACTTCGGGCCG		1
TCCTGAAGACAGCAGCTTCTACATCTGCAGTGCTAGAGCTCGGGTAGCGGGAGGGCCGGGGTCTACAATGAGCAGTTCTTCGGGCCA		1
ACTCTGGAGTCCGCTACCAGCTCCCAGACATCTGTGTACTTCTGTGCCGCTCAAGGGGGAGGTAGGGATGAGCAGTTCTTCGGGCCA	CAAQGGGRDEQFF	1
CAAAAGAACCCGACAGCTTTCTATCTCTGTGCCAGTAGTATAAGAAGAGCGGGAGGGCCGTCCTACAATGAGCAGTTCTTCGGGCCA	CASSIRRAGGPSYNEQFF	1
ATCCAGCCCTCAGAACCCAGGGACTCAGCTGTGTACTTCTGTGCCAGCAATTCAGCGGGACCGCGCGATGAGCAGTTCTTCGGGCCA	CASNSAGPRDEQFF	2
GAGATCCAGCGCACAGAGCAGGGGGACTCGGCCATGTATCTCTGTGCCAGCAGCTCCTCTGGTGGCACTGAAGCTTTCTTTGGACAA	CASSSSGGTEAFF	1
CTGCTGTCGGCTGCTCCCTCCCAGACATCTGTGTACTTCTGTGCCAGCAGTTATCAAACCGGAATGGGTACGCAGTATTTTGGCCCA	CASSYQTGMGTQYF	2
CAGCCCTCAGAACCCAGGGACTCAGCTGTGTACTTCTGTGCCAGCAGTCCCCGAAGGGGTGGGTGGGAGACCCAGTACTTCGGGCCA	CASSPRRGGWETQYF	1
CCTGCAGAGCTTGGGGACTCGGCCATGTATCTCTGTGCCAGCAGCTTTGGTTACGGCAGCAATAACTATGGCTACACCTTCGGTTCG	CASSFGYGSNNYGYTF	1
AGCTCTCTGGAGCTGGGGGACTCAGCTTTGTATTTCTGTGCCAGCCTCCCAGGTTCGGGAAACACCGGGGAGCTGTTTTTTGGAGAA	CASLPGSGNTGELFF	1
ACAAAGCTGGAGGACTCAGCCATGTACTTCTGTGCCAGCAGTGCAGGGCCTGGAGAGGGGACTCCGTACGAGCAGTACTTCGGGCCG	CASSAGPGEGTPYEQYF	48
GTGAGCACCTTGGAGCTGGGGGACTCGGCCCTTTATCTTTGCGCCAGCAGCACGGACAGGGTGGGTGAAAAACTGTTTTTTGGCAGT	CASSTDRVGEKLFF	1
GCCTTGGAGCTGGAGGACTCGGCCCTGTATCTCTGTGCCAGCAGCTTGGGGACTACTTCGAACACCGGGGAGCTGTTTTTTGGAGAA	CASSLGTTSNTGELFF	1
CGGTCCACAAAGCTGGAGGACTCAGCCATGTACTTCTGTGCCAGCAGTGATAATGGCCGCCGGACCGAAAAACTGTTTTTTGGCAGT	CASSDNGRRTEKLFF	1
CTGAGTTCTAAGAAGCTCCTTCTCAGTGACTCTGGCTTCTATCTCTGTGCCTGGAGTTCCAGGCTGGTCGAGCAGTACTTCGGGCCG	CAWSSRLVEQYF	1
CTGGAGTCGGCTGCTCCCTCCCAGACATCTGTGTACTTCTGTGCCAGTCAATCAGGGGGCACCAACTATGGCTACACCTTCGGTTCG	CASQSGGTNYGYTF	1
GACTGTGAGCAACATGAGCCCTGAAGACAGCAGCATATATCTCTGCAGCGTTGAAAACTAGCGGGAGACGAGCAGTACTTCGGGCCG		1
ACCAGTGCCCATCCTGAAGACAGCAGCTTCTACATCTGCAGTGCTAGACCGGGACGTCTGAGCTCCTACGAGCAGTACTTCGGGCCA	CSARPGRLSSYEQYF	1
ACTGTGACATCGGCCCAAAAGAACCCGACAGCTTTCTATCTCTGTGCCATTTGGGGGCGGGATGGGAACGAGCAGTACTTCGGGCCG	CAIWGRDGNEQYF	2
GAGTCGCCCAGCCCCAACCAGACCTCTCTGTACTTCTGTGCCAGCAGTTTACAGGGGGATCGGGTGGGGGAGCAGTACTTCGGGCCG	CASSLQGDRVGEQYF	1
AGCACCTTGGAGCTGGGGGACTCGGCCCTTTATCTTTGCGCCAGCAGCTTGGAGGGACAGCCCAATTCACCCCTCCACTTTGGGAAC	CASSLEGQPNSPLHF	1
GAGTCCGCCAGCACCAACCAGACATCTATGTACCTCTGTGCCAGCAGTGAACCGCGGGGGGCAGCCCAGCCCCAGCATTTTGGTGAT	CASSEPRGAAQPQHF	1
GAGTCCGCTACCAGCTCCCAGACATCTGTGTACTTCTGTGCCATCAGTGGCAGCACTGCGAACACCGGGGAGCTGTTTTTTGGAGAA	CAISGSTANTGELFF	2
GTGAGCACCTTGGAGCTGGGGGACTCGGCCCTTTATCTTTGCGCCAGCAGCTTGGGGGCCGGGGGATTACGGGCTTTCTTTGGACAA	CASSLGAGGLRAFF	2
ACATCGGCCCAAAAGAACCCGACAGCTTTCTATCTCTGTGCCAGTAGTATTGAGGGTTCGAGCACAGATACGCAGTATTTTGGCCCA	CASSIEGSSTDTQYF	2
ACGCCTTGTTGCTGGGGGACTCGGCCCTGTATCTCTGTGCCAGCAGCTTGGTTCTGCCCGTACCAGGGGGCCCAGTACTTCGGGCCA		1
ATCCAGCCCTCAGAACCCAGGGACTCAGCTGTGTATTTTTGTGCTAGTGGACCGGGACAGGGGATTTATACGCAGTATTTTGGCCCA	CASGPGQGIYTQYF	1
TCCCTGATTCTGGAGTCCGCCAGCACCAACCAGACATCTATGTACCTCTGTGCCAGCAGTGAGACCCGGCCCCAGCATTTTGGTGAT	CASSETRPQHF	1
ATCCAGCGCACAGAGCAGCGGGACTCGGCCATGTATCGCTGTGCCAGCAGCTTAGAGTTAGTAGAAGGCGAGCAGTTCTTCGGGCCA	CASSLELVEGEQFF	1
ATCCAGCCCTCAGAACCCAGGGACTCAGCTGTGTACTTCTGTGCCAGCAGTTTGGGTGGAGGAGTCTACGAGCAGTACTTCGGGCCG	CASSLGGGVYEQYF	1
CTGAGCTCTCTGGAGCTGGGGGACTCAGCTTTGTATTTCTGTGCCAGCCGGACAGGGGGCGGCTCAGATACGCAGTATTTTGGCCCA	CASRTGGGSDTQYF	1
CAGCGCACACAGCAGGAGGACTCGGCCGTGTATCTCTGTGCCAGCAGACCACAGCCTTTCTCTGGAAACACCATATATTTTGGAGAG	CASRPQPFSGNTIYF	1
CACCTACACGCCCTGCAGCCAGAAGACTCAGCCCTGTATCTCTGCGCCAGCAGCCAAGAGTTTACCGGCGAGCAGTACTTCGGGCCG	CASSQEFTGEQYF	2
CAGCCCCAACCAGACCTCTCTGTACTTCTGTGCCAGCAGTTTATCGTAGTACTCGGCGCGGAAGGCGATGGCTACACCTTCGGTTCG		1
CGCTCACCAGGCCTGGGGGACGCAGCCATGTACCTGTGTGCCACCAGCAGAGCCCGGGAGAGTAATTCACCCCTCCACTTTGGGAAC	CATSRARESNSPLHF	1
ATCCAGCGCACAGAGCAGGGGGACTCGGCCATGTATCTCTGTGCCAGCAGCTTACGGGCGGGAGGCAATGAGCAGTTCTTCGGGCCA	CASSLRAGGNEQFF	1
GCTGCTCCCTCCCAGACATCTGTGTACTTCTGTGCCAGCAGTTACTCGAGAGGGGGCAGCATGAACACTGAAGCTTTCTTTGGACAA	CASSYSRGGSMNTEAFF	1
CAGCGCACAGAGCAGGGGGACTCGGCCATGTATCTCTGTGCCAGCAGCTTAGATGACAATAGCAATCAGCCCCAGCATTTTGGTGAT	CASSLDDNSNQPQHF	3
GAGTCGCCCAGCCCCAACCAGACCTCTCTGTACTTCTGTGCCAGCAGACCATTCCCTAGGTCTGGAAACACCATATATTTTGGAGAG	CASRPFPRSGNTIYF	1
AGGATCCAGCAGGTAGTGCGAGGAGATTCGGCAGCTTATTTCTGTGCCAGCTCTCCGGAGGGGAATCAGCCCCAGCATTTTGGTGAT	CASSPEGNQPQHF	1
GAGTCGCCCAGCCCCAACCAGACCTCTCTGTACTTCTGTGCCAGCAGACAATGGGCGGGGGCCGGCTATGGCTACACCTTCGGTTCG	CASRQWAGAGYGYTF	1
AATGTGAACGCCTTGGAGCTGGAGGACTCGGCCCTGTATCTCTGTGCCAGCACAACAAGTTCAGATTCACCCCTCCACTTTGGGAAC	CASTTSSDSPLHF	1
AATGTGAATGCCTTGGAGCTGGAGGACTCGGCCCTGTATCTCTGTGCCAGCAGCGGAACGGACAGCTATGGCTACACCTTCGGTTCG	CASSGTDSYGYTF	1
CTGGAGTCGCCCAGCCCCAACCAGACCTCTCTGTACTTCTGTGCCAGCAGTCGGTTGGGTTCTAACTATGGCTACACCTTCGGTTCG	CASSRLGSNYGYTF	1
TCGGCTGCTCCCTCCCAGACATCTGTGTACTTCTGTGCCAGCAGTGCCCCCGGGACTAGAATCACCGGGGAGCTGTTTTTTGGAGAA	CASSAPGTRITGELFF	1
CTAGAGTCTGCCATCCCCAACCAGACAGCTCTTTACTTCTGTGCCACCAGTGAGGGCGACAGGGTTGATGGCTACACCTTCGGTTCG	CATSEGDRVDGYTF	1
CAGACATCTGTGTACTTCTGTGCCAGCAGCACCGGGACCCCCGGGCTAGCGGGAGCGTTGGGCACAGATACGCAGTATTTTGGCCCA	CASSTGTPGLAGALGTDTQYF	1
TTGGAGTCGGCTGCTCCCTCCCAAACATCTGTGTACTTCTGTGCCAGCAGTGCCGGGACTAGCATCGGCGAGCAGTACTTCGGGCCG	CASSAGTSIGEQYF	1
AGTGCCCATCCTGAAGACAGCAGCTTCTACATCTGCAGTGCTCGAGGGGGAGCGGGAGGGCCAGGGAATGAGCAGTTCTTCGGGCCA	CSARGGAGGPGNEQFF	1
CCTTGGAGATCCAGTCCACGGAGTCAGGGGACACAGCACTGTATTTCTGTGCCAGCAGCATCGGGGGAGACCCAGTACTTCGGGCCA		1
CGGTCCACAAAGCTGGAGGACTCAGCCATGTACTTCTGTGCCAGCAGTCTGACTAGCGGGGGTGCCGATACGCAGTATTTTGGCCCA	CASSLTSGGADTQYF	1
GTGAGCACCTTGGAGCTGGGGGACTCGGCCCTTTATCTTTGCGCCAGCAGCTTACAGGGGATCACAGATACGCAGTATTTTGGCCCA	CASSLQGITDTQYF	1
TCCGCCAGCACCAACCAGACATCTATGTACCTCTGTGCCAGCAGTTTATTCGGGACACATAGCAATCAGCCCCAGCATTTTGGTGAT	CASSLFGTHSNQPQHF	1
ATCCAGCCCTCAGAACCCAGGGACTCAGCTGTGTACTTCTGTGCCAGCAGTTTGACTAGCGGCTACAATGAGCAGTTCTTCGGGCCA	CASSLTSGYNEQFF	1
AGATCCAACCTGCAAAGCTTGAGGACTCGGCCGTGTATCTCTGTGCCAGCCGGACAGGATTTAAGGTATGGCTACACCTTCGGTTCG		1
GTGACATCGGCCCAAAAGAACCCGACAGCTTTCTATCTCTGTGCCAGTAACCCGGGACAGAAAAATCAGCCCCAGCATTTTGGTGAT	CASNPGQKNQPQHF	2
CCAGCGCACAGAGCAGGGGGACTCGGCCATGTATCTCTGTGCCAGCAGCGGGGGGGACAGGGGAACTATGGCTACACCTTCGGTTCG		1
ACCAGTGCCCATCCTGAAGACAGCAGCTTCTACATCTGCAGTGCTAGAGATCTTAGCGGGAGGGCGAATGAGCAGTTCTTCGGGCCA	CSARDLSGRANEQFF	1
CTTGGTGACTCTGCTGTGTATTTCTGTGCCAGCAGCCAATCTCCTCGGGGACTAGCGGGAGACTCAGAGGCCCAGTACTTCGGGCCA	CASSQSPRGLAGDSEAQYF	3
CTGAAGATCCGGTCCACAAAGCTGGAGGACTCAGCCATGTACTTCTGTGCCAGCAGTCGCGACAGGGGAAAACTGTTTTTTGGCAGT	CASSRDRGKLFF	2
CTGAAGATCCGGTCCACAAAGCTGGAGGACTCAGCCATGTACTTCTGTGCCAGCAGTTCCGACCGGGGCGGCTACACCTTCGGTTCG	CASSSDRGGYTF	1
GTGAGCAACATGAGCCCTGAAGACAGCAGCATATATCTCTGCAGCGTTGTAAATGGTCCGAACACCGGGGAGCTGTTTTTTGGAGAA	CSVVNGPNTGELFF	1
AAGATCCAGCCCTCAGAACCCAGGGACTCAGCTGTGTACTTCTGTGCCAGCAGTTTAAAGGGGGACACTGAAGCTTTCTTTGGACAA	CASSLKGDTEAFF	1
TCTGAAGATCCGGTCCACAAAGCTGGAGGACTCAGCCATGTACTTCTGTGCCAGCAGTGCAGGGAAGGGGGCTACACCTTCGGTTCG		1
CAGGTAGTGCGAGGAGATTCGGCAGCTTATTTCTGTGCCAGCTCAGGTTGGGGGACTAGCGAGAAAGAGACCCAGTACTTCGGGCCA	CASSGWGTSEKETQYF	3
GAGTCCGCCAGCACCAACCAGACATCTATGTACCTCTGTGCCAGCAGTTTCGGGAGGGCCAACACCGGGGAGCTGTTTTTTGGAGAA	CASSFGRANTGELFF	1
CGCACAGAGCAGGGGGACTCGGCCATGTATCTCTGTGCCAGCAGCGTAGGACTAGCGGGGGGATTGGGTGAGCAGTTCTTCGGGCCA	CASSVGLAGGLGEQFF	1
ACTGTGACATCGGCCCAAAAGAACCCGACAGCTTTCTATCTCTGTGCCAGTAGCAGGGACAGCAACTATGGCTACACCTTCGGTTCG	CASSRDSNYGYTF	1
GAGTCCGCCAGCACCAACCAGACATCTATGTACCTCTGTGCCAGCAGTCTAGCCGGGACTACCTCCTACGAGCAGTACTTCGGGCCG	CASSLAGTTSYEQYF	1
GTGACCAGTGCCCATCCTGAAGACAGCAGCTTCTACATCTGCAGTGCTAGAGATTTGGACACCCTCTACGAGCAGTACTTCGGGCCG	CSARDLDTLYEQYF	1
TCCCTGGAGCTTGGTGACTCTGCTGTGTATTTCTGTGCCAGCAGCCGGTCTGGCGGGAGGGGCGAAGGTGAGCAGTTCTTCGGGCCA	CASSRSGGRGEGEQFF	1
CTGACAGTGACCAGTGCCCATCCTGAAGACAGCAGCTTCTACATCTGCAGTGTTGCCGGACAGCTCTACGAGCAGTACTTCGGGCCG	CSVAGQLYEQYF	1
AGCGCACAGAGCAGGGGGACTCAGCCGCGTATCTCCGTGCCAGCAGCTCCCACCCGGACTAGCGGGTGCGAGCAGTACTTCGGGCCG		1
ATCCAGCCCTCAGAACCCAGGGACTCAGCTGTGTACTTCTGTGCCAGCAGCCCCGGACAGTCGAACACTGAAGCTTTCTTTGGACAA	CASSPGQSNTEAFF	1
CACATCAATTCCCTGGAGCTTGGTGACTCTGCTGTGTATTTCTGTGCCAGCAGCCAAGCTTTGGAGCAGCCCCAGCATTTTGGTGAT	CASSQALEQPQHF	1
TGCTGCCTCCTCCCAGACATCTGTATATTTCTGCGCCAGCCTTGTAATGGGGGAGGGTCGGACACCGGGGAGCTGTTTTTTGGAGAA		1
AGCTCTCTGGAGCTGGGGGACTCAGCTTTGTATTTCTGTGCCAGCAAACCCGACTTACTAGGCCCAGATACGCAGTATTTTGGCCCA	CASKPDLLGPDTQYF	1
GTGACCAGTGCCCATCCTGAAGACAGCAGCTTCTACATCTGCAGTGCTCCGGCGAACAGGGTGGGATCTGGCTACACCTTCGGTTCG	CSAPANRVGSGYTF	1
CTGAGCTCTCTGGAGCTGGGGGACTCAGCTTTGTATTTCTGTGCCAGCAGCGCCTATGGAGCTCGGGACGAGCAGTACTTCGGGCCG	CASSAYGARDEQYF	3
ATCCAGCCCTCAGAACCCAGGGACTCAGCTGTGTACTTCTGTGCCAGCACCCAAGCGGGGTCCTACAATGAGCAGTTCTTCGGGCCA	CASTQAGSYNEQFF	1
AGGCTGCTGTCGGCTGCTCCCTCCCAGACATCTGTGTACTTCTGTGCCAGCAGGTCCTTCCGGACCGGGGAGCTGTTTTTTGGAGAA	CASRSFRTGELFF	1
GCCCAAAAGAACCCGACAGCTTTCTATCTCTGTGCCAGTAGTATATCAGGGACAGGGCCGGTCAAAAACATTCAGTACTTCGGCGCC	CASSISGTGPVKNIQYF	1
TCTGCCATCCCCAACCAGACAGCTCTTTACTTCTGTGCCACCAGTGATCCTAGCGGGGGGGTTGCAGATACGCAGTATTTTGGCCCA	CATSDPSGGVADTQYF	2
ACTCTGGAGTCTGCTGCCTCCTCCCAGACATCTGTATATTTCTGCGCCAGCAGTAAGCGGGAGCAAGATACGCAGTATTTTGGCCCA	CASSKREQDTQYF	1
AACGCCTTGTTGCTGGGGGACTCGGCCCTGTATCTCTGTGCCAGCAGCATTGGAGTAGCGGGAGGTCAGACCCAGTACTTCGGGCCA	CASSIGVAGGQTQYF	1
TCGGCTGCTCCCTCCCAGACATCTGTGTACTTCTGTGCCAGCAGTTCCCGGAGCGGGGGGGCCTTAAATGAGCAGTTCTTCGGGCCA	CASSSRSGGALNEQFF	2
GTGACATCGGCCCAAAAGAACCCGACAGCTTTCTATCTCTGTGCCAGTAGTATCGGGGAATACACCGGGGAGCTGTTTTTTGGAGAA	CASSIGEYTGELFF	1
AGGCTGGAGTCAGCTGCTCCCTCCCAGACATCTGTATACTTCTGTGCCAGCAGTTCGCACTCCTGATACGAGCAGTACTTCGGGCCG	CASSSHS*YEQYF	1
ACATCGGCCCAAAAGAACCCGACAGCTTTCTATCTCTGTGCCAGTACCTACACCGGGACAGGAACCTACGAGCAGTACTTCGGGCCG	CASTYTGTGTYEQYF	1
CTGGAGCTTGGTGACTCTGCTGTGTATTTCTGTGCCAGCAGCCAAGATTAAATTGTAGCGGGAGAGGACGAGCAGTACTTCGGGCCG	CASSQD*IVAGEDEQYF	11
CTGGAGTTGGCTGCTCCCTCCCAGACATCTGTGTACTTCTGTGCCAGCAGCCCCCAGCCCTCTGGAAACACCATATATTTTGGAGAG	CASSPQPSGNTIYF	2
CAGCGCACAGAGCAGGGGGACTCGGCCATGTATCTCTGTGCCAGCAGCCACCTCGGACAGCGCAGCTACGAGCAGTACTTCGGGCCG	CASSHLGQRSYEQYF	4
ACCAGTGCCCATCCTGAAGACAGCAGCTTCTACATCTGCAGTGCTAGAGTTGCTGGTAGAGAGCAGCATGAGCAGTTCTTCGGGCCA	CSARVAGREQHEQFF	1
AAGAAGACTCAGCTGCGTATCTCTGCACCAGCAGCCCCTCGGGGACTAGCGGGACGGGTCCGTAGAGAGACCCAGTACTTCGGGCCA		1
CTAGAGTCTGCCATCCCCAACCAGACAGCTCTTTACTTCTGTGCCACCAGTGATACGGGGTTAGAGAAGGGCCAGTACTTCGGGCCA	CATSDTGLEKGQYF	1
ACATCGGCCCAAAAGAACCCGACAGCTTTCTATCTCTGTGCCAGTACCCCCAAGGGCTTCCCCCTGGACGAGCAGTACTTCGGGCCG	CASTPKGFPLDEQYF	1
GAGATCCAGCGCACAGAGCAGGGGGACTCGGCCATGTATCTCTGTGCCAGCAGCTTAGGGGCAGGGTCCGGCTACACCTTCGGTTCG	CASSLGAGSGYTF	1
GAGTCGGCTGCTCCCTCCCAAACATCTGTGTACTTCTGTGCCAGCTGGGAGGAGAGGACATCCCGAGAGACCCAGTACTTCGGGCCA	CASWEERTSRETQYF	1
CCTGCAGAGCTTGGGGACTCGGCCGTGTATCTCTGTGCCAGCAGCTTAGATGTGATGGGGTACCAAGAGACCCAGTACTTCGGGCCA	CASSLDVMGYQETQYF	1
GCTCCCTCCCAAACATCTGTGTACTTCTGTGCCAGCAGTTACTCGATGAGGGCCCTCCGGAGCAATCAGCCCCAGCATTTTGGTGAT	CASSYSMRALRSNQPQHF	1
ATCCTGGAGTCGCCCAGCCCCAACCAGACCTCTCTGTACTTCTGTGCCAGCAGCTATAAGACCACCGGGGAGCTGTTTTTTGGAGAA	CASSYKTTGELFF	4
CTGTCCCTAGAGTCTGCCATCCCCAACCAGACAGCTCTTTACTTCTGTGCCACGCGTTCAGGATCCGGGGAGCTGTTTTTTGGAGAA	CATRSGSGELFF	1
CGCACAGAGCAGGGGGACTCGGCCATGTATCTCTGTGCCAGCAGCCCACTAGGGGGAACGAACACCGGGGAGCTGTTTTTTGGAGAA	CASSPLGGTNTGELFF	1
TCTGCTGTACCCTCTCAGACATCTGTGTACTTCTGTGCCAGCAGGTACAGGGATACTAGCGGGGCCTACGAGCAGTACTTCGGGCCG	CASRYRDTSGAYEQYF	1
AGGATCCAGCAGGTAGTGCGAGGAGATTCGGCAGCTTATTTCTGTGCCAGCTCTCTAGAGGCTGGAAACACCATATATTTTGGAGAG	CASSLEAGNTIYF	1
ATCAATTCCCTGGAGCTTGGTGACTCTGCTGTGTATTTCTGTGCCAGCAGCCAAGGGGAGGCCGCGGCTGAAGCTTTCTTTGGACAA	CASSQGEAAAEAFF	1
CTGACAGTGACCAGTGCCCATCCTGAAGACAGCAGCTTCTACATCTGCAGTGCAAGGACTAGCGGAGAGACCCAGTACTTCGGGCCA	CSARTSGETQYF	1
CGCCCTGCAGCCAGAAGACTCAGCCCTGTATCTCTGCGCCAGCAGCCAAGGGCGTACGGTCGGAACACTGAAGCTTTCTTTGGACAA		1
CAGCAGGTAGTGCGAGGAGATTCGGCAGCTTATTTCTGTGCCAGCTCACCCTCCGGGACTACCTCCTACGAGCAGTACTTCGGGCCG	CASSPSGTTSYEQYF	1
TCCCGCTCAGGCTGCTGTCGGCTGCTCCCTCCCAGACATCTGTGTACTTCTGTGCCAGCGGGTCCCGGGGAGCTGTTTTTTGGAGAA		1
GTGAACGCCTTGTTGCTGGGGGACTCGGCCCTGTATCTCTGTGCCAGCAGCTCAACGGTCCCCGTAGATACGCAGTATTTTGGCCCA	CASSSTVPVDTQYF	2
TTGGAGCTGGACGGCTCGGCCCTGTATCTCTGTGCCATTGGTACCCCTAGCGGAGGGGACCACACCGGGGAGCTGTTTTTTGGAGAA	CAIGTPSGGDHTGELFF	1
CTGCTGTCGGCTGCTCCCTCCCAGACATCTGTGTACTTCTGTGCCAGCAGTTATCGGGAGGGAAGGGACATTCAGTACTTCGGCGCC	CASSYREGRDIQYF	1
TCCACTCTGACAGTGACCAGTGCCCATCCTGAAGACAGCAGCTTCTACATCTGCAGTGCTAGGTCGACCATGGCTTTCTTTGGACAA	CSARSTMAFF	1
CGCACAGAGCAGCGGGACTCGGCCATGTATCGCTGTGCCAGCAGCTCAAGGACTAGCGGGAGGCAAGAGACCCAGTACTTCGGGCCA	CASSSRTSGRQETQYF	1
CTGGAGTCGGCTGCTCCCTCCCAGACATCTGTGTACTTCTGTGCCAGCAGTGAAGGGGCAGGGGTAGATACGCAGTATTTTGGCCCA	CASSEGAGVDTQYF	1
ACTCTGAAGATCCAGCCTGCAGAGCAGGGGGACTCGGCCGTGTATGTCTGTGCAAGTCCTCAGTCCTACGAGCAGTACTTCGGGCCG	CASPQSYEQYF	1
ATCCTGGAGTCGCCCAGCCCCAACCAGACCTCTCTGTACTTCTGTGCCAGCAGTTTAAGGCGGAATGAAAAACTGTTTTTTGGCAGT	CASSLRRNEKLFF	1
TCGGCTGCTCCCTCCCAGACATCTGTGTACTTCTGTGCCAGCAGTTACTCGGTTGGCTCTAGGAGAGACATTCAGTACTTCGGCGCC	CASSYSVGSRRDIQYF	1
AGTGACCAGTGCCCATCCTGAAGACAGCAGCTTCTACATCTGCAGTGCTAGAACGGGGGGAGCTCCTACGAGCAGTACTTCGGGCCG		1
CCCCTCACTCTGGAGTCTGCTGCCTCCTCCCAGACATCTGTATATTTCTGCGCCAGCAGTGAGGGACTAGAGCAGTTCTTCGGGCCA	CASSEGLEQFF	1
CGGTCCACAAAGCTGGAGGACTCAGCCATGTACTTCTGTGCCAGCAGTGATCGGAGACAGGGGCCAGATACGCAGTATTTTGGCCCA	CASSDRRQGPDTQYF	2
TCCCTAGAGTCTGCCATCCCCAACCAGACAGCTCTTTACTTCTGTGCCACCAGTGATCCATACGGCAATGAGCAGTTCTTCGGGCCA	CATSDPYGNEQFF	1
AGAACTGGAGGATTCTGGAGTTTATTTCTGTGCCAGCAGCCAATAGTCCGGCCCCCCAGATGCAATCAGCCCCAGCATTTTGGTGAT		3
GAGCTGAATGTGAACGCCTTGTTGCTGGGGGACTCGGCCCTCTATCTCTGTGCCAGCAGCCTTGGATCTGAAGCTTTCTTTGGACAA	CASSLGSEAFF	1
GCTCCCTCCCAAACATCTGTGTACTTCTGTGCCAGCATAGCTGACCCGGACCTCCTGACGGGCAATCAGCCCCAGCATTTTGGTGAT	CASIADPDLLTGNQPQHF	1
CTGATTCTGGAGTCCGCCAGCACCAACCAGACATCTATGTACCTCTGTGCCAGCAGGACTCCCTCCGATACGCAGTATTTTGGCCCA	CASRTPSDTQYF	1
ATCCAGCAGGTAGTGCGAGGAGATTCGGCAGCTTATTTCTGTGCCAGCTCACCCAGGCCTGGAAAAGATACGCAGTATTTTGGCCCA	CASSPRPGKDTQYF	2
ACGATCCAGCGCACACAGCAGGAGGACTCGGCCGTGTATCTCTGTGCCAGCAGCCCTTATACGGACCTTGAAGCTTTCTTTGGACAA	CASSPYTDLEAFF	1
GTGAGCAACATGAGCCCTGAAGACAGCAGCATATATCTCTGCAGCGTTATAAGACAGGGACAGGCGGAGACCCAGTACTTCGGGCCA	CSVIRQGQAETQYF	1
CTGACGATCCAGCGCACACAGCAGGAGGACTCGGCCGTGTATCTCTGTGCCAGCAGCGATTCTAGTTATGGCTACACCTTCGGTTCG	CASSDSSYGYTF	1
CTGGAGTCTGCCAGGCCCTCACATACCTCTCAGTACCTCTGTGCCAGCAGTGTGGGGTATAGCAATCAGCCCCAGCATTTTGGTGAT	CASSVGYSNQPQHF	1
GAGTCTGCCAGGCCCTCACATACCTCTCAGTACCTCTGTGCCAGCAGTGAATATCCCCCGAACTCGGATGGCTACACCTTCGGTTCG	CASSEYPPNSDGYTF	1
AGCTCTCTGGAGCTGGGGGACTCAGCTTTGTATTTCTGTGCCAGCAGCGTAGCCGTCGGACCAAACTATGGCTACACCTTCGGTTCG	CASSVAVGPNYGYTF	1
CAGTGACCAGTGCCCATCCTGAAGACAGCAGCTTCTACATCTGCAGCGCCGGGCGGGGGGGGCTTCAATGAGCAGTTCTTCGGGCCA		2
CTGAGCTCTCTGGAGCTGGGGGACTCAGCTTTGTATTTCTGTGCCAGCAGCGTAGGTGGGGTGAGCTATGGCTACACCTTCGGTTCG	CASSVGGVSYGYTF	1
AGTGCCCATCCTGAAGACAGCAGCTTCTACATCTGCAGTGCTAGAGATTTGGCCGCCGGTTACTACAATGAGCAGTTCTTCGGGCCA	CSARDLAAGYYNEQFF	1
CCCTCCCAGACATCTGTGTACTTCTGTGCCAGCAGCAAAAGCGGGAGGGCCATCCGTAAGAACACAGATACGCAGTATTTTGGCCCA	CASSKSGRAIRKNTDTQYF	1
CTGGAGTCCGCCAGCACCAACCAGACATCTATGTACCTCTGTGCCAGCAGAGGGGGACAGGGAGCCTATGGCTACACCTTCGGTTCG	CASRGGQGAYGYTF	1
CGATCCAGCGCACACAGCAGGAGGACTCGGCCGTGTATCTCTGTGCCAGCAGCCGGGACAGGGGGGGGAGAGCAGTACTTCGGGCCG		2
GTGACCAGTGCCCATCCTGAAGACAGCAGCTTCTACATCTGCAGTGTGGAGTATCGGGGTCGTAAAAACATTCAGTACTTCGGCGCC	CSVEYRGRKNIQYF	1
GCCCAAAAGAACCCGACAGCTTTCTATCTCTGTGCCAGTACCCCCGGAGGGGGCGCGGGGGCCAAAAACATTCAGTACTTCGGCGCC	CASTPGGGAGAKNIQYF	1
CTCCCAAACATCTGTGTACTTCTGTGCCAGCAGTTTTTGACGACCCAAAAACTGACAGGGGAATACAATGAGCAGTTCTTCGGGCCA		2
CGCCCTGCAGCCAGAAGACTCAGCCCTGTATCTCTGCGCCAGCAGCCAAGAGGGACTAGTTCAAATTCACCCCTCCACTTTGGGAAC		1
GAGTCTGCCATCCCCAACCAGACAGCTCTTTACTTCTGTGCCACCAGTGACCCCCGGGACAGAAAAGAGACCCAGTACTTCGGGCCA	CATSDPRDRKETQYF	1
CAGGGGGACTCAGCCGCGTATCTCCGTGCCAGCGTGGGTCGTTTGTGGTGACAGGCAAACTCTGGAAACACCATATATTTTGGAGAG	RASVGRLW*QANSGNTIYF	1
GAGTCGGCTGCTCCCTCCCAGACATCTGTGTACTTCTGTGCCAGCAGTGAATTAAGAGGCCGAAATTCACCCCTCCACTTTGGGAAC	CASSELRGRNSPLHF	1
ACCTTGGAGCTGGGGGACTCGGCCCTTTATCTTTGCGCCAGCAGCTGGGGAGAAGGGGGGAACGGAAACACCATATATTTTGGAGAG	CASSWGEGGNGNTIYF	1
GAGTTGGCTGCTCCCTCCCAGACATCTGTGTACTTCTGTGCCAGCAGCCTAGATCTGGGTAAACCCTACGAGCAGTACTTCGGGCCG	CASSLDLGKPYEQYF	1
ACATCGGCCCAAAAGAACCCGACAGCTTTCTATCTCTGTGCCAGTAGTCAGGGGGCAAGGGCCTACAATGAGCAGTTCTTCGGGCCA	CASSQGARAYNEQFF	1
GAGTCCGCCAGCACCAACCAGACATCTATGTACCTCTGTGCCAGCAGTTTATGGGGCAGGGGGGGCGAGACCCAGTACTTCGGGCCA	CASSLWGRGGETQYF	1
CGCACACAGCAGGAGGACTCGGCCGTGTATCTCTGTGCCAGCAGCGGATTTGGCGGGGGGTCGAACACTGAAGCTTTCTTTGGACAA	CASSGFGGGSNTEAFF	1
CTACACACCCTGCAGCCAGAAGACTCGGCCCTGTATCTCTGCGCCAGTCGGCCCGTAGGGGATTCGTATGGCTACACCTTCGGTTCG	CASRPVGDSYGYTF	1
TTGGCGTCTGCTGTACCCTCTCAGACATCTGTGTACTTCTGTGCCAGCAGTGGACAGGGATTCAGCTATGGCTACACCTTCGGTTCG	CASSGQGFSYGYTF	1
GCCATCCCCAACCAGACAGCTCTTTACTTCTGTGCCACCGTCGGACGACCCGGAGGGGGTGGAGGCCAGCCCCAGCATTTTGGTGAT	CATVGRPGGGGGQPQHF	1
CAGCGCACACAGCAGGAGGACTCGGCCGTGTATCTCTGTGCCAGCAGCTCCGACACCGCCTCCTACAATGAGCAGTTCTTCGGGCCA	CASSSDTASYNEQFF	1
